tax	F82	S370_full	S777_AD1	S778_AD2	S779_AD3	S780_AD4	S781_AD5	S782_AD6	total
Bacteria;Bacteria_none;Firmicutes;Negativicutes;Selenomonadales;Selenomonadaceae;Selenomonas;Selenomonas bovis	5	42	15	37589	0	8	5108	34234	77001
Bacteria;Bacteria_none;Firmicutes;Clostridia;Eubacteriales;Peptostreptococcaceae;Romboutsia;Romboutsia timonensis	5052	10322	16198	18424	4181	6697	4996	6390	72260
Bacteria;Bacteria_none;Firmicutes;Clostridia;Eubacteriales;Oscillospiraceae;Acetivibrio;Acetivibrio mesophilus	0	17	23005	234	726	8641	24	35	32682
Bacteria;Bacteria_none;Firmicutes;Clostridia;Eubacteriales;Clostridiaceae;Clostridium;Clostridium saudiense	1315	2521	3456	6112	1180	1489	1393	1436	18902
Bacteria;Bacteria_none;Firmicutes;Tissierellia;Tissierellia_Incertae_sedis;Tissierellia_Incertae_sedis;Sedimentibacter;Sedimentibacter saalensis	128	2257	8208	354	1710	594	229	583	14063
Bacteria;Bacteria_none;Firmicutes;Clostridia;Eubacteriales;Oscillospiraceae;Ruminococcus;Ruminococcus flavefaciens	256	13264	17	20	56	12	2	4	13631
Bacteria;Bacteria_none;Firmicutes;Clostridia;Eubacteriales;Clostridiaceae;Clostridium;Clostridium jeddahitimonense	990	1542	2239	3966	668	893	902	886	12086
Bacteria;Bacteria_none;Firmicutes;Clostridia;Eubacteriales;Oscillospiraceae;Acetivibrio;Acetivibrio straminisolvens	0	55	7948	77	247	2903	9	4	11243
Bacteria;Bacteria_none;Firmicutes;Negativicutes;Veillonellales;Veillonellaceae;Megasphaera;Megasphaera indica	27	2	7	7815	1	3	2091	93	10039
Bacteria;Bacteria_none;Firmicutes;Clostridia;Eubacteriales;Peptostreptococcaceae;Intestinibacter;Intestinibacter bartlettii	701	1248	2180	2417	536	863	624	841	9410
Bacteria;Bacteria_none;Firmicutes;Negativicutes;Veillonellales;Veillonellaceae;Megasphaera;Megasphaera elsdenii	71	7	52	6046	2	19	2371	78	8646
Bacteria;Bacteria_none;Firmicutes;Tissierellia;Tissierellia_Incertae_sedis;Tissierellia_Incertae_sedis;Sedimentibacter;Sedimentibacter hongkongensis	75	1067	4253	293	823	1440	113	249	8313
Bacteria;Bacteria_none;Firmicutes;Bacilli;Lactobacillales;Carnobacteriaceae;Trichococcus;Trichococcus paludicola	6055	825	244	689	120	63	141	147	8284
Bacteria;Bacteria_none;Firmicutes;Bacilli;Bacillales;Paenibacillaceae;Marinicrinis;Marinicrinis sediminis	14	320	3645	857	680	2105	157	104	7882
Bacteria;Bacteria_none;Bacteroidota;Bacteroidia;Marinilabiliales;Prolixibacteraceae;Roseimarinus;Roseimarinus sediminis	475	6460	204	328	42	75	51	56	7691
Bacteria;Bacteria_none;Firmicutes;Tissierellia;Tissierellia_Incertae_sedis;Tissierellia_Incertae_sedis;Sedimentibacter;Sedimentibacter hydroxybenzoicus	96	699	2972	369	543	2397	65	149	7290
Bacteria;Bacteria_none;Firmicutes;Clostridia;Eubacteriales;Clostridiaceae;Clostridium;Clostridium manihotivorum	475	1145	1796	1717	402	532	280	278	6625
Bacteria;Bacteria_none;Firmicutes;Bacilli;Lactobacillales;Streptococcaceae;Lactococcus;Lactococcus raffinolactis	5035	310	136	335	48	31	105	98	6098
Bacteria;Bacteria_none;Firmicutes;Clostridia;Eubacteriales;Desulfotomaculaceae;Pelotomaculum;Pelotomaculum schinkii	9	712	3319	267	483	1096	79	42	6007
Bacteria;Bacteria_none;Firmicutes;Clostridia;Eubacteriales;Proteinivoraceae;Anaerobranca;Anaerobranca horikoshii	0	0	4721	97	606	446	40	18	5928
Bacteria;Bacteria_none;Firmicutes;Clostridia;Eubacteriales;Peptococcaceae;Desulfofundulus;Desulfofundulus thermobenzoicus	12	279	2788	1572	586	417	139	77	5870
Bacteria;Bacteria_none;Firmicutes;Clostridia;Eubacteriales;Clostridiaceae;Clostridium;Clostridium disporicum	422	752	1018	1962	331	442	447	469	5843
Bacteria;Bacteria_none;Firmicutes;Bacilli;Lactobacillales;Streptococcaceae;Streptococcus;Streptococcus moroccensis	4646	171	69	198	36	9	44	66	5239
Bacteria;Bacteria_none;Firmicutes;Bacilli;Lactobacillales;Streptococcaceae;Streptococcus;Streptococcus chenjunshii	3955	303	165	363	53	41	91	69	5040
Bacteria;Bacteria_none;Firmicutes;Negativicutes;Veillonellales;Veillonellaceae;Dialister;Dialister succinatiphilus	29	6	4	2001	1	0	413	2356	4810
Bacteria;Bacteria_none;Proteobacteria;Betaproteobacteria;Burkholderiales;Comamonadaceae;Comamonas;Comamonas denitrificans	3952	164	188	88	70	112	23	53	4650
Bacteria;Bacteria_none;Proteobacteria;Gammaproteobacteria;Moraxellales;Moraxellaceae;Moraxella;Moraxella osloensis	3538	36	246	479	51	116	33	36	4535
Bacteria;Bacteria_none;Firmicutes;Clostridia;Eubacteriales;Eubacteriaceae;Eubacterium;Eubacterium aggregans	909	762	809	850	225	427	308	140	4430
Bacteria;Bacteria_none;Firmicutes;Clostridia;Eubacteriales;Gracilibacteraceae;Gracilibacter;Gracilibacter thermotolerans	141	2257	1110	19	500	162	3	94	4286
Bacteria;Bacteria_none;Firmicutes;Clostridia;Eubacteriales;Peptostreptococcaceae;Terrisporobacter;Terrisporobacter petrolearius	332	542	1018	1066	269	392	258	378	4255
Bacteria;Bacteria_none;Firmicutes;Bacilli;Lactobacillales;Streptococcaceae;Streptococcus;Streptococcus minor	2295	472	329	596	78	63	160	81	4074
Bacteria;Bacteria_none;Proteobacteria;Deltaproteobacteria;Syntrophales;Smithellaceae;Smithella;Smithella propionica	70	2101	196	55	1570	42	12	15	4061
Bacteria;Bacteria_none;Atribacterota;Atribacteria;Atribacterales;Atribacteraceae;Atribacter;Atribacter laminatus	91	712	1634	995	327	110	83	63	4015
Bacteria;Bacteria_none;Firmicutes;Clostridia;Eubacteriales;Oscillospiraceae;Acutalibacter;Acutalibacter muris	285	3079	89	29	32	44	4	7	3569
Bacteria;Bacteria_none;Bacteroidota;Bacteroidia;Bacteroidales;Rikenellaceae;Alistipes;Alistipes putredinis	214	1543	1059	60	273	262	62	54	3527
Bacteria;Bacteria_none;Armatimonadetes;Armatimonadia;Capsulimonadales;Capsulimonadaceae;Capsulimonas;Capsulimonas corticalis	63	734	1694	178	421	308	44	46	3488
Bacteria;Bacteria_none;Firmicutes;Clostridia;Eubacteriales;Lachnospiraceae;Shuttleworthia;Shuttleworthia satelles	804	80	761	797	259	267	248	122	3338
Bacteria;Bacteria_none;Proteobacteria;Deltaproteobacteria;Syntrophorhabdales;Syntrophorhabdaceae;Syntrophorhabdus;Syntrophorhabdus aromaticivorans	144	2331	562	140	111	16	6	10	3320
Bacteria;Bacteria_none;Firmicutes;Bacilli;Bacillales;Paenibacillaceae;Paenibacillus;Paenibacillus polymyxa	302	544	755	742	234	400	169	134	3280
Bacteria;Bacteria_none;Firmicutes;Clostridia;Eubacteriales;Oscillospiraceae;Ruminococcus;Ruminococcus champanellensis	437	1425	356	351	383	115	48	62	3177
Bacteria;Bacteria_none;Firmicutes;Bacilli;Bacillales;Paenibacillaceae;Paenibacillus;Paenibacillus graminis	5	130	1453	303	293	883	43	36	3146
Bacteria;Bacteria_none;Firmicutes;Clostridia;Eubacteriales;Peptostreptococcaceae;Romboutsia;Romboutsia lituseburensis	215	421	660	802	187	262	228	259	3034
Bacteria;Bacteria_none;Firmicutes;Clostridia;Eubacteriales;Oscillospiraceae;Pseudoclostridium;Pseudoclostridium thermosuccinogenes	16	58	1640	141	511	528	46	21	2961
Bacteria;Bacteria_none;Proteobacteria;Alphaproteobacteria;Rhodospirillales;Acetobacteraceae;Acidomonas;Acidomonas methanolica	6	43	383	1840	26	237	330	44	2909
Bacteria;Bacteria_none;Firmicutes;Tissierellia;Tissierellales;Tissierellaceae;Sporanaerobacter;Sporanaerobacter acetigenes	5	2	527	359	123	181	68	1632	2897
Bacteria;Bacteria_none;Firmicutes;Clostridia;Eubacteriales;Oscillospiraceae;Monoglobus;Monoglobus pectinilyticus	177	1033	1045	72	140	377	23	23	2890
Bacteria;Bacteria_none;Bacteroidota;Bacteroidia;Bacteroidales;Bacteroidaceae;Bacteroides;Bacteroides caccae	0	0	224	1893	64	58	374	255	2868
Bacteria;Bacteria_none;Firmicutes;Clostridia;Eubacteriales;Clostridiaceae;Clostridium;Clostridium perfringens	178	344	520	982	199	218	224	190	2855
Bacteria;Bacteria_none;Firmicutes;Bacilli;Lactobacillales;Streptococcaceae;Streptococcus;Streptococcus ferus	1541	331	214	424	73	58	149	64	2854
Bacteria;Bacteria_none;Bacteroidota;Bacteroidia;Bacteroidales;Prevotellaceae;Prevotella;Prevotella nigrescens	87	1037	1144	38	280	194	11	43	2834
Bacteria;Bacteria_none;Proteobacteria;Alphaproteobacteria;Hyphomicrobiales;Kaistiaceae;Prosthecomicrobium;Prosthecomicrobium hirschii	316	1162	218	831	19	101	134	39	2820
Bacteria;Bacteria_none;Firmicutes;Clostridia;Eubacteriales;Oscillospiraceae;Acetivibrio;Acetivibrio thermocellus	38	33	1676	87	452	456	36	31	2809
Bacteria;Bacteria_none;Firmicutes;Tissierellia;Tissierellia_Incertae_sedis;Tissierellia_Incertae_sedis;Sedimentibacter;Sedimentibacter acidaminivorans	22	407	1470	79	310	323	39	97	2747
Bacteria;Bacteria_none;Firmicutes;Clostridia;Eubacteriales;Oscillospiraceae;Acetivibrio;Acetivibrio saccincola	9	94	1823	51	73	664	19	5	2738
Bacteria;Bacteria_none;Firmicutes;Clostridia;Eubacteriales;Lachnospiraceae;Butyrivibrio;Butyrivibrio fibrisolvens	434	51	863	472	265	353	167	114	2719
Bacteria;Bacteria_none;Proteobacteria;Gammaproteobacteria;Pasteurellales;Pasteurellaceae;Rodentibacter;Rodentibacter rarus	203	874	603	494	87	6	39	341	2647
Bacteria;Bacteria_none;Firmicutes;Clostridia;Eubacteriales;Oscillospiraceae;Vescimonas;Vescimonas coprocola	157	128	992	479	263	252	164	81	2516
Bacteria;Bacteria_none;Proteobacteria;Alphaproteobacteria;Hyphomicrobiales;Hyphomicrobiaceae;Hyphomicrobium;Hyphomicrobium denitrificans	577	814	420	367	83	150	39	23	2473
Bacteria;Bacteria_none;Proteobacteria;Betaproteobacteria;Rhodocyclales;Rhodocyclaceae;Azospira;Azospira restricta	1533	479	128	89	66	110	20	31	2456
Bacteria;Bacteria_none;Firmicutes;Clostridia;Eubacteriales;Oscillospiraceae;Fumia;Fumia xinanensis	245	2085	42	28	13	24	4	6	2447
Bacteria;Bacteria_none;Proteobacteria;Gammaproteobacteria;Xanthomonadales;Rhodanobacteraceae;Dokdonella;Dokdonella immobilis	2226	70	15	68	1	9	12	25	2426
Bacteria;Bacteria_none;Firmicutes;Clostridia;Eubacteriales;Peptostreptococcaceae;Paeniclostridium;Paeniclostridium sordellii	86	142	407	460	116	1011	84	120	2426
Bacteria;Bacteria_none;Firmicutes;Bacilli;Bacillales;Bacillaceae;Evansella;Evansella caseinilytica	0	1	1956	32	244	169	12	4	2418
Bacteria;Bacteria_none;Firmicutes;Clostridia;Eubacteriales;Peptostreptococcaceae;Terrisporobacter;Terrisporobacter mayombei	158	303	505	618	145	243	146	218	2336
Bacteria;Bacteria_none;Firmicutes;Clostridia;Eubacteriales;Oscillospiraceae;Thermoclostridium;Thermoclostridium caenicola	3	27	148	227	43	1805	29	12	2294
Bacteria;Bacteria_none;Firmicutes;Bacilli;Lactobacillales;Streptococcaceae;Lactococcus;Lactococcus chungangensis	1770	127	119	146	24	7	37	36	2266
Bacteria;Bacteria_none;Bacteroidota;Chitinophagia;Chitinophagales;Chitinophagaceae;Ferruginibacter;Ferruginibacter yonginensis	1854	263	27	44	8	11	9	14	2230
Bacteria;Bacteria_none;Firmicutes;Clostridia;Eubacteriales;Oscillospiraceae;Saccharofermentans;Saccharofermentans acetigenes	114	1409	377	75	44	102	30	18	2169
Bacteria;Bacteria_none;Proteobacteria;Betaproteobacteria;Burkholderiales;Comamonadaceae;Acidovorax;Acidovorax defluvii	1759	158	90	25	39	34	16	43	2164
Bacteria;Bacteria_none;Proteobacteria;Betaproteobacteria;Neisseriales;Neisseriaceae;Uruburuella;Uruburuella suis	1611	86	52	300	13	28	35	24	2149
Bacteria;Bacteria_none;Proteobacteria;Gammaproteobacteria;Xanthomonadales;Rhodanobacteraceae;Mizugakiibacter;Mizugakiibacter sediminis	1458	463	66	81	22	12	22	15	2139
Bacteria;Bacteria_none;Bacteroidota;Bacteroidia;Bacteroidales;Rikenellaceae;Alistipes;Alistipes finegoldii	18	1352	433	82	97	101	18	30	2131
Bacteria;Bacteria_none;Proteobacteria;Alphaproteobacteria;Rhodobacterales;Rhodobacteraceae;Tabrizicola;Tabrizicola piscis	603	505	354	379	74	121	43	13	2092
Bacteria;Bacteria_none;Proteobacteria;Betaproteobacteria;Burkholderiales;Comamonadaceae;Polaromonas;Polaromonas hydrogenivorans	1082	534	167	66	50	88	21	24	2032
Bacteria;Bacteria_none;Firmicutes;Negativicutes;Acidaminococcales;Acidaminococcaceae;Acidaminococcus;Acidaminococcus provencensis	662	55	375	309	129	212	164	104	2010
Bacteria;Bacteria_none;Firmicutes;Negativicutes;Veillonellales;Veillonellaceae;Veillonella;Veillonella magna	1455	274	119	82	7	19	22	25	2003
Bacteria;Bacteria_none;Proteobacteria;Betaproteobacteria;Burkholderiales;Comamonadaceae;Brachymonas;Brachymonas denitrificans	841	311	334	138	114	175	61	21	1995
Bacteria;Bacteria_none;Firmicutes;Clostridia;Eubacteriales;Peptostreptococcaceae;Sporacetigenium;Sporacetigenium mesophilum	2	13	246	265	52	1332	37	29	1976
Bacteria;Bacteria_none;Firmicutes;Bacilli;Lactobacillales;Streptococcaceae;Streptococcus;Streptococcus ictaluri	1039	215	163	277	43	43	87	40	1907
Bacteria;Bacteria_none;Firmicutes;Bacilli;Lactobacillales;Streptococcaceae;Streptococcus;Streptococcus suis	1622	68	31	82	9	1	12	20	1845
Bacteria;Bacteria_none;Bacteroidota;Bacteroidia;Bacteroidales;Bacteroidaceae;Bacteroides;Bacteroides ilei	60	503	372	442	82	179	73	106	1817
Bacteria;Bacteria_none;Planctomycetota;Planctomycetia;Gemmatales;Gemmataceae;Limnoglobus;Limnoglobus roseus	1311	343	33	59	21	22	9	8	1806
Bacteria;Bacteria_none;Firmicutes;Clostridia;Eubacteriales;Eubacteriaceae;Acetobacterium;Acetobacterium wieringae	631	353	192	310	71	87	67	90	1801
Bacteria;Bacteria_none;Proteobacteria;Betaproteobacteria;Burkholderiales;Sphaerotilaceae;Piscinibacter;Piscinibacter defluvii	1689	43	21	5	4	5	1	3	1771
Bacteria;Bacteria_none;Firmicutes;Clostridia;Eubacteriales;Oscillospiraceae;Sporobacter;Sporobacter termitidis	297	177	514	274	154	168	94	86	1764
Bacteria;Bacteria_none;Firmicutes;Clostridia;Eubacteriales;Lachnospiraceae;Butyrivibrio;Butyrivibrio hungatei	201	59	719	231	200	239	72	41	1762
Bacteria;Bacteria_none;Proteobacteria;Betaproteobacteria;Burkholderiales;Comamonadaceae;Acidovorax;Acidovorax temperans	1448	84	64	44	18	36	2	19	1715
Bacteria;Bacteria_none;Proteobacteria;Deltaproteobacteria;Desulfovibrionales;Desulfovibrionaceae;Halodesulfovibrio;Halodesulfovibrio aestuarii	166	1532	14	0	0	2	0	0	1714
Bacteria;Bacteria_none;Bacteroidota;Bacteroidia;Bacteroidales;Rikenellaceae;Alistipes;Alistipes indistinctus	92	1575	6	20	3	2	3	8	1709
Bacteria;Bacteria_none;Firmicutes;Bacilli;Lactobacillales;Streptococcaceae;Lactococcus;Lactococcus plantarum	1306	61	64	144	25	17	42	40	1699
Bacteria;Bacteria_none;Proteobacteria;Betaproteobacteria;Burkholderiales;Comamonadaceae;Simplicispira;Simplicispira limi	1127	402	70	37	13	16	19	12	1696
Bacteria;Bacteria_none;Chloroflexi;Anaerolineae;Anaerolineales;Anaerolineaceae;Flexilinea;Flexilinea flocculi	17	249	920	44	354	45	21	40	1690
Bacteria;Bacteria_none;Firmicutes;Clostridia;Eubacteriales;Lachnospiraceae;Syntrophococcus;Syntrophococcus sucromutans	40	67	651	263	119	395	63	66	1664
Bacteria;Bacteria_none;Chloroflexi;Anaerolineae;Anaerolineales;Anaerolineaceae;Levilinea;Levilinea saccharolytica	23	237	794	165	111	179	68	51	1628
Bacteria;Bacteria_none;Bacteroidota;Bacteroidia;Bacteroidales;Dysgonomonadaceae;Seramator;Seramator thermalis	26	201	278	413	85	488	68	63	1622
Bacteria;Bacteria_none;Bacteroidota;Bacteroidia;Bacteroidales;Paludibacteraceae;Paludibacter;Paludibacter jiangxiensis	3	108	679	259	330	22	61	118	1580
Bacteria;Bacteria_none;Firmicutes;Negativicutes;Selenomonadales;Selenomonadaceae;Selenomonas;Selenomonas sputigena	170	25	160	434	48	61	566	112	1576
Bacteria;Bacteria_none;Firmicutes;Negativicutes;Veillonellales;Veillonellaceae;Megasphaera;Megasphaera stantonii	9	1	1	661	1	1	100	791	1565
Bacteria;Bacteria_none;Actinobacteria;Thermoleophilia;Solirubrobacterales;Solirubrobacteraceae;Solirubrobacter;Solirubrobacter soli	159	192	259	761	26	81	51	27	1556
Bacteria;Bacteria_none;Firmicutes;Clostridia;Eubacteriales;Christensenellaceae;Luoshenia;Luoshenia tenuis	171	581	439	50	107	173	12	19	1552
Bacteria;Bacteria_none;Proteobacteria;Betaproteobacteria;Burkholderiales;Comamonadaceae;Simplicispira;Simplicispira hankyongi	972	282	124	24	30	54	12	11	1509
Bacteria;Bacteria_none;Firmicutes;Clostridia;Eubacteriales;Eubacteriales_Incertae_sedis;Massilistercora;Massilistercora timonensis	1	0	118	1156	8	83	120	5	1491
Bacteria;Bacteria_none;Proteobacteria;Betaproteobacteria;Rhodocyclales;Zoogloeaceae;Zoogloea;Zoogloea ramigera	828	201	160	100	39	74	26	56	1484
Bacteria;Bacteria_none;Firmicutes;Clostridia;Eubacteriales;Eubacteriaceae;Acetobacterium;Acetobacterium malicum	538	385	154	195	25	50	107	11	1465
Bacteria;Bacteria_none;Bacteroidota;Bacteroidia;Bacteroidales;Bacteroidaceae;Bacteroides;Bacteroides ovatus	8	104	207	817	47	73	112	84	1452
Bacteria;Bacteria_none;Armatimonadetes;Armatimonadia;Armatimonadales;Armatimonadaceae;Armatimonas;Armatimonas rosea	27	213	748	76	116	214	18	36	1448
Bacteria;Bacteria_none;Proteobacteria;Alphaproteobacteria;Hyphomicrobiales;Aestuariivirgaceae;Aestuariivirga;Aestuariivirga litoralis	350	503	193	247	46	70	21	9	1439
Bacteria;Bacteria_none;Firmicutes;Clostridia;Thermosediminibacterales;Tepidanaerobacteraceae;Tepidanaerobacter;Tepidanaerobacter syntrophicus	3	3	122	913	15	188	136	45	1425
Bacteria;Bacteria_none;Firmicutes;Clostridia;Eubacteriales;Clostridiaceae;Clostridium;Clostridium butyricum	115	187	232	488	69	113	102	97	1403
Bacteria;Bacteria_none;Firmicutes;Clostridia;Eubacteriales;Oscillospiraceae;Petroclostridium;Petroclostridium xylanilyticum	21	272	564	219	148	95	35	19	1373
Bacteria;Bacteria_none;Firmicutes;Clostridia;Eubacteriales;Desulfotomaculaceae;Cryptanaerobacter;Cryptanaerobacter phenolicus	8	779	262	102	39	108	33	2	1333
Bacteria;Bacteria_none;Firmicutes;Clostridia;Eubacteriales;Syntrophomonadaceae;Syntrophothermus;Syntrophothermus lipocalidus	4	4	502	87	25	571	54	61	1308
Bacteria;Bacteria_none;Firmicutes;Negativicutes;Acidaminococcales;Acidaminococcaceae;Acidaminococcus;Acidaminococcus intestini	392	40	248	208	72	130	117	77	1284
Bacteria;Bacteria_none;Firmicutes;Clostridia;Eubacteriales;Oscillospiraceae;Ethanoligenens;Ethanoligenens harbinense	111	847	108	58	37	55	30	16	1262
Bacteria;Bacteria_none;Bacteroidota;Bacteroidia;Bacteroidales;Rikenellaceae;Gallalistipes;Gallalistipes aquisgranensis	73	1109	9	41	4	4	3	3	1246
Bacteria;Bacteria_none;Proteobacteria;Betaproteobacteria;Neisseriales;Neisseriaceae;Vitreoscilla;Vitreoscilla stercoraria	831	20	15	312	9	3	28	13	1231
Bacteria;Bacteria_none;Firmicutes;Negativicutes;Veillonellales;Veillonellaceae;Megasphaera;Megasphaera micronuciformis	56	7	211	507	37	98	181	104	1201
Bacteria;Bacteria_none;Firmicutes;Clostridia;Eubacteriales;Oscillospiraceae;Pseudoruminococcus;Pseudoruminococcus massiliensis	174	591	204	50	36	104	14	11	1184
Bacteria;Bacteria_none;Firmicutes;Clostridia;Eubacteriales;Peptostreptococcaceae;Paeniclostridium;[Eubacterium] tenue	84	164	295	293	59	117	80	90	1182
Bacteria;Bacteria_none;Proteobacteria;Betaproteobacteria;Burkholderiales;Comamonadaceae;Ottowia;Ottowia testudinis	666	185	105	73	33	68	12	25	1167
Bacteria;Bacteria_none;Proteobacteria;Betaproteobacteria;Burkholderiales;Comamonadaceae;Comamonas;Comamonas fluminis	652	34	143	115	29	119	40	14	1146
Bacteria;Bacteria_none;Firmicutes;Negativicutes;Selenomonadales;Selenomonadaceae;Anaerovibrio;Anaerovibrio lipolyticus	102	21	101	303	33	66	428	76	1130
Bacteria;Bacteria_none;Proteobacteria;Alphaproteobacteria;Rhodospirillales;Geminicoccaceae;Arboricoccus;Arboricoccus pini	310	422	155	120	28	45	20	5	1105
Bacteria;Bacteria_none;Firmicutes;Clostridia;Eubacteriales;Peptostreptococcaceae;Tepidibacter;Tepidibacter formicigenes	14	15	835	31	181	14	4	11	1105
Bacteria;Bacteria_none;Proteobacteria;Betaproteobacteria;Burkholderiales;Burkholderiaceae;Cupriavidus;Cupriavidus basilensis	714	184	74	61	15	37	14	5	1104
Bacteria;Bacteria_none;Firmicutes;Clostridia;Eubacteriales;Oscillospiraceae;Fastidiosipila;Fastidiosipila sanguinis	61	144	372	125	68	238	47	45	1100
Bacteria;Bacteria_none;Firmicutes;Clostridia;Eubacteriales;Clostridiaceae;Falcatimonas;Falcatimonas natans	742	37	218	24	27	39	4	6	1097
Bacteria;Bacteria_none;Firmicutes;Clostridia;Eubacteriales;Clostridiaceae;Clostridium;Clostridium vincentii	468	73	120	230	41	42	55	64	1093
Bacteria;Bacteria_none;Firmicutes;Clostridia;Eubacteriales;Oscillospiraceae;Ercella;Ercella succinigenes	31	628	178	91	39	72	11	14	1064
Bacteria;Bacteria_none;Firmicutes;Clostridia;Eubacteriales;Eubacteriales Family XIII. Incertae Sedis;Sinanaerobacter;Sinanaerobacter chloroacetimidivorans	27	57	379	72	23	436	44	19	1057
Bacteria;Bacteria_none;Firmicutes;Negativicutes;Veillonellales;Veillonellaceae;Veillonella;Veillonella montpellierensis	773	126	53	53	10	17	11	8	1051
Bacteria;Bacteria_none;Firmicutes;Clostridia;Eubacteriales;Eubacteriaceae;Acetobacterium;Acetobacterium tundrae	363	301	91	133	33	49	23	57	1050
Bacteria;Bacteria_none;Spirochaetes;Spirochaetia;Spirochaetales;Rectinemataceae;Rectinema;Rectinema cohabitans	26	65	297	360	39	71	85	104	1047
Bacteria;Bacteria_none;Firmicutes;Clostridia;Eubacteriales;Clostridiaceae;Sarcina;Sarcina ventriculi	99	141	209	293	54	83	88	62	1029
Bacteria;Bacteria_none;Proteobacteria;Betaproteobacteria;Burkholderiales;Comamonadaceae;Ottowia;Ottowia pentelensis	543	169	124	50	23	69	19	25	1022
Bacteria;Bacteria_none;Proteobacteria;Alphaproteobacteria;Hyphomicrobiales;Nitrobacteraceae;Bradyrhizobium;Bradyrhizobium cenepequi	271	327	112	225	24	22	23	18	1022
Bacteria;Bacteria_none;Firmicutes;Clostridia;Eubacteriales;Oscillospiraceae;Acetivibrio;Acetivibrio cellulolyticus	0	11	705	19	33	245	1	2	1016
Bacteria;Bacteria_none;Planctomycetota;Planctomycetia;Pirellulales;Thermoguttaceae;Thermogutta;Thermogutta terrifontis	8	24	84	699	24	100	56	9	1004
Bacteria;Bacteria_none;Bacteroidota;Bacteroidia;Bacteroidales;Porphyromonadaceae;Porphyromonas;Porphyromonas pasteri	0	0	116	571	35	37	142	96	997
Bacteria;Bacteria_none;Firmicutes;Clostridia;Eubacteriales;Oscillospiraceae;Vescimonas;Vescimonas fastidiosa	71	52	377	208	95	103	56	34	996
Bacteria;Bacteria_none;Firmicutes;Bacilli;Bacillales;Bacillales Family X. Incertae Sedis;Brockia;Brockia lithotrophica	1	57	403	141	100	246	17	16	981
Bacteria;Bacteria_none;Firmicutes;Clostridia;Eubacteriales;Oscillospiraceae;Faecalibacterium;Faecalibacterium gallinarum	277	45	98	227	71	58	144	56	976
Bacteria;Bacteria_none;Firmicutes;Clostridia;Eubacteriales;Eubacteriaceae;Acetobacterium;Acetobacterium paludosum	207	229	174	157	25	127	0	51	970
Bacteria;Bacteria_none;Proteobacteria;Alphaproteobacteria;Rhodobacterales;Rhodobacteraceae;Amaricoccus;Amaricoccus tamworthensis	189	142	159	335	32	54	43	16	970
Bacteria;Bacteria_none;Firmicutes;Negativicutes;Selenomonadales;Sporomusaceae;Anaerosinus;Anaerosinus glycerini	330	381	148	23	17	44	3	17	963
Bacteria;Bacteria_none;Firmicutes;Clostridia;Thermoanaerobacterales;Thermoanaerobacterales Family III. Incertae Sedis;Caldicellulosiruptor;Caldicellulosiruptor acetigenus	0	23	748	24	85	60	9	4	953
Bacteria;Bacteria_none;Synergistetes;Synergistia;Synergistales;Synergistaceae;Acetomicrobium;Acetomicrobium mobile	0	0	53	489	2	298	88	19	949
Bacteria;Bacteria_none;Firmicutes;Clostridia;Eubacteriales;Peptostreptococcaceae;Romboutsia;[Clostridium] dakarense	67	146	205	253	60	78	58	75	942
Bacteria;Bacteria_none;Firmicutes;Bacilli;Bacillales;Thermoactinomycetaceae;Lihuaxuella;Lihuaxuella thermophila	0	0	747	7	98	78	11	1	942
Bacteria;Bacteria_none;Chloroflexi;Anaerolineae;Anaerolineales;Anaerolineaceae;Bellilinea;Bellilinea caldifistulae	2	47	740	81	37	10	12	9	938
Bacteria;Bacteria_none;Nitrospirae;Nitrospira;Nitrospirales;Nitrospiraceae;Nitrospira;Nitrospira moscoviensis	685	240	0	1	0	1	0	0	927
Bacteria;Bacteria_none;Proteobacteria;Deltaproteobacteria;Syntrophales;Syntrophaceae;Syntrophus;Syntrophus aciditrophicus	13	642	62	12	173	11	4	9	926
Bacteria;Bacteria_none;Firmicutes;Clostridia;Eubacteriales;Lachnospiraceae;Blautia;Blautia argi	88	73	362	143	68	131	32	25	922
Bacteria;Bacteria_none;Proteobacteria;Betaproteobacteria;Burkholderiales;Comamonadaceae;Acidovorax;Acidovorax anthurii	698	97	49	19	7	32	3	9	914
Bacteria;Bacteria_none;Firmicutes;Clostridia;Eubacteriales;Eubacteriaceae;Acetobacterium;Acetobacterium fimetarium	311	156	78	114	42	71	93	45	910
Bacteria;Bacteria_none;Bacteroidota;Bacteroidia;Bacteroidales;Bacteroidaceae;Phocaeicola;Phocaeicola sartorii	3	49	149	547	10	61	66	25	910
Bacteria;Bacteria_none;Firmicutes;Clostridia;Eubacteriales;Oscillospiraceae;Marasmitruncus;Marasmitruncus massiliensis	21	834	21	13	0	9	3	6	907
Bacteria;Bacteria_none;Bacteroidota;Chitinophagia;Chitinophagales;Chitinophagaceae;Terrimonas;Terrimonas terrae	660	85	43	71	2	14	8	21	904
Bacteria;Bacteria_none;Proteobacteria;Gammaproteobacteria;Enterobacterales;Enterobacteriaceae;Citrobacter;Citrobacter koseri	638	43	20	118	5	16	28	28	896
Bacteria;Bacteria_none;Bacteroidota;Bacteroidia;Bacteroidales;Paludibacteraceae;Paludibacter;Paludibacter propionicigenes	25	67	367	147	165	12	37	74	894
Bacteria;Bacteria_none;Firmicutes;Clostridia;Eubacteriales;Lachnospiraceae;Johnsonella;Johnsonella ignava	176	20	237	213	80	75	51	39	891
Bacteria;Bacteria_none;Firmicutes;Bacilli;Lactobacillales;Streptococcaceae;Streptococcus;Streptococcus parasuis	802	21	21	24	2	7	5	6	888
Bacteria;Bacteria_none;Firmicutes;Clostridia;Eubacteriales;Syntrophomonadaceae;Syntrophomonas;Syntrophomonas sapovorans	7	189	393	118	17	119	18	27	888
Bacteria;Bacteria_none;Bacteroidota;Bacteroidia;Bacteroidales;Williamwhitmaniaceae;Williamwhitmania;Williamwhitmania taraxaci	13	68	431	65	141	139	11	20	888
Bacteria;Bacteria_none;Firmicutes;Negativicutes;Acidaminococcales;Acidaminococcaceae;Phascolarctobacterium;Phascolarctobacterium wakonense	277	4	111	194	45	80	94	73	878
Bacteria;Bacteria_none;Proteobacteria;Alphaproteobacteria;Hyphomicrobiales;Hyphomicrobiales_Incertae_sedis;Pseudorhodoplanes;Pseudorhodoplanes sinuspersici	126	245	149	205	53	53	31	16	878
Bacteria;Bacteria_none;Planctomycetota;Planctomycetia;Gemmatales;Gemmataceae;Fimbriiglobus;Fimbriiglobus ruber	607	217	11	15	3	14	3	6	876
Bacteria;Bacteria_none;Proteobacteria;Betaproteobacteria;Burkholderiales;Comamonadaceae;Comamonas;Comamonas faecalis	64	5	206	11	116	452	10	10	874
Bacteria;Bacteria_none;Firmicutes;Clostridia;Eubacteriales;Peptococcaceae;Thermanaerosceptrum;Thermanaerosceptrum fracticalcis	0	4	562	149	17	31	58	51	872
Bacteria;Bacteria_none;Proteobacteria;Deltaproteobacteria;Desulfobacterales;Desulfobacteraceae;Desulfotignum;Desulfotignum toluenicum	16	362	60	0	425	0	0	0	863
Bacteria;Bacteria_none;Proteobacteria;Alphaproteobacteria;Hyphomicrobiales;Methylocystaceae;Methylocystis;Methylocystis heyeri	215	312	144	116	24	34	11	6	862
Bacteria;Bacteria_none;Nitrospirae;Thermodesulfovibrionia;Thermodesulfovibrionales;Thermodesulfovibrionaceae;Thermodesulfovibrio;Thermodesulfovibrio thiophilus	0	0	11	646	0	82	120	1	860
Bacteria;Bacteria_none;Firmicutes;Bacilli;Bacillales;Bacillaceae;Bacillus;Bacillus pseudoflexus	4	39	449	125	90	116	22	8	853
Bacteria;Bacteria_none;Planctomycetota;Planctomycetia;Planctomycetales;Planctomycetaceae;Thalassoroseus;Thalassoroseus pseudoceratinae	134	136	128	210	75	83	48	36	850
Bacteria;Bacteria_none;Proteobacteria;Deltaproteobacteria;Myxococcales;Sandaracinaceae;Sandaracinus;Sandaracinus amylolyticus	91	143	212	201	29	3	18	152	849
Bacteria;Bacteria_none;Firmicutes;Clostridia;Eubacteriales;Lachnospiraceae;Fusicatenibacter;Fusicatenibacter saccharivorans	630	30	63	56	11	26	13	18	847
Bacteria;Bacteria_none;Bacteroidota;Bacteroidia;Bacteroidales;Bacteroidaceae;Bacteroides;Bacteroides acidifaciens	11	91	144	409	19	63	56	47	840
Bacteria;Bacteria_none;Proteobacteria;Betaproteobacteria;Burkholderiales;Comamonadaceae;Ottowia;Ottowia flava	528	138	70	18	23	30	7	17	831
Bacteria;Bacteria_none;Firmicutes;Clostridia;Eubacteriales;Xylanivirgaceae;Xylanivirga;Xylanivirga thermophila	13	104	347	72	73	187	13	16	825
Bacteria;Bacteria_none;Proteobacteria;Betaproteobacteria;Burkholderiales;Comamonadaceae;Polaromonas;Polaromonas naphthalenivorans	433	231	38	23	33	35	2	13	808
Bacteria;Bacteria_none;Bacteroidota;Bacteroidia;Bacteroidales;Bacteroidaceae;Bacteroides;Bacteroides thetaiotaomicron	22	93	112	400	21	57	48	54	807
Bacteria;Bacteria_none;Proteobacteria;Alphaproteobacteria;Hyphomicrobiales;Rhizobiaceae;Shinella;Shinella fusca	237	67	148	255	20	50	12	17	806
Bacteria;Bacteria_none;Proteobacteria;Alphaproteobacteria;Hyphomicrobiales;Rhizobiaceae;Shinella;Shinella kummerowiae	170	154	138	223	47	32	21	18	803
Bacteria;Bacteria_none;Firmicutes;Clostridia;Eubacteriales;Eubacteriales Family XIII. Incertae Sedis;Lentihominibacter;Lentihominibacter faecis	43	59	145	310	48	96	70	31	802
Bacteria;Bacteria_none;Proteobacteria;Epsilonproteobacteria;Campylobacterales;Arcobacteraceae;Aliarcobacter;Aliarcobacter skirrowii	109	99	86	207	21	74	64	142	802
Bacteria;Bacteria_none;Firmicutes;Bacilli;Bacillales;Bacillaceae;Mesobacillus;Mesobacillus subterraneus	4	91	136	237	31	241	42	15	797
Bacteria;Bacteria_none;Synergistetes;Synergistetes_Incertae_sedis;Synergistetes_Incertae_sedis;Thermosynergistaceae;Thermosynergistes;Thermosynergistes pyruvativorans	4	48	320	259	35	58	45	27	796
Bacteria;Bacteria_none;Proteobacteria;Alphaproteobacteria;Rhodobacterales;Rhodobacteraceae;Paracoccus;Paracoccus mutanolyticus	255	155	111	190	26	34	15	8	794
Bacteria;Bacteria_none;Firmicutes;Clostridia;Eubacteriales;Clostridiaceae;Clostridium;Clostridium chauvoei	63	92	137	277	42	68	57	56	792
Bacteria;Bacteria_none;Firmicutes;Bacilli;Lactobacillales;Streptococcaceae;Lactococcus;Lactococcus lactis	533	66	55	74	16	12	17	15	788
Bacteria;Bacteria_none;Firmicutes;Clostridia;Eubacteriales;Oscillospiraceae;Pseudobacteroides;Pseudobacteroides cellulosolvens	10	56	146	12	423	129	4	3	783
Bacteria;Bacteria_none;Firmicutes;Clostridia;Eubacteriales;Eubacteriales_Incertae_sedis;Gemmiger;Gemmiger gallinarum	72	249	117	39	18	265	15	7	782
Bacteria;Bacteria_none;Firmicutes;Clostridia;Eubacteriales;Oscillospiraceae;Neglectibacter;Neglectibacter timonensis	224	216	146	79	39	40	14	21	779
Bacteria;Bacteria_none;Bacteroidota;Bacteroidia;Bacteroidales;Bacteroidaceae;Bacteroides;Bacteroides sedimenti	37	355	104	150	26	50	14	42	778
Bacteria;Bacteria_none;Proteobacteria;Gammaproteobacteria;Xanthomonadales;Xanthomonadaceae;Lysobacter;Lysobacter tongrenensis	506	191	25	30	4	1	7	10	774
Bacteria;Bacteria_none;Firmicutes;Negativicutes;Veillonellales;Veillonellaceae;Veillonella;Veillonella massiliensis	557	92	54	27	3	12	8	8	761
Bacteria;Bacteria_none;Firmicutes;Clostridia;Eubacteriales;Oscillospiraceae;Thermoclostridium;Thermoclostridium stercorarium	6	104	197	55	50	320	18	11	761
Bacteria;Bacteria_none;Firmicutes;Negativicutes;Selenomonadales;Selenomonadaceae;Anaerovibrio;Anaerovibrio slackiae	65	17	79	227	22	29	270	48	757
Bacteria;Bacteria_none;Firmicutes;Clostridia;Eubacteriales;Lachnospiraceae;Lachnoclostridium;[Clostridium] fimetarium	561	12	85	54	6	14	14	6	752
Bacteria;Bacteria_none;Proteobacteria;Alphaproteobacteria;Hyphomicrobiales;Reyranellaceae;Reyranella;Reyranella massiliensis	217	199	106	166	15	25	10	11	749
Bacteria;Bacteria_none;Firmicutes;Clostridia;Eubacteriales;Oscillospiraceae;Acetivibrio;Acetivibrio clariflavus	3	30	406	59	39	182	8	21	748
Bacteria;Bacteria_none;Proteobacteria;Alphaproteobacteria;Rhodobacterales;Rhodobacteraceae;Rhodobacter;Rhodobacter tardus	181	170	108	176	19	63	21	8	746
Bacteria;Bacteria_none;Firmicutes;Clostridia;Eubacteriales;Oscillospiraceae;Ruminococcus;Ruminococcus bromii	507	65	35	72	9	17	19	20	744
Bacteria;Bacteria_none;Proteobacteria;Gammaproteobacteria;Oceanospirillales;Oceanospirillaceae;Motiliproteus;Motiliproteus sediminis	2	11	97	491	2	50	66	13	732
Bacteria;Bacteria_none;Proteobacteria;Alphaproteobacteria;Rhodobacterales;Rhodobacteraceae;Paracoccus;Paracoccus lutimaris	258	112	109	175	7	31	21	17	730
Bacteria;Bacteria_none;Proteobacteria;Gammaproteobacteria;Legionellales;Coxiellaceae;Coxiella;Coxiella burnetii	80	588	30	17	6	5	2	2	730
Bacteria;Bacteria_none;Firmicutes;Clostridia;Eubacteriales;Christensenellaceae;Christensenella;Christensenella timonensis	79	455	38	27	24	85	7	12	727
Bacteria;Bacteria_none;Chloroflexi;Anaerolineae;Anaerolineales;Anaerolineaceae;Leptolinea;Leptolinea tardivitalis	22	148	333	82	49	49	21	18	722
Bacteria;Bacteria_none;Planctomycetota;Phycisphaerae;Phycisphaerales;Phycisphaeraceae;Phycisphaera;Phycisphaera mikurensis	6	4	320	87	42	233	5	23	720
Bacteria;Bacteria_none;Firmicutes;Clostridia;Eubacteriales;Eubacteriales Family XIII. Incertae Sedis;Bacilliculturomica;Bacilliculturomica massiliensis	20	121	281	121	72	69	20	12	716
Bacteria;Bacteria_none;Armatimonadetes;Chthonomonadetes;Chthonomonadales;Chthonomonadaceae;Chthonomonas;Chthonomonas calidirosea	11	72	403	32	107	63	14	12	714
Bacteria;Bacteria_none;Bacteroidota;Sphingobacteriia;Sphingobacteriales;Sphingobacteriaceae;Pedobacter;Pedobacter pollutisoli	3	23	115	426	4	55	52	35	713
Bacteria;Bacteria_none;Planctomycetota;Planctomycetia;Planctomycetales;Planctomycetaceae;Caulifigura;Caulifigura coniformis	228	153	60	153	28	40	22	21	705
Bacteria;Bacteria_none;Firmicutes;Clostridia;Eubacteriales;Clostridiaceae;Clostridium;Clostridium paraputrificum	73	88	145	206	28	58	55	49	702
Bacteria;Bacteria_none;Firmicutes;Clostridia;Eubacteriales;Oscillospiraceae;Oscillospiraceae_Incertae_sedis;[Clostridium] leptum	94	544	15	19	5	9	5	7	698
Bacteria;Bacteria_none;Proteobacteria;Betaproteobacteria;Burkholderiales;Comamonadaceae;Comamonas;Comamonas nitrativorans	4	0	171	49	126	339	4	5	698
Bacteria;Bacteria_none;Firmicutes;Clostridia;Eubacteriales;Oscillospiraceae;Dysosmobacter;Dysosmobacter acutus	70	34	227	119	67	72	29	69	687
Bacteria;Bacteria_none;Proteobacteria;Betaproteobacteria;Rhodocyclales;Rhodocyclaceae;Propionivibrio;Propionivibrio militaris	404	129	34	37	26	44	8	3	685
Bacteria;Bacteria_none;Firmicutes;Clostridia;Eubacteriales;Oscillospiraceae;Ruminococcus;Ruminococcus callidus	53	265	61	94	81	84	13	33	684
Bacteria;Bacteria_none;Proteobacteria;Alphaproteobacteria;Hyphomicrobiales;Methylocystaceae;Hansschlegelia;Hansschlegelia zhihuaiae	179	215	102	118	24	25	10	3	676
Bacteria;Bacteria_none;Nitrospirae;Nitrospira;Nitrospirales;Nitrospiraceae;Nitrospira;Nitrospira japonica	568	105	0	0	0	1	0	0	674
Bacteria;Bacteria_none;Planctomycetota;Planctomycetia;Gemmatales;Gemmataceae;Urbifossiella;Urbifossiella limnaea	480	136	10	30	2	9	2	4	673
Bacteria;Bacteria_none;Firmicutes;Clostridia;Eubacteriales;Eubacteriales Family XIII. Incertae Sedis;Aminipila;Aminipila terrae	9	41	205	148	45	146	64	12	670
Bacteria;Bacteria_none;Bacteroidota;Bacteroidia;Bacteroidales;Bacteroidaceae;Bacteroides;Bacteroides propionicifaciens	100	533	4	16	1	7	1	3	665
Bacteria;Bacteria_none;Bacteroidota;Bacteroidia;Bacteroidales;Prevotellaceae;Alloprevotella;Alloprevotella tannerae	0	1	69	385	19	13	111	59	657
Bacteria;Bacteria_none;Proteobacteria;Betaproteobacteria;Burkholderiales;Comamonadaceae;Pseudacidovorax;Pseudacidovorax intermedius	418	168	29	16	4	7	6	8	656
Bacteria;Bacteria_none;Synergistetes;Synergistia;Synergistales;Synergistaceae;Cloacibacillus;Cloacibacillus porcorum	19	272	267	17	33	27	7	11	653
Bacteria;Bacteria_none;Actinobacteria;Actinomycetia;Pseudonocardiales;Pseudonocardiaceae;Pseudonocardia;Pseudonocardia antarctica	7	11	20	534	5	0	61	12	650
Bacteria;Bacteria_none;Proteobacteria;Betaproteobacteria;Burkholderiales;Comamonadaceae;Ramlibacter;Ramlibacter solisilvae	294	201	51	25	23	43	5	5	647
Bacteria;Bacteria_none;Firmicutes;Clostridia;Thermoanaerobacterales;Thermoanaerobacterales Family III. Incertae Sedis;Syntrophaceticus;Syntrophaceticus schinkii	2	36	352	100	17	114	19	5	645
Bacteria;Bacteria_none;Proteobacteria;Betaproteobacteria;Burkholderiales;Burkholderiaceae;Quisquiliibacterium;Quisquiliibacterium transsilvanicum	393	138	52	15	11	20	5	7	641
Bacteria;Bacteria_none;Firmicutes;Bacilli;Lactobacillales;Streptococcaceae;Streptococcus;Streptococcus caballi	532	16	12	40	5	5	14	16	640
Bacteria;Bacteria_none;Bacteroidota;Bacteroidia;Marinilabiliales;Prolixibacteraceae;Mariniphaga;Mariniphaga sediminis	37	570	20	0	1	4	7	0	639
Bacteria;Bacteria_none;Actinobacteria;Actinomycetia;Corynebacteriales;Mycobacteriaceae;Mycolicibacterium;Mycolicibacterium confluentis	58	218	131	119	22	47	19	20	634
Bacteria;Bacteria_none;Firmicutes;Clostridia;Thermoanaerobacterales;Thermodesulfobiaceae;Thermodesulfobium;Thermodesulfobium acidiphilum	0	0	178	410	45	0	0	0	633
Bacteria;Bacteria_none;Proteobacteria;Alphaproteobacteria;Rhodobacterales;Rhodobacteraceae;Rhodobacter;Rhodobacter thermarum	267	142	70	105	8	16	12	9	629
Bacteria;Bacteria_none;Verrucomicrobia;Verrucomicrobiae;Verrucomicrobiales;Verrucomicrobia subdivision 3;Limisphaera;Limisphaera ngatamarikiensis	83	518	8	4	8	2	0	0	623
Bacteria;Bacteria_none;Synergistetes;Synergistia;Synergistales;Synergistaceae;Aminivibrio;Aminivibrio pyruvatiphilus	36	550	16	5	3	5	0	0	615
Bacteria;Bacteria_none;Proteobacteria;Betaproteobacteria;Burkholderiales;Comamonadaceae;Acidovorax;Acidovorax caeni	523	51	3	10	3	9	2	7	608
Bacteria;Bacteria_none;Firmicutes;Bacilli;Bacillales;Alicyclobacillaceae;Alicyclobacillus;Alicyclobacillus suci	0	25	293	62	47	151	12	6	596
Bacteria;Bacteria_none;Proteobacteria;Betaproteobacteria;Burkholderiales;Burkholderiaceae;Pandoraea;Pandoraea norimbergensis	331	105	62	29	21	26	9	6	589
Bacteria;Bacteria_none;Proteobacteria;Betaproteobacteria;Rhodocyclales;Zoogloeaceae;Zoogloea;Zoogloea resiniphila	354	57	46	40	23	39	14	13	586
Bacteria;Bacteria_none;Firmicutes;Negativicutes;Veillonellales;Veillonellaceae;Megasphaera;Megasphaera paucivorans	54	457	26	15	10	13	4	1	580
Bacteria;Bacteria_none;Bacteroidota;Bacteroidia;Bacteroidales;Rikenellaceae;Alistipes;Alistipes ihumii	22	172	265	6	65	41	3	5	579
Bacteria;Bacteria_none;Firmicutes;Clostridia;Eubacteriales;Desulfotomaculaceae;Pelotomaculum;Pelotomaculum propionicicum	0	52	288	57	32	133	13	3	578
Bacteria;Bacteria_none;Proteobacteria;Alphaproteobacteria;Hyphomicrobiales;Reyranellaceae;Reyranella;Reyranella terrae	110	138	124	129	21	40	11	3	576
Bacteria;Bacteria_none;Proteobacteria;Alphaproteobacteria;Hyphomicrobiales;Kaistiaceae;Bauldia;Bauldia consociata	87	123	87	196	24	24	16	16	573
Bacteria;Bacteria_none;Proteobacteria;Betaproteobacteria;Burkholderiales;Comamonadaceae;Acidovorax;Acidovorax konjaci	394	96	27	13	6	26	7	1	570
Bacteria;Bacteria_none;Firmicutes;Bacilli;Bacillales;Bacillaceae;Halobacillus;Halobacillus aidingensis	13	66	338	30	49	63	6	4	569
Bacteria;Bacteria_none;Proteobacteria;Betaproteobacteria;Burkholderiales;Comamonadaceae;Comamonas;Comamonas terrigena	314	63	50	26	21	82	4	3	563
Bacteria;Bacteria_none;Firmicutes;Clostridia;Eubacteriales;Christensenellaceae;Gehongia;Gehongia tenuis	70	423	31	11	8	15	3	1	562
Bacteria;Bacteria_none;Firmicutes;Negativicutes;Selenomonadales;Selenomonadaceae;Selenomonas;Selenomonas montiformis	57	4	63	154	9	27	118	124	556
Bacteria;Bacteria_none;Proteobacteria;Betaproteobacteria;Burkholderiales;Comamonadaceae;Acidovorax;Acidovorax delafieldii	438	44	35	8	5	13	7	2	552
Bacteria;Bacteria_none;Firmicutes;Clostridia;Eubacteriales;Oscillospiraceae;Ruminiclostridium;Ruminiclostridium cellobioparum	81	35	148	48	65	127	15	16	535
Bacteria;Bacteria_none;Actinobacteria;Actinomycetia;Propionibacteriales;Nocardioidaceae;Micropruina;Micropruina glycogenica	89	123	132	113	7	35	17	16	532
Bacteria;Bacteria_none;Firmicutes;Clostridia;Eubacteriales;Oscillospiraceae;Acetivibrio;Acetivibrio alkalicellulosi	7	173	226	19	28	70	7	0	530
Bacteria;Bacteria_none;Proteobacteria;Betaproteobacteria;Burkholderiales;Comamonadaceae;Comamonas;Comamonas badia	315	74	47	15	14	55	3	7	530
Bacteria;Bacteria_none;Proteobacteria;Betaproteobacteria;Burkholderiales;Comamonadaceae;Comamonas;Comamonas granuli	274	178	36	11	6	15	2	5	527
Bacteria;Bacteria_none;Proteobacteria;Alphaproteobacteria;Hyphomicrobiales;Hyphomicrobiales_Incertae_sedis;Nordella;Nordella oligomobilis	161	241	45	50	9	12	2	6	526
Bacteria;Bacteria_none;Planctomycetota;Planctomycetia;Pirellulales;Pirellulaceae;Aureliella;Aureliella helgolandensis	102	101	52	184	20	25	24	15	523
Bacteria;Bacteria_none;Firmicutes;Clostridia;Eubacteriales;Syntrophomonadaceae;Dethiobacter;Dethiobacter alkaliphilus	0	1	386	32	54	37	7	2	519
Bacteria;Bacteria_none;Firmicutes;Clostridia;Eubacteriales;Desulfitobacteriaceae;Dehalobacter;Dehalobacter restrictus	123	270	50	16	21	26	1	4	511
Bacteria;Bacteria_none;Proteobacteria;Betaproteobacteria;Burkholderiales;Burkholderiaceae;Cupriavidus;Cupriavidus metallidurans	310	99	46	20	7	21	1	6	510
Bacteria;Bacteria_none;Proteobacteria;Betaproteobacteria;Burkholderiales;Comamonadaceae;Comamonas;Comamonas kerstersii	318	77	46	16	7	31	4	6	505
Bacteria;Bacteria_none;Planctomycetota;Planctomycetia;Gemmatales;Gemmataceae;Gemmata;Gemmata obscuriglobus	339	111	8	22	3	12	2	7	504
Bacteria;Bacteria_none;Proteobacteria;Alphaproteobacteria;Hyphomicrobiales;Hyphomicrobiaceae;Pedomicrobium;Pedomicrobium americanum	141	148	73	101	6	20	11	4	504
Bacteria;Bacteria_none;Firmicutes;Clostridia;Eubacteriales;Oscillospiraceae;Tepidibaculum;Tepidibaculum saccharolyticum	49	49	82	202	32	26	38	25	503
Bacteria;Bacteria_none;Chloroflexi;Anaerolineae;Anaerolineales;Anaerolineaceae;Pelolinea;Pelolinea submarina	17	77	234	58	37	42	18	18	501
Bacteria;Bacteria_none;Actinobacteria;Thermoleophilia;Solirubrobacterales;Parviterribacteraceae;Parviterribacter;Parviterribacter kavangonensis	60	70	89	199	8	27	22	17	492
Bacteria;Bacteria_none;Actinobacteria;Actinomycetia;Corynebacteriales;Mycobacteriaceae;Mycolicibacterium;Mycolicibacterium insubricum	81	105	127	88	13	35	20	20	489
Bacteria;Bacteria_none;Proteobacteria;Alphaproteobacteria;Hyphomicrobiales;Nitrobacteraceae;Afipia;[Pseudomonas] carboxydohydrogena	108	122	73	128	16	23	17	0	487
Bacteria;Bacteria_none;Firmicutes;Limnochordia;Limnochordales;Limnochordaceae;Limnochorda;Limnochorda pilosa	1	24	228	62	52	111	3	4	485
Bacteria;Bacteria_none;Firmicutes;Bacilli;Lactobacillales;Streptococcaceae;Streptococcus;Streptococcus oriscaviae	415	13	10	32	4	4	2	4	484
Bacteria;Bacteria_none;Bacteroidota;Chitinophagia;Chitinophagales;Chitinophagaceae;Parasediminibacterium;Parasediminibacterium paludis	433	46	0	1	0	2	0	2	484
Bacteria;Bacteria_none;Proteobacteria;Epsilonproteobacteria;Campylobacterales;Helicobacteraceae;Helicobacter;Helicobacter apri	0	46	283	0	154	0	0	0	483
Bacteria;Bacteria_none;Proteobacteria;Betaproteobacteria;Neisseriales;Chromobacteriaceae;Laribacter;Laribacter hongkongensis	65	5	74	223	32	49	26	7	481
Bacteria;Bacteria_none;Proteobacteria;Betaproteobacteria;Burkholderiales;Comamonadaceae;Comamonas;Comamonas terrae	295	59	36	10	31	42	0	6	479
Bacteria;Bacteria_none;Proteobacteria;Betaproteobacteria;Burkholderiales;Comamonadaceae;Acidovorax;Acidovorax soli	323	79	0	40	13	12	7	0	474
Bacteria;Bacteria_none;Firmicutes;Clostridia;Eubacteriales;Lachnospiraceae;Porcincola;Porcincola intestinalis	122	31	113	86	26	44	25	26	473
Bacteria;Bacteria_none;Firmicutes;Clostridia;Eubacteriales;Lachnospiraceae;Lachnoclostridium;[Clostridium] hylemonae	40	82	165	73	36	44	18	14	472
Bacteria;Bacteria_none;Proteobacteria;Alphaproteobacteria;Rhodobacterales;Rhodobacteraceae;Xinfangfangia;Xinfangfangia soli	104	162	56	97	19	17	12	1	468
Bacteria;Bacteria_none;Proteobacteria;Epsilonproteobacteria;Campylobacterales;Helicobacteraceae;Helicobacter;Helicobacter cholecystus	0	132	256	35	0	0	0	41	464
Bacteria;Bacteria_none;Verrucomicrobia;Verrucomicrobiae;Verrucomicrobiales;Verrucomicrobiaceae;Sulfuriroseicoccus;Sulfuriroseicoccus oceanibius	37	408	9	1	0	7	0	0	462
Bacteria;Bacteria_none;Proteobacteria;Alphaproteobacteria;Rhodobacterales;Rhodobacteraceae;Paracoccus;Paracoccus communis	120	145	47	89	27	26	7	0	461
Bacteria;Bacteria_none;Proteobacteria;Alphaproteobacteria;Emcibacterales;Emcibacteraceae;Luteithermobacter;Luteithermobacter gelatinilyticus	32	200	83	74	12	4	6	49	460
Bacteria;Bacteria_none;Firmicutes;Clostridia;Eubacteriales;Oscillospiraceae;Hydrogenoanaerobacterium;Hydrogenoanaerobacterium saccharovorans	9	59	19	9	344	12	3	2	457
Bacteria;Bacteria_none;Proteobacteria;Epsilonproteobacteria;Campylobacterales;Helicobacteraceae;Wolinella;Wolinella succinogenes	3	87	228	7	110	12	5	4	456
Bacteria;Bacteria_none;Firmicutes;Clostridia;Eubacteriales;Peptostreptococcaceae;Proteocatella;Proteocatella sphenisci	422	13	6	0	3	8	2	1	455
Bacteria;Bacteria_none;Proteobacteria;Gammaproteobacteria;Enterobacterales;Yersiniaceae;Rahnella;Rahnella inusitata	316	11	14	61	2	6	13	28	451
Bacteria;Bacteria_none;Firmicutes;Clostridia;Eubacteriales;Eubacteriales Family XIII. Incertae Sedis;Mogibacterium;Mogibacterium timidum	76	13	127	71	53	61	22	27	450
Bacteria;Bacteria_none;Proteobacteria;Betaproteobacteria;Burkholderiales;Comamonadaceae;Serpentinimonas;Serpentinimonas maccroryi	249	35	64	38	14	32	15	3	450
Bacteria;Bacteria_none;Firmicutes;Negativicutes;Selenomonadales;Sporomusaceae;Anaeroarcus;Anaeroarcus burkinensis	312	44	49	31	5	0	2	5	448
Bacteria;Bacteria_none;Proteobacteria;Alphaproteobacteria;Hyphomicrobiales;Hyphomicrobiaceae;Hyphomicrobium;Hyphomicrobium chloromethanicum	118	140	66	75	20	18	10	1	448
Bacteria;Bacteria_none;Bacteroidota;Bacteroidia;Bacteroidales;Dysgonomonadaceae;Petrimonas;Petrimonas mucosa	2	21	89	174	23	84	30	25	448
Bacteria;Bacteria_none;Firmicutes;Clostridia;Eubacteriales;Oscillospiraceae;Faecalibacterium;Faecalibacterium prausnitzii	125	40	42	99	29	32	51	29	447
Bacteria;Bacteria_none;Firmicutes;Clostridia;Eubacteriales;Lachnospiraceae;Blautia;Blautia wexlerae	346	17	20	31	4	14	2	11	445
Bacteria;Bacteria_none;Firmicutes;Clostridia;Eubacteriales;Clostridiaceae;Clostridium;Clostridium acetobutylicum	4	47	213	86	39	38	7	8	442
Bacteria;Bacteria_none;Bacteroidota;Bacteroidia;Bacteroidales;Porphyromonadaceae;Macellibacteroides;Macellibacteroides fermentans	68	64	31	153	0	10	42	71	439
Bacteria;Bacteria_none;Proteobacteria;Betaproteobacteria;Burkholderiales;Burkholderiales_Incertae_sedis;Thiomonas;Thiomonas delicata	239	110	37	13	10	18	5	6	438
Bacteria;Bacteria_none;Actinobacteria;Actinomycetia;Actinomycetales;Actinomycetaceae;Actinomyces;Actinomyces minihominis	138	95	56	81	15	11	25	14	435
Bacteria;Bacteria_none;Proteobacteria;Gammaproteobacteria;Xanthomonadales;Xanthomonadaceae;Thermomonas;Thermomonas aquatica	213	115	37	29	14	11	8	2	429
Bacteria;Bacteria_none;Firmicutes;Clostridia;Eubacteriales;Clostridiaceae;Clostridium;Clostridium oceanicum	36	123	108	90	29	26	8	9	429
Bacteria;Bacteria_none;Firmicutes;Bacilli;Lactobacillales;Streptococcaceae;Streptococcus;Streptococcus urinalis	318	42	13	31	5	1	13	5	428
Bacteria;Bacteria_none;Proteobacteria;Betaproteobacteria;Burkholderiales;Burkholderiales_Incertae_sedis;Rhizobacter;Rhizobacter dauci	277	67	42	23	4	11	2	2	428
Bacteria;Bacteria_none;Proteobacteria;Alphaproteobacteria;Hyphomicrobiales;Reyranellaceae;Reyranella;Reyranella aquatilis	137	123	66	52	11	26	7	3	425
Bacteria;Bacteria_none;Proteobacteria;Deltaproteobacteria;Syntrophales;Syntrophaceae;Syntrophus;Syntrophus buswellii	12	347	16	3	38	1	2	6	425
Bacteria;Bacteria_none;Firmicutes;Clostridia;Eubacteriales;Oscillospiraceae;Bittarella;Bittarella massiliensis	60	68	52	23	192	15	9	5	424
Bacteria;Bacteria_none;Planctomycetota;Planctomycetia;Planctomycetales;Planctomycetaceae;Symmachiella;Symmachiella macrocystis	86	59	61	154	10	26	19	7	422
Bacteria;Bacteria_none;Proteobacteria;Alphaproteobacteria;Rhodobacterales;Rhodobacteraceae;Amaricoccus;Amaricoccus kaplicensis	147	58	61	112	7	18	9	10	422
Bacteria;Bacteria_none;Proteobacteria;Alphaproteobacteria;Hyphomicrobiales;Hyphomicrobiaceae;Hyphomicrobium;Hyphomicrobium facile	106	113	67	78	15	18	4	14	415
Bacteria;Bacteria_none;Actinobacteria;Actinomycetia;Pseudonocardiales;Pseudonocardiaceae;Saccharomonospora;Saccharomonospora xiaoerkulensis	2	18	83	215	27	24	35	11	415
Bacteria;Bacteria_none;Proteobacteria;Alphaproteobacteria;Hyphomicrobiales;Rhizobiaceae;Rhizobium;Rhizobium alvei	112	114	58	79	12	29	4	5	413
Bacteria;Bacteria_none;Firmicutes;Clostridia;Eubacteriales;Desulfotomaculaceae;Pelotomaculum;Pelotomaculum isophthalicicum	0	35	193	79	18	74	10	3	412
Bacteria;Bacteria_none;Planctomycetota;Planctomycetia;Planctomycetales;Planctomycetaceae;Fuerstiella;Fuerstiella marisgermanici	115	159	33	71	13	12	6	2	411
Bacteria;Bacteria_none;Planctomycetota;Planctomycetia;Pirellulales;Pirellulaceae;Pirellula;Pirellula staleyi	112	74	49	127	10	17	12	8	409
Bacteria;Bacteria_none;Firmicutes;Clostridia;Eubacteriales;Eubacteriales Family XIII. Incertae Sedis;Aminipila;Aminipila luticellarii	8	36	137	22	18	170	8	5	404
Bacteria;Bacteria_none;Firmicutes;Bacilli;Lactobacillales;Lactobacillaceae;Lactobacillus;Lactobacillus delbrueckii	246	18	37	55	16	14	7	6	399
Bacteria;Bacteria_none;Proteobacteria;Gammaproteobacteria;Enterobacterales;Enterobacteriaceae;Kluyvera;Kluyvera ascorbata	280	17	16	44	10	4	8	20	399
Bacteria;Bacteria_none;Actinobacteria;Actinomycetia;Micrococcales;Microbacteriaceae;Microbacterium;Microbacterium gubbeenense	24	89	97	116	15	33	16	9	399
Bacteria;Bacteria_none;Proteobacteria;Alphaproteobacteria;Rhodospirillales;Rhodospirillaceae;Inquilinus;Inquilinus limosus	90	88	60	115	15	11	12	7	398
Bacteria;Bacteria_none;Proteobacteria;Alphaproteobacteria;Rhodospirillales;Azospirillaceae;Desertibacter;Desertibacter roseus	140	123	62	45	8	13	3	2	396
Bacteria;Bacteria_none;Chloroflexi;Caldilineae;Caldilineales;Caldilineaceae;Caldilinea;Caldilinea aerophila	27	40	282	27	10	2	5	2	395
Bacteria;Bacteria_none;Firmicutes;Clostridia;Eubacteriales;Lachnospiraceae;Herbinix;Herbinix hemicellulosilytica	3	330	28	10	5	13	3	0	392
Bacteria;Bacteria_none;Actinobacteria;Actinomycetia;Streptomycetales;Streptomycetaceae;Streptomyces;Streptomyces vietnamensis	6	38	81	191	20	7	1	47	391
Bacteria;Bacteria_none;Synergistetes;Synergistia;Synergistales;Synergistaceae;Acetomicrobium;Acetomicrobium hydrogeniformans	0	0	9	209	2	133	37	1	391
Bacteria;Bacteria_none;Firmicutes;Clostridia;Eubacteriales;Eubacteriaceae;Aminicella;Aminicella lysinilytica	59	6	53	122	53	52	25	20	390
Bacteria;Bacteria_none;Firmicutes;Clostridia;Eubacteriales;Lachnospiraceae;Catonella;Catonella massiliensis	21	244	6	92	4	0	21	0	388
Bacteria;Bacteria_none;Firmicutes;Clostridia;Eubacteriales;Lachnospiraceae;Blautia;Blautia luti	329	24	9	8	5	7	1	5	388
Bacteria;Bacteria_none;Bacteroidota;Saprospiria;Saprospirales;Saprospiraceae;Rubidimonas;Rubidimonas crustatorum	82	13	49	166	7	21	31	19	388
Bacteria;Bacteria_none;Actinobacteria;Actinomycetia;Micrococcales;Micrococcaceae;Arthrobacter;Arthrobacter nitrophenolicus	29	102	71	117	7	14	17	28	385
Bacteria;Bacteria_none;Proteobacteria;Betaproteobacteria;Burkholderiales;Comamonadaceae;Caenimonas;Caenimonas koreensis	252	71	20	13	7	14	4	4	385
Bacteria;Bacteria_none;Planctomycetota;Phycisphaerae;Sedimentisphaerales;Anaerohalosphaeraceae;Anaerohalosphaera;Anaerohalosphaera lusitana	6	15	53	208	7	56	15	23	383
Bacteria;Bacteria_none;Synergistetes;Synergistia;Synergistales;Synergistaceae;Cloacibacillus;Cloacibacillus evryensis	24	146	149	7	29	23	3	1	382
Bacteria;Bacteria_none;Bacteroidota;Bacteroidia;Bacteroidales;Rikenellaceae;Alistipes;Alistipes shahii	0	381	0	0	0	0	0	0	381
Bacteria;Bacteria_none;Proteobacteria;Betaproteobacteria;Burkholderiales;Sphaerotilaceae;Aquincola;Aquincola rivuli	292	59	11	10	1	5	3	0	381
Bacteria;Bacteria_none;Proteobacteria;Betaproteobacteria;Rhodocyclales;Rhodocyclaceae;Propionivibrio;Propionivibrio pelophilus	217	41	44	40	15	8	12	3	380
Bacteria;Bacteria_none;Firmicutes;Clostridia;Eubacteriales;Oscillospiraceae;Faecalibacterium;Faecalibacterium butyricigenerans	87	73	82	57	20	18	24	17	378
Bacteria;Bacteria_none;Planctomycetota;Planctomycetia;Isosphaerales;Isosphaeraceae;Singulisphaera;Singulisphaera acidiphila	293	56	10	3	1	10	1	1	375
Bacteria;Bacteria_none;Actinobacteria;Actinomycetia;Pseudonocardiales;Pseudonocardiaceae;Actinosynnema;Actinosynnema mirum	8	30	42	242	4	9	17	22	374
Bacteria;Bacteria_none;Proteobacteria;Gammaproteobacteria;Enterobacterales;Enterobacteriaceae;Klebsiella;Klebsiella pneumoniae	139	14	3	42	0	0	13	162	373
Bacteria;Bacteria_none;Proteobacteria;Gammaproteobacteria;Pasteurellales;Pasteurellaceae;Haemophilus;Haemophilus parainfluenzae	340	0	0	14	0	18	0	0	372
Bacteria;Bacteria_none;Firmicutes;Negativicutes;Selenomonadales;Selenomonadaceae;Propionispira;Propionispira arcuata	150	27	47	49	2	27	39	31	372
Bacteria;Bacteria_none;Proteobacteria;Alphaproteobacteria;Rhodospirillales;Rhodospirillaceae;Defluviicoccus;Defluviicoccus vanus	86	113	40	83	15	20	7	6	370
Bacteria;Bacteria_none;Proteobacteria;Betaproteobacteria;Burkholderiales;Comamonadaceae;Acidovorax;Acidovorax avenae	289	23	25	0	0	0	0	32	369
Bacteria;Bacteria_none;Proteobacteria;Betaproteobacteria;Burkholderiales;Comamonadaceae;Hydrogenophaga;Hydrogenophaga intermedia	243	60	24	14	5	6	12	4	368
Bacteria;Bacteria_none;Firmicutes;Bacilli;Lactobacillales;Streptococcaceae;Streptococcus;Streptococcus anginosus	308	18	11	19	0	0	8	4	368
Bacteria;Bacteria_none;Proteobacteria;Alphaproteobacteria;Hyphomicrobiales;Devosiaceae;Devosia;Devosia humi	90	74	53	112	9	9	16	4	367
Bacteria;Bacteria_none;Proteobacteria;Alphaproteobacteria;Rhodobacterales;Rhodobacteraceae;Amaricoccus;Amaricoccus solimangrovi	84	66	75	94	9	19	13	5	365
Bacteria;Bacteria_none;Proteobacteria;Betaproteobacteria;Rhodocyclales;Rhodocyclaceae;Aromatoleum;Aromatoleum toluvorans	223	62	38	10	10	11	8	3	365
Bacteria;Bacteria_none;Firmicutes;Clostridia;Eubacteriales;Clostridiaceae;Clostridium;Clostridium felsineum	110	38	62	77	14	23	24	15	363
Bacteria;Bacteria_none;Proteobacteria;Alphaproteobacteria;Sphingomonadales;Sphingomonadaceae;Aquisediminimonas;Aquisediminimonas profunda	134	110	17	85	3	4	3	6	362
Bacteria;Bacteria_none;Proteobacteria;Epsilonproteobacteria;Campylobacterales;Helicobacteraceae;Helicobacter;Helicobacter labacensis	0	0	172	0	189	0	0	0	361
Bacteria;Bacteria_none;Planctomycetota;Planctomycetia;Pirellulales;Pirellulaceae;Anatilimnocola;Anatilimnocola aggregata	81	56	45	132	14	20	9	3	360
Bacteria;Bacteria_none;Firmicutes;Clostridia;Eubacteriales;Desulfallaceae;Desulfallas;Desulfallas thermosapovorans	17	84	123	55	23	43	9	5	359
Bacteria;Bacteria_none;Proteobacteria;Alphaproteobacteria;Hyphomicrobiales;Pleomorphomonadaceae;Pleomorphomonas;Pleomorphomonas koreensis	71	32	82	110	21	31	6	4	357
Bacteria;Bacteria_none;Proteobacteria;Betaproteobacteria;Burkholderiales;Comamonadaceae;Variovorax;Variovorax soli	139	144	21	10	21	13	0	7	355
Bacteria;Bacteria_none;Bacteroidota;Bacteroidia;Marinilabiliales;Marinilabiliaceae;Alkaliflexus;Alkaliflexus imshenetskii	15	47	154	26	34	70	2	6	354
Bacteria;Bacteria_none;Proteobacteria;Betaproteobacteria;Burkholderiales;Comamonadaceae;Comamonas;Comamonas serinivorans	189	18	31	16	21	70	3	4	352
Bacteria;Bacteria_none;Firmicutes;Clostridia;Eubacteriales;Oscillospiraceae;Ruminococcoides;Ruminococcoides bili	217	29	27	33	15	12	10	9	352
Bacteria;Bacteria_none;Firmicutes;Clostridia;Eubacteriales;Eubacteriales Family XIII. Incertae Sedis;Mobilibacterium;Mobilibacterium timonense	7	23	176	39	39	59	1	6	350
Bacteria;Bacteria_none;Firmicutes;Clostridia;Eubacteriales;Lachnospiraceae;Mediterraneibacter;Mediterraneibacter faecis	230	23	37	27	11	8	9	4	349
Bacteria;Bacteria_none;Firmicutes;Clostridia;Eubacteriales;Peptostreptococcaceae;Acetoanaerobium;Acetoanaerobium noterae	253	31	32	7	5	13	1	1	343
Bacteria;Bacteria_none;Firmicutes;Clostridia;Thermoanaerobacterales;Thermoanaerobacteraceae;Gelria;Gelria glutamica	0	4	26	118	8	70	56	60	342
Bacteria;Bacteria_none;Firmicutes;Bacilli;Lactobacillales;Streptococcaceae;Streptococcus;Streptococcus cameli	178	46	41	53	3	7	10	3	341
Bacteria;Bacteria_none;Bacteroidota;Bacteroidia;Bacteroidales;Porphyromonadaceae;Microbacter;Microbacter margulisiae	6	33	65	153	13	20	20	31	341
Bacteria;Bacteria_none;Proteobacteria;Alphaproteobacteria;Hyphomicrobiales;Hyphomicrobiaceae;Rhodomicrobium;Rhodomicrobium lacus	25	101	20	153	2	15	18	6	340
Bacteria;Bacteria_none;Firmicutes;Clostridia;Eubacteriales;Eubacteriales Family XIII. Incertae Sedis;Aminipila;Aminipila butyrica	5	11	159	41	7	96	11	8	338
Bacteria;Bacteria_none;Proteobacteria;Gammaproteobacteria;Pseudomonadales;Marinobacteraceae;Marinobacter;Marinobacter halodurans	50	231	19	19	3	1	4	11	338
Bacteria;Bacteria_none;Planctomycetota;Planctomycetia;Pirellulales;Lacipirellulaceae;Bythopirellula;Bythopirellula polymerisocia	41	41	52	147	7	27	16	3	334
Bacteria;Bacteria_none;Firmicutes;Clostridia;Eubacteriales;Peptostreptococcaceae;Romboutsia;Romboutsia sedimentorum	19	41	78	92	28	27	17	32	334
Bacteria;Bacteria_none;Firmicutes;Clostridia;Eubacteriales;Clostridiaceae;Clostridium;Clostridium senegalense	53	59	37	99	8	27	25	24	332
Bacteria;Bacteria_none;Bacteroidota;Bacteroidia;Marinilabiliales;Prolixibacteraceae;Maribellus;Maribellus maritimus	11	233	15	59	0	8	0	6	332
Bacteria;Bacteria_none;Firmicutes;Clostridia;Eubacteriales;Lachnospiraceae;Lachnospira;Lachnospira pectinoschiza	79	28	53	91	24	18	29	10	332
Bacteria;Bacteria_none;Firmicutes;Bacilli;Bacillales;Paenibacillaceae;Paenibacillus;Paenibacillus enshidis	3	18	122	34	32	112	7	3	331
Bacteria;Bacteria_none;Firmicutes;Clostridia;Eubacteriales;Peptostreptococcaceae;Romboutsia;Romboutsia ilealis	27	60	71	76	19	22	14	42	331
Bacteria;Bacteria_none;Firmicutes;Clostridia;Eubacteriales;Clostridiaceae;Clostridium;Clostridium tagluense	2	1	73	133	12	28	38	44	331
Bacteria;Bacteria_none;Proteobacteria;Betaproteobacteria;Burkholderiales;Comamonadaceae;Hydrogenophaga;Hydrogenophaga caeni	242	44	21	5	8	7	2	1	330
Bacteria;Bacteria_none;Proteobacteria;Alphaproteobacteria;Rhodospirillales;Elioraeaceae;Elioraea;Elioraea thermophila	78	122	46	58	5	14	5	2	330
Bacteria;Bacteria_none;Firmicutes;Clostridia;Eubacteriales;Oscillospiraceae;Ruminococcus;Ruminococcus albus	15	154	53	30	48	11	3	15	329
Bacteria;Bacteria_none;Synergistetes;Synergistia;Synergistales;Synergistaceae;Acetomicrobium;Acetomicrobium flavidum	0	0	13	187	0	107	18	3	328
Bacteria;Bacteria_none;Proteobacteria;Betaproteobacteria;Burkholderiales;Sphaerotilaceae;Aquincola;Aquincola amnicola	326	1	0	0	0	1	0	0	328
Bacteria;Bacteria_none;Tenericutes;Mollicutes;Mycoplasmatales;Mycoplasmataceae;Mesomycoplasma;Mesomycoplasma collis	54	230	19	15	2	1	0	4	325
Bacteria;Bacteria_none;Actinobacteria;Actinomycetia;Corynebacteriales;Mycobacteriaceae;Mycolicibacterium;Mycolicibacterium komossense	40	109	62	53	9	27	13	5	318
Bacteria;Bacteria_none;Firmicutes;Clostridia;Eubacteriales;Clostridiaceae;Clostridium;Clostridium cochlearium	1	2	5	283	5	4	12	6	318
Bacteria;Bacteria_none;Chloroflexi;Anaerolineae;Anaerolineales;Anaerolineaceae;Ornatilinea;Ornatilinea apprima	21	118	108	26	10	15	8	11	317
Bacteria;Bacteria_none;Firmicutes;Negativicutes;Acidaminococcales;Acidaminococcaceae;Phascolarctobacterium;Phascolarctobacterium faecium	80	10	68	55	14	20	49	21	317
Bacteria;Bacteria_none;Bacteroidota;Bacteroidia;Marinilabiliales;Prolixibacteraceae;Mangrovibacterium;Mangrovibacterium marinum	24	269	8	8	3	2	1	2	317
Bacteria;Bacteria_none;Proteobacteria;Alphaproteobacteria;Hyphomicrobiales;Phyllobacteriaceae;Mesorhizobium;Mesorhizobium denitrificans	80	133	32	55	5	8	2	0	315
Bacteria;Bacteria_none;Acidobacteria;Vicinamibacteria;Vicinamibacterales;Vicinamibacteraceae;Vicinamibacter;Vicinamibacter silvestris	120	46	112	6	19	2	7	0	312
Bacteria;Bacteria_none;Firmicutes;Negativicutes;Veillonellales;Veillonellaceae;Megasphaera;Megasphaera sueciensis	21	9	42	149	5	20	46	19	311
Bacteria;Bacteria_none;Proteobacteria;Alphaproteobacteria;Hyphomicrobiales;Ancalomicrobiaceae;Ancalomicrobium;Ancalomicrobium adetum	10	11	64	175	8	17	21	5	311
Bacteria;Bacteria_none;Proteobacteria;Epsilonproteobacteria;Campylobacterales;Helicobacteraceae;Helicobacter;Helicobacter anatolicus	0	204	106	0	0	0	0	0	310
Bacteria;Bacteria_none;Firmicutes;Negativicutes;Acidaminococcales;Acidaminococcaceae;Succinispira;Succinispira mobilis	40	28	94	53	17	45	16	15	308
Bacteria;Bacteria_none;Actinobacteria;Actinomycetia;Propionibacteriales;Propionibacteriaceae;Tessaracoccus;Tessaracoccus flavescens	71	143	40	32	7	8	2	4	307
Bacteria;Bacteria_none;Proteobacteria;Betaproteobacteria;Burkholderiales;Comamonadaceae;Ottowia;Ottowia caeni	196	44	25	9	6	17	4	3	304
Bacteria;Bacteria_none;Bacteroidota;Bacteroidia;Bacteroidales;Rikenellaceae;Anaerocella;Anaerocella delicata	22	30	56	65	15	75	17	24	304
Bacteria;Bacteria_none;Firmicutes;Clostridia;Eubacteriales;Oscillospiraceae;Caproicibacterium;Caproicibacterium lactatifermentans	35	169	39	21	15	17	7	1	304
Unclassified;Unknown;Unknown;Unknown;Unknown;Unknown;Unknown;Unknown	29	67	76	51	27	34	8	11	303
Bacteria;Bacteria_none;Firmicutes;Clostridia;Eubacteriales;Eubacteriaceae;Eubacterium;Eubacterium coprostanoligenes	38	184	24	13	2	33	3	6	303
Bacteria;Bacteria_none;Firmicutes;Bacilli;Lactobacillales;Streptococcaceae;Streptococcus;Streptococcus entericus	199	16	33	26	8	9	7	4	302
Bacteria;Bacteria_none;Firmicutes;Clostridia;Eubacteriales;Oscillospiraceae;Scatolibacter;Scatolibacter rhodanostii	78	109	50	11	13	28	9	3	301
Bacteria;Bacteria_none;Proteobacteria;Alphaproteobacteria;Hyphomicrobiales;Nitrobacteraceae;Afipia;Afipia clevelandensis	67	72	44	74	8	16	9	10	300
Bacteria;Bacteria_none;Synergistetes;Synergistia;Synergistales;Synergistaceae;Lactivibrio;Lactivibrio alcoholicus	19	262	9	3	1	3	2	1	300
Bacteria;Bacteria_none;Firmicutes;Negativicutes;Acidaminococcales;Acidaminococcaceae;Succiniclasticum;Succiniclasticum ruminis	78	11	31	98	9	14	39	19	299
Bacteria;Bacteria_none;Firmicutes;Clostridia;Eubacteriales;Syntrophomonadaceae;Syntrophomonas;Syntrophomonas wolfei	2	60	50	49	1	126	3	8	299
Bacteria;Bacteria_none;Proteobacteria;Alphaproteobacteria;Hyphomicrobiales;Boseaceae;Bosea;Bosea psychrotolerans	75	44	44	88	25	11	11	0	298
Bacteria;Bacteria_none;Bacteroidota;Bacteroidia;Bacteroidales;Rikenellaceae;Acetobacteroides;Acetobacteroides hydrogenigenes	14	195	24	40	1	8	11	3	296
Bacteria;Bacteria_none;Firmicutes;Bacilli;Lactobacillales;Enterococcaceae;Enterococcus;Enterococcus aquimarinus	260	12	10	7	1	3	0	1	294
Bacteria;Bacteria_none;Bacteroidota;Bacteroidia;Marinilabiliales;Prolixibacteraceae;Maribellus;Maribellus luteus	26	244	4	6	0	3	8	0	291
Bacteria;Bacteria_none;Proteobacteria;Alphaproteobacteria;Rhodobacterales;Rhodobacteraceae;Amaricoccus;Amaricoccus veronensis	61	51	44	89	8	18	15	5	291
Bacteria;Bacteria_none;Firmicutes;Clostridia;Eubacteriales;Lachnospiraceae;Zhenhengia;Zhenhengia yiwuensis	14	28	101	84	15	17	14	17	290
Bacteria;Bacteria_none;Firmicutes;Clostridia;Eubacteriales;Peptococcaceae;Dehalobacterium;Dehalobacterium formicoaceticum	9	54	160	3	16	40	1	6	289
Bacteria;Bacteria_none;Firmicutes;Clostridia;Eubacteriales;Proteinivoraceae;Anaerobranca;Anaerobranca californiensis	3	28	104	99	16	28	9	2	289
Bacteria;Bacteria_none;Bacteroidota;Bacteroidia;Bacteroidales;Rikenellaceae;Rikenella;Rikenella microfusus	11	211	15	30	4	12	4	1	288
Bacteria;Bacteria_none;Firmicutes;Bacilli;Lactobacillales;Carnobacteriaceae;Trichococcus;Trichococcus flocculiformis	210	32	14	21	0	6	1	3	287
Bacteria;Bacteria_none;Firmicutes;Bacilli;Bacillales;Bacillaceae;Salimicrobium;Salimicrobium humidisoli	1	18	135	40	23	63	6	0	286
Bacteria;Bacteria_none;Firmicutes;Tissierellia;Tissierellales;Peptoniphilaceae;Gallicola;Gallicola barnesae	131	81	23	22	5	3	15	6	286
Bacteria;Bacteria_none;Proteobacteria;Deltaproteobacteria;Myxococcales;Vulgatibacteraceae;Vulgatibacter;Vulgatibacter incomptus	5	80	129	1	64	0	1	5	285
Bacteria;Bacteria_none;Firmicutes;Clostridia;Eubacteriales;Syntrophomonadaceae;Syntrophomonas;Syntrophomonas bryantii	0	6	178	48	4	28	8	12	284
Bacteria;Bacteria_none;Firmicutes;Bacilli;Bacillales;Bacillaceae;Bacillus;Bacillus mycoides	19	49	91	60	12	30	0	22	283
Bacteria;Bacteria_none;Proteobacteria;Betaproteobacteria;Nitrosomonadales;Nitrosomonadaceae;Nitrosomonas;Nitrosomonas oligotropha	228	47	0	3	1	2	0	1	282
Bacteria;Bacteria_none;Firmicutes;Bacilli;Lactobacillales;Streptococcaceae;Streptococcus;Streptococcus rupicaprae	219	11	6	29	3	0	6	7	281
Bacteria;Bacteria_none;Planctomycetota;Planctomycetia;Isosphaerales;Isosphaeraceae;Singulisphaera;Singulisphaera rosea	181	61	13	7	7	10	1	1	281
Bacteria;Bacteria_none;Firmicutes;Bacilli;Bacillales;Bacillaceae;Anoxybacillus;Anoxybacillus tengchongensis	53	72	59	34	13	22	19	8	280
Bacteria;Bacteria_none;Bacteroidota;Bacteroidia;Bacteroidales;Odoribacteraceae;Odoribacter;Odoribacter denticanis	2	14	30	137	48	18	15	12	276
Bacteria;Bacteria_none;Proteobacteria;Alphaproteobacteria;Rhodobacterales;Rhodobacteraceae;Paracoccus;Paracoccus zhejiangensis	148	47	17	41	5	12	4	2	276
Bacteria;Bacteria_none;Planctomycetota;Planctomycetia;Gemmatales;Gemmataceae;Tuwongella;Tuwongella immobilis	132	114	7	3	1	15	3	1	276
Bacteria;Bacteria_none;Firmicutes;Clostridia;Eubacteriales;Oscillospiraceae;Anaerobacterium;Anaerobacterium chartisolvens	16	20	102	54	37	34	10	3	276
Bacteria;Bacteria_none;Actinobacteria;Acidimicrobiia;Acidimicrobiales;Iamiaceae;Rhabdothermincola;Rhabdothermincola salaria	50	136	28	42	5	9	2	3	275
Bacteria;Bacteria_none;Firmicutes;Clostridia;Eubacteriales;Oscillospiraceae;Acetanaerobacterium;Acetanaerobacterium elongatum	19	39	94	29	17	50	18	9	275
Bacteria;Bacteria_none;Firmicutes;Clostridia;Eubacteriales;Peptostreptococcaceae;Peptostreptococcaceae_Incertae_sedis;[Clostridium] paradoxum	23	36	118	26	22	26	13	11	275
Bacteria;Bacteria_none;Armatimonadetes;Fimbriimonadia;Fimbriimonadales;Fimbriimonadaceae;Fimbriimonas;Fimbriimonas ginsengisoli	135	103	16	8	0	5	1	6	274
Bacteria;Bacteria_none;Proteobacteria;Gammaproteobacteria;Gammaproteobacteria_Incertae_sedis;Gammaproteobacteria_Incertae_sedis;Acidibacter;Acidibacter ferrireducens	178	69	11	9	1	2	0	3	273
Bacteria;Bacteria_none;Planctomycetota;Planctomycetia;Gemmatales;Gemmataceae;Telmatocola;Telmatocola sphagniphila	165	62	10	12	7	11	3	2	272
Bacteria;Bacteria_none;Proteobacteria;Epsilonproteobacteria;Campylobacterales;Arcobacteraceae;Aliarcobacter;Aliarcobacter cryaerophilus	43	52	41	74	0	15	17	30	272
Bacteria;Bacteria_none;Bacteroidota;Bacteroidia;Bacteroidales;Porphyromonadaceae;Porphyromonas;Porphyromonas gingivalis	0	0	7	198	0	0	22	45	272
Bacteria;Bacteria_none;Firmicutes;Clostridia;Eubacteriales;Peptostreptococcaceae;Acetoanaerobium;Acetoanaerobium sticklandii	207	11	42	3	5	2	1	1	272
Bacteria;Bacteria_none;Firmicutes;Clostridia;Eubacteriales;Lachnospiraceae;Coprococcus;Coprococcus eutactus	90	17	59	38	23	13	17	14	271
Bacteria;Bacteria_none;Firmicutes;Clostridia;Eubacteriales;Oscillospiraceae;Mageeibacillus;Mageeibacillus indolicus	4	210	28	6	8	13	1	0	270
Bacteria;Bacteria_none;Proteobacteria;Gammaproteobacteria;Xanthomonadales;Rhodanobacteraceae;Ahniella;Ahniella affigens	181	36	5	31	1	0	9	7	270
Bacteria;Bacteria_none;Bacteroidota;Cytophagia;Cytophagales;Spirosomaceae;Runella;Runella palustris	160	63	29	1	3	9	2	1	268
Bacteria;Bacteria_none;Proteobacteria;Deltaproteobacteria;Desulfovibrionales;Desulfovibrionaceae;Solidesulfovibrio;Solidesulfovibrio alcoholivorans	25	232	8	0	0	0	2	0	267
Bacteria;Bacteria_none;Firmicutes;Clostridia;Eubacteriales;Peptostreptococcaceae;Romboutsia;Romboutsia hominis	8	34	63	68	16	36	15	27	267
Bacteria;Bacteria_none;Firmicutes;Clostridia;Eubacteriales;Oscillospiraceae;Pseudoflavonifractor;Pseudoflavonifractor capillosus	8	57	94	38	6	45	9	9	266
Bacteria;Bacteria_none;Firmicutes;Clostridia;Eubacteriales;Christensenellaceae;Guopingia;Guopingia tenuis	19	140	36	18	10	34	5	4	266
Bacteria;Bacteria_none;Proteobacteria;Gammaproteobacteria;Enterobacterales;Erwiniaceae;Erwinia;Erwinia piriflorinigrans	185	12	5	29	3	8	9	14	265
Bacteria;Bacteria_none;Proteobacteria;Betaproteobacteria;Burkholderiales;Sphaerotilaceae;Ideonella;Ideonella livida	154	47	25	14	6	14	1	4	265
Bacteria;Bacteria_none;Bacteroidota;Chitinophagia;Chitinophagales;Chitinophagaceae;Flavisolibacter;Flavisolibacter galbus	245	19	0	0	0	0	0	0	264
Bacteria;Bacteria_none;Firmicutes;Clostridia;Thermoanaerobacterales;Thermoanaerobacteraceae;Calorimonas;Calorimonas adulescens	11	5	20	192	1	16	19	0	264
Bacteria;Bacteria_none;Firmicutes;Clostridia;Eubacteriales;Oscillospiraceae;Congzhengia;Congzhengia minquanensis	12	49	129	14	22	34	2	1	263
Bacteria;Bacteria_none;Proteobacteria;Betaproteobacteria;Nitrosomonadales;Sterolibacteriaceae;Sulfuritalea;Sulfuritalea hydrogenivorans	218	12	10	4	3	2	2	9	260
Bacteria;Bacteria_none;Planctomycetota;Planctomycetia;Isosphaerales;Isosphaeraceae;Tautonia;Tautonia sociabilis	138	78	14	7	5	16	0	2	260
Bacteria;Bacteria_none;Firmicutes;Clostridia;Eubacteriales;Eubacteriaceae;Acetobacterium;Acetobacterium carbinolicum	55	53	24	79	10	8	17	14	260
Bacteria;Bacteria_none;Firmicutes;Clostridia;Eubacteriales;Eubacteriales Family XIII. Incertae Sedis;Lentihominibacter;Lentihominibacter hominis	35	97	25	39	16	36	8	3	259
Bacteria;Bacteria_none;Proteobacteria;Betaproteobacteria;Burkholderiales;Comamonadaceae;Diaphorobacter;Diaphorobacter oryzae	224	17	8	4	1	1	1	2	258
Bacteria;Bacteria_none;Bacteroidota;Bacteroidia;Bacteroidales;Prevotellaceae;Prevotella;Prevotella nanceiensis	5	34	128	10	28	33	9	10	257
Bacteria;Bacteria_none;Firmicutes;Clostridia;Eubacteriales;Eubacteriales_Incertae_sedis;Intestinimonas;Intestinimonas massiliensis	12	30	25	149	3	18	16	4	257
Bacteria;Bacteria_none;Planctomycetota;Planctomycetia;Isosphaerales;Isosphaeraceae;Aquisphaera;Aquisphaera giovannonii	125	76	14	12	10	14	1	5	257
Bacteria;Bacteria_none;Verrucomicrobia;Verrucomicrobiae;Verrucomicrobiales;Verrucomicrobiaceae;Prosthecobacter;Prosthecobacter dejongeii	9	246	0	0	0	0	0	0	255
Bacteria;Bacteria_none;Synergistetes;Synergistia;Synergistales;Synergistaceae;Aminomonas;Aminomonas paucivorans	17	159	19	39	0	2	11	6	253
Bacteria;Bacteria_none;Proteobacteria;Deltaproteobacteria;Desulfobacterales;Desulfobacteraceae;Desulfatitalea;Desulfatitalea tepidiphila	6	140	11	0	93	2	1	0	253
Bacteria;Bacteria_none;Firmicutes;Bacilli;Lactobacillales;Streptococcaceae;Streptococcus;Streptococcus orisratti	191	17	14	13	4	1	10	3	253
Bacteria;Bacteria_none;Firmicutes;Clostridia;Eubacteriales;Eubacteriaceae;Eubacterium;Eubacterium barkeri	30	39	58	62	8	24	20	11	252
Bacteria;Bacteria_none;Actinobacteria;Thermoleophilia;Solirubrobacterales;Paraconexibacteraceae;Paraconexibacter;Paraconexibacter algicola	24	33	31	133	6	7	8	10	252
Bacteria;Bacteria_none;Firmicutes;Tissierellia;Tissierellales;Gottschalkiaceae;Andreesenia;Andreesenia angusta	6	0	20	203	5	2	11	5	252
Bacteria;Bacteria_none;Firmicutes;Clostridia;Eubacteriales;Clostridiaceae;Clostridium;Clostridium prolinivorans	120	8	41	27	15	29	4	5	249
Bacteria;Bacteria_none;Proteobacteria;Alphaproteobacteria;Hyphomicrobiales;Xanthobacteraceae;Labrys;Labrys wisconsinensis	46	62	37	69	12	20	0	2	248
Bacteria;Bacteria_none;Proteobacteria;Betaproteobacteria;Burkholderiales;Sphaerotilaceae;Ideonella;Ideonella dechloratans	146	57	14	11	6	6	3	4	247
Bacteria;Bacteria_none;Firmicutes;Clostridia;Eubacteriales;Lachnospiraceae;Enterocloster;Enterocloster bolteae	84	19	49	38	36	8	3	9	246
Bacteria;Bacteria_none;Actinobacteria;Actinomycetia;Streptomycetales;Streptomycetaceae;Streptomyces;Streptomyces lycii	8	39	28	131	5	15	18	2	246
Bacteria;Bacteria_none;Firmicutes;Clostridia;Eubacteriales;Clostridiaceae;Clostridium;Clostridium fermenticellae	1	0	2	221	0	0	17	5	246
Bacteria;Bacteria_none;Firmicutes;Clostridia;Eubacteriales;Oscillospiraceae;Ruminiclostridium;Ruminiclostridium cellulolyticum	1	3	100	0	110	31	0	0	245
Bacteria;Bacteria_none;Firmicutes;Clostridia;Eubacteriales;Oscillospiraceae;Ructibacterium;Ructibacterium gallinarum	44	41	65	38	15	22	11	8	244
Bacteria;Bacteria_none;Proteobacteria;Betaproteobacteria;Burkholderiales;Burkholderiaceae;Formosimonas;Formosimonas limnophila	148	26	30	12	10	12	2	4	244
Bacteria;Bacteria_none;Bacteroidota;Bacteroidia;Bacteroidales;Rikenellaceae;Alistipes;Alistipes montrealensis	97	146	0	0	0	0	0	0	243
Bacteria;Bacteria_none;Proteobacteria;Alphaproteobacteria;Hyphomicrobiales;Hyphomicrobiales_Incertae_sedis;Vineibacter;Vineibacter terrae	89	75	33	29	6	6	3	1	242
Bacteria;Bacteria_none;Tenericutes;Mollicutes;Entomoplasmatales;Spiroplasmataceae;Spiroplasma;Spiroplasma velocicrescens	19	61	62	52	13	0	4	30	241
Bacteria;Bacteria_none;Proteobacteria;Deltaproteobacteria;Desulfobacterales;Desulfobacteraceae;Desulfotignum;Desulfotignum balticum	0	208	0	32	0	0	0	0	240
Bacteria;Bacteria_none;Firmicutes;Clostridia;Eubacteriales;Lachnospiraceae;Blautia;Blautia provencensis	196	9	12	11	2	4	2	4	240
Bacteria;Bacteria_none;Proteobacteria;Betaproteobacteria;Burkholderiales;Comamonadaceae;Acidovorax;Acidovorax carolinensis	184	28	7	10	2	6	1	2	240
Bacteria;Bacteria_none;Abditibacteriota;Abditibacteria;Abditibacteriales;Abitibacteriaceae;Abditibacterium;Abditibacterium utsteinense	8	48	43	96	3	13	11	17	239
Bacteria;Bacteria_none;Firmicutes;Clostridia;Eubacteriales;Lachnospiraceae;Dorea;Dorea longicatena	184	16	24	5	4	2	2	1	238
Bacteria;Bacteria_none;Proteobacteria;Alphaproteobacteria;Hyphomicrobiales;Aurantimonadaceae;Aurantimonas;Aurantimonas litoralis	21	43	38	109	7	0	6	14	238
Bacteria;Bacteria_none;Firmicutes;Erysipelotrichia;Erysipelotrichales;Turicibacteraceae;Turicibacter;Turicibacter bilis	23	39	55	39	15	26	15	25	237
Bacteria;Bacteria_none;Proteobacteria;Alphaproteobacteria;Rhodobacterales;Rhodobacteraceae;Rhodobacter;Rhodobacter calidifons	67	64	31	50	7	11	3	3	236
Bacteria;Bacteria_none;Bacteroidota;Cytophagia;Cytophagales;Spirosomaceae;Runella;Runella defluvii	185	25	17	4	1	3	0	1	236
Bacteria;Bacteria_none;Planctomycetota;Planctomycetia;Planctomycetales;Planctomycetaceae;Schlesneria;Schlesneria paludicola	98	37	23	56	7	8	4	2	235
Bacteria;Bacteria_none;Proteobacteria;Alphaproteobacteria;Hyphomicrobiales;Hyphomicrobiaceae;Pedomicrobium;Pedomicrobium australicum	52	84	25	47	7	11	6	3	235
Bacteria;Bacteria_none;Proteobacteria;Gammaproteobacteria;Enterobacterales;Yersiniaceae;Yersinia;Yersinia canariae	153	3	10	43	5	2	4	15	235
Bacteria;Bacteria_none;Proteobacteria;Deltaproteobacteria;Desulfovibrionales;Desulfovibrionaceae;Pseudodesulfovibrio;Pseudodesulfovibrio profundus	9	218	5	2	1	0	0	0	235
Bacteria;Bacteria_none;Firmicutes;Clostridia;Eubacteriales;Lachnospiraceae;Blautia;Blautia intestinalis	156	35	6	22	5	4	6	0	234
Bacteria;Bacteria_none;Proteobacteria;Betaproteobacteria;Burkholderiales;Burkholderiaceae;Caballeronia;Caballeronia grimmiae	146	40	17	12	6	8	0	4	233
Bacteria;Bacteria_none;Firmicutes;Clostridia;Eubacteriales;Peptococcaceae;Paradesulfitobacterium;Paradesulfitobacterium aromaticivorans	0	2	168	14	38	3	7	0	232
Bacteria;Bacteria_none;Proteobacteria;Betaproteobacteria;Burkholderiales;Burkholderiaceae;Paraburkholderia;Paraburkholderia pallida	136	41	19	18	5	10	3	0	232
Bacteria;Bacteria_none;Bacteroidota;Bacteroidia;Bacteroidales;Dysgonomonadaceae;Proteiniphilum;Proteiniphilum acetatigenes	0	0	0	128	0	70	33	0	231
Bacteria;Bacteria_none;Firmicutes;Clostridia;Eubacteriales;Peptostreptococcaceae;Romboutsia;Romboutsia maritimum	10	37	55	58	15	22	13	21	231
Bacteria;Bacteria_none;Proteobacteria;Alphaproteobacteria;Rhodobacterales;Rhodobacteraceae;Paracoccus;Paracoccus limosus	84	57	23	50	2	4	9	2	231
Bacteria;Bacteria_none;Actinobacteria;Acidimicrobiia;Acidimicrobiales;Acidimicrobiaceae;Acidiferrimicrobium;Acidiferrimicrobium australe	22	107	27	52	5	2	11	3	229
Bacteria;Bacteria_none;Chloroflexi;Anaerolineae;Anaerolineales;Anaerolineaceae;Thermanaerothrix;Thermanaerothrix daxensis	3	9	176	23	6	5	3	3	228
Bacteria;Bacteria_none;Proteobacteria;Betaproteobacteria;Burkholderiales;Comamonadaceae;Extensimonas;Extensimonas vulgaris	139	38	15	20	1	7	4	4	228
Bacteria;Bacteria_none;Proteobacteria;Betaproteobacteria;Burkholderiales;Comamonadaceae;Lampropedia;Lampropedia hyalina	165	32	13	7	2	7	0	1	227
Bacteria;Bacteria_none;Proteobacteria;Alphaproteobacteria;Rhodobacterales;Rhodobacteraceae;Paracoccus;Paracoccus thiocyanatus	20	26	53	102	6	12	7	1	227
Bacteria;Bacteria_none;Firmicutes;Bacilli;Lactobacillales;Carnobacteriaceae;Trichococcus;Trichococcus palustris	165	24	5	21	2	1	7	2	227
Bacteria;Bacteria_none;Bacteroidota;Bacteroidia;Bacteroidales;Tenuifilaceae;Perlabentimonas;Perlabentimonas gracilis	18	158	19	18	5	4	5	0	227
Bacteria;Bacteria_none;Actinobacteria;Acidimicrobiia;Acidimicrobiales;Iamiaceae;Aquihabitans;Aquihabitans daechungensis	74	91	17	25	1	2	7	9	226
Bacteria;Bacteria_none;Planctomycetota;Phycisphaerae;Phycisphaerales;Phycisphaeraceae;Poriferisphaera;Poriferisphaera corsica	4	1	101	24	10	83	2	1	226
Bacteria;Bacteria_none;Proteobacteria;Betaproteobacteria;Neisseriales;Neisseriaceae;Paralysiella;Paralysiella testudinis	126	6	26	48	6	7	4	2	225
Bacteria;Bacteria_none;Bacteroidota;Bacteroidia;Bacteroidales;Prevotellaceae;Prevotella;Prevotella herbatica	40	3	6	102	0	22	16	36	225
Bacteria;Bacteria_none;Bacteroidota;Bacteroidia;Bacteroidales;Tannerellaceae;Parabacteroides;Parabacteroides chartae	13	18	0	113	0	17	11	53	225
Bacteria;Bacteria_none;Firmicutes;Clostridia;Eubacteriales;Oscillospiraceae;Ruthenibacterium;Ruthenibacterium lactatiformans	101	31	36	16	16	14	6	5	225
Bacteria;Bacteria_none;Proteobacteria;Alphaproteobacteria;Hyphomicrobiales;Methylobacteriaceae;Microvirga;Microvirga flavescens	28	60	37	74	8	5	6	6	224
Bacteria;Bacteria_none;Bacteroidota;Chitinophagia;Chitinophagales;Chitinophagaceae;Ferruginibacter;Ferruginibacter lapsinanis	179	32	3	2	1	1	0	6	224
Bacteria;Bacteria_none;Kiritimatiellaeota;Tichowtungiia;Tichowtungiales;Tichowtungiaceae;Tichowtungia;Tichowtungia aerotolerans	26	173	6	8	0	2	1	5	221
Bacteria;Bacteria_none;Proteobacteria;Alphaproteobacteria;Rhodobacterales;Rhodobacteraceae;Gemmobacter;Gemmobacter lanyuensis	107	52	35	16	3	6	1	0	220
Bacteria;Bacteria_none;Proteobacteria;Betaproteobacteria;Burkholderiales;Comamonadaceae;Polaromonas;Polaromonas glacialis	130	53	16	6	2	8	0	3	218
Bacteria;Bacteria_none;Actinobacteria;Actinomycetia;Pseudonocardiales;Pseudonocardiaceae;Actinokineospora;Actinokineospora cibodasensis	0	0	13	202	0	2	0	0	217
Bacteria;Bacteria_none;Proteobacteria;Betaproteobacteria;Burkholderiales;Burkholderiaceae;Paraburkholderia;Paraburkholderia franconis	156	41	15	2	0	0	2	1	217
Bacteria;Bacteria_none;Bacteroidota;Bacteroidia;Bacteroidales;Dysgonomonadaceae;Dysgonomonas;Dysgonomonas gadei	10	7	22	103	13	27	25	10	217
Bacteria;Bacteria_none;Firmicutes;Clostridia;Eubacteriales;Eubacteriales Family XIII. Incertae Sedis;Eubacteriales Family XIII. Incertae Sedis_Incertae_sedis;[Eubacterium] infirmum	7	33	98	12	18	39	4	5	216
Bacteria;Bacteria_none;Chloroflexi;Chloroflexia;Kallotenuales;Kallotenuaceae;Kallotenue;Kallotenue papyrolyticum	1	0	0	214	0	0	0	0	215
Bacteria;Bacteria_none;Firmicutes;Clostridia;Eubacteriales;Lachnospiraceae;Anaerotaenia;Anaerotaenia torta	4	19	70	7	11	100	2	2	215
Bacteria;Bacteria_none;Bacteroidota;Cytophagia;Cytophagales;Spirosomaceae;Lacihabitans;Lacihabitans soyangensis	212	0	0	1	0	0	0	1	214
Bacteria;Bacteria_none;Firmicutes;Clostridia;Thermosediminibacterales;Tepidanaerobacteraceae;Tepidanaerobacter;Tepidanaerobacter acetatoxydans	0	1	65	56	17	53	8	13	213
Bacteria;Bacteria_none;Proteobacteria;Alphaproteobacteria;Hyphomicrobiales;Nitrobacteraceae;Bradyrhizobium;Bradyrhizobium valentinum	48	87	21	30	8	7	8	3	212
Bacteria;Bacteria_none;Firmicutes;Clostridia;Eubacteriales;Desulfotomaculaceae;Pelotomaculum;Pelotomaculum terephthalicicum	0	18	107	16	12	52	7	0	212
Bacteria;Bacteria_none;Bacteroidota;Chitinophagia;Chitinophagales;Chitinophagaceae;Terrimonas;Terrimonas crocea	186	24	0	1	0	0	0	0	211
Bacteria;Bacteria_none;Firmicutes;Clostridia;Eubacteriales;Syntrophomonadaceae;Syntrophomonas;Syntrophomonas zehnderi	3	64	76	13	22	22	2	8	210
Bacteria;Bacteria_none;Firmicutes;Clostridia;Eubacteriales;Oscillospiraceae;Caproicibacter;Caproicibacter fermentans	24	66	49	35	11	13	5	5	208
Bacteria;Bacteria_none;Firmicutes;Clostridia;Eubacteriales;Oscillospiraceae;Gorbachella;Gorbachella massiliensis	14	88	16	39	11	25	12	2	207
Bacteria;Bacteria_none;Proteobacteria;Deltaproteobacteria;Desulfobacterales;Desulfocapsaceae;Desulfofustis;Desulfofustis glycolicus	3	66	95	7	30	2	1	2	206
Bacteria;Bacteria_none;Firmicutes;Clostridia;Eubacteriales;Clostridiaceae;Lutispora;Lutispora thermophila	3	41	78	30	28	15	6	5	206
Bacteria;Bacteria_none;Synergistetes;Synergistia;Synergistales;Synergistaceae;Aminobacterium;Aminobacterium colombiense	8	65	32	82	1	2	8	7	205
Bacteria;Bacteria_none;Spirochaetes;Spirochaetia;Leptospirales;Leptospiraceae;Turneriella;Turneriella parva	3	55	98	3	29	16	1	0	205
Bacteria;Bacteria_none;Bacteroidota;Bacteroidia;Bacteroidales;Porphyromonadaceae;Porphyromonas;Porphyromonas levii	9	28	19	95	3	5	30	16	205
Bacteria;Bacteria_none;Proteobacteria;Gammaproteobacteria;Legionellales;Legionellaceae;Legionella;Legionella israelensis	64	30	23	54	10	12	8	3	204
Bacteria;Bacteria_none;Firmicutes;Clostridia;Eubacteriales;Clostridiaceae;Oxobacter;Oxobacter pfennigii	6	69	70	29	10	14	2	3	203
Bacteria;Bacteria_none;Firmicutes;Clostridia;Eubacteriales;Lachnospiraceae;Butyrivibrio;Butyrivibrio proteoclasticus	18	14	99	18	18	28	1	6	202
Bacteria;Bacteria_none;Planctomycetota;Planctomycetia;Gemmatales;Gemmataceae;Gemmata;Gemmata palustris	139	46	0	8	2	5	1	0	201
Bacteria;Bacteria_none;Proteobacteria;Deltaproteobacteria;Myxococcales;Kofleriaceae;Haliangium;Haliangium ochraceum	161	3	5	19	4	2	1	6	201
Bacteria;Bacteria_none;Proteobacteria;Betaproteobacteria;Burkholderiales;Comamonadaceae;Extensimonas;Extensimonas perlucida	92	66	16	2	8	10	6	1	201
Bacteria;Bacteria_none;Firmicutes;Clostridia;Eubacteriales;Lachnospiraceae;Bilifractor;Bilifractor porci	32	12	74	44	10	12	11	5	200
Bacteria;Bacteria_none;Proteobacteria;Betaproteobacteria;Nitrosomonadales;Methylophilaceae;Methylobacillus;Methylobacillus pratensis	1	2	25	146	5	0	18	3	200
Bacteria;Bacteria_none;Proteobacteria;Alphaproteobacteria;Hyphomicrobiales;Hyphomicrobiaceae;Hyphomicrobium;Hyphomicrobium album	63	62	25	33	3	10	4	0	200
Bacteria;Bacteria_none;Proteobacteria;Gammaproteobacteria;Enterobacterales;Enterobacteriaceae;Enterobacter;Enterobacter soli	180	0	0	19	0	0	0	0	199
Bacteria;Bacteria_none;Bacteroidota;Bacteroidia;Bacteroidales;Dysgonomonadaceae;Petrimonas;Petrimonas sulfuriphila	8	77	16	66	2	12	13	5	199
Bacteria;Bacteria_none;Acidobacteria;Holophagae;Thermotomaculales;Thermotomaculaceae;Thermotomaculum;Thermotomaculum hydrothermale	1	8	36	121	0	10	20	3	199
Bacteria;Bacteria_none;Proteobacteria;Alphaproteobacteria;Hyphomicrobiales;Xanthobacteraceae;Xanthobacter;Xanthobacter agilis	27	46	53	33	9	27	2	2	199
Bacteria;Bacteria_none;Chlamydiae;Chlamydiia;Parachlamydiales;Criblamydiaceae;Estrella;Estrella lausannensis	23	166	8	0	0	1	0	0	198
Bacteria;Bacteria_none;Proteobacteria;Alphaproteobacteria;Hyphomicrobiales;Nitrobacteraceae;Bradyrhizobium;Bradyrhizobium forestalis	45	63	26	44	2	12	2	4	198
Bacteria;Bacteria_none;Verrucomicrobia;Verrucomicrobiae;Verrucomicrobiales;Verrucomicrobiaceae;Haloferula;Haloferula helveola	24	172	0	1	0	0	0	0	197
Bacteria;Bacteria_none;Verrucomicrobia;Verrucomicrobiae;Verrucomicrobiales;Verrucomicrobiaceae;Phragmitibacter;Phragmitibacter flavus	2	188	7	0	0	0	0	0	197
Bacteria;Bacteria_none;Planctomycetota;Planctomycetia;Planctomycetales;Planctomycetaceae;Rubinisphaera;Rubinisphaera brasiliensis	28	34	14	57	14	15	18	15	195
Bacteria;Bacteria_none;Firmicutes;Clostridia;Eubacteriales;Clostridiales Family XVI. Incertae Sedis;Carboxydocella;Carboxydocella sporoproducens	5	24	83	17	20	38	4	4	195
Bacteria;Bacteria_none;Proteobacteria;Alphaproteobacteria;Hyphomicrobiales;Parvibaculaceae;Parvibaculum;Parvibaculum sedimenti	5	30	99	7	49	5	0	0	195
Bacteria;Bacteria_none;Proteobacteria;Alphaproteobacteria;Hyphomicrobiales;Methylocystaceae;Methylocystis;Methylocystis rosea	42	80	50	11	0	5	0	7	195
Bacteria;Bacteria_none;Proteobacteria;Deltaproteobacteria;Myxococcales;Labilitrichaceae;Labilithrix;Labilithrix luteola	159	8	5	14	2	2	2	2	194
Bacteria;Bacteria_none;Acidobacteria;Holophagae;Holophagales;Holophagaceae;Geothrix;Geothrix fermentans	38	145	4	2	0	0	0	3	192
Bacteria;Bacteria_none;Firmicutes;Clostridia;Eubacteriales;Symbiobacteriaceae;Symbiobacterium;Symbiobacterium terraclitae	3	53	86	5	1	41	0	3	192
Bacteria;Bacteria_none;Proteobacteria;Alphaproteobacteria;Hyphomicrobiales;Stappiaceae;Roseibium;Roseibium album	19	90	16	48	2	9	4	4	192
Bacteria;Bacteria_none;Proteobacteria;Betaproteobacteria;Burkholderiales;Sphaerotilaceae;Sphaerotilus;Sphaerotilus hippei	189	2	1	0	0	0	0	0	192
Bacteria;Bacteria_none;Firmicutes;Negativicutes;Veillonellales;Veillonellaceae;Megasphaera;Megasphaera cerevisiae	69	2	20	52	2	9	32	5	191
Bacteria;Bacteria_none;Firmicutes;Clostridia;Eubacteriales;Lachnospiraceae;Qiania;Qiania dongpingensis	33	122	16	5	5	9	1	0	191
Bacteria;Bacteria_none;Firmicutes;Clostridia;Eubacteriales;Lachnospiraceae;Roseburia;Roseburia intestinalis	10	19	54	36	7	20	16	27	189
Bacteria;Bacteria_none;Proteobacteria;Alphaproteobacteria;Hyphomicrobiales;Methylocystaceae;Methylopila;Methylopila capsulata	44	64	27	28	11	8	4	3	189
Bacteria;Bacteria_none;Spirochaetes;Spirochaetia;Spirochaetales;Treponemataceae;Treponema;Treponema phagedenis	4	11	64	62	7	10	8	23	189
Bacteria;Bacteria_none;Chloroflexi;Caldilineae;Caldilineales;Caldilineaceae;Litorilinea;Litorilinea aerophila	85	82	15	3	0	3	0	1	189
Bacteria;Bacteria_none;Proteobacteria;Deltaproteobacteria;Syntrophobacterales;Syntrophobacteraceae;Syntrophobacter;Syntrophobacter fumaroxidans	3	50	108	3	24	0	0	0	188
Bacteria;Bacteria_none;Firmicutes;Clostridia;Eubacteriales;Lachnospiraceae;Anaerostipes;Anaerostipes hadrus	148	12	8	10	2	1	5	2	188
Bacteria;Bacteria_none;Firmicutes;Clostridia;Eubacteriales;Lachnospiraceae;Lachnospiraceae_Incertae_sedis;[Eubacterium] rectale	144	13	4	11	2	2	0	11	187
Bacteria;Bacteria_none;Proteobacteria;Betaproteobacteria;Rhodocyclales;Azonexaceae;Dechloromonas;Dechloromonas denitrificans	36	41	55	42	5	8	0	0	187
Bacteria;Bacteria_none;Bacteroidota;Bacteroidia;Bacteroidales;Bacteroidaceae;Bacteroides;Bacteroides ihuae	6	156	12	12	0	0	0	1	187
Bacteria;Bacteria_none;Firmicutes;Clostridia;Eubacteriales;Clostridiaceae;Clostridium;Clostridium tertium	23	19	39	64	8	9	13	11	186
Bacteria;Bacteria_none;Actinobacteria;Actinomycetia;Actinomycetales;Actinomycetaceae;Actinotignum;Actinotignum urinale	57	54	24	35	2	1	6	5	184
Bacteria;Bacteria_none;Proteobacteria;Alphaproteobacteria;Rhodobacterales;Rhodobacteraceae;Paracoccus;Paracoccus simplex	113	40	9	16	2	0	1	3	184
Bacteria;Bacteria_none;Bacteroidota;Bacteroidia;Bacteroidales;Bacteroidaceae;Bacteroides;Bacteroides fragilis	3	12	16	117	1	15	8	12	184
Bacteria;Bacteria_none;Firmicutes;Clostridia;Eubacteriales;Clostridiaceae;Clostridium;Clostridium pasteurianum	1	0	4	159	0	0	14	6	184
Bacteria;Bacteria_none;Firmicutes;Clostridia;Eubacteriales;Oscillospiraceae;Anaerofilum;Anaerofilum pentosovorans	70	21	33	20	13	14	10	2	183
Bacteria;Bacteria_none;Firmicutes;Clostridia;Eubacteriales;Peptococcaceae;Desulforamulus;Desulforamulus profundi	0	11	118	6	33	11	4	0	183
Bacteria;Bacteria_none;Proteobacteria;Alphaproteobacteria;Rhodobacterales;Rhodobacteraceae;Coraliihabitans;Coraliihabitans acroporae	59	41	24	35	7	10	5	1	182
Bacteria;Bacteria_none;Proteobacteria;Betaproteobacteria;Burkholderiales;Comamonadaceae;Diaphorobacter;Diaphorobacter aerolatus	158	12	2	0	2	4	1	3	182
Bacteria;Bacteria_none;Firmicutes;Clostridia;Eubacteriales;Syntrophomonadaceae;Syntrophomonas;Syntrophomonas cellicola	0	2	100	43	1	23	4	7	180
Bacteria;Bacteria_none;Planctomycetota;Planctomycetia;Pirellulales;Lacipirellulaceae;Adhaeretor;Adhaeretor mobilis	20	38	23	53	17	19	6	4	180
Bacteria;Bacteria_none;Actinobacteria;Acidimicrobiia;Acidimicrobiales;Ilumatobacteraceae;Ilumatobacter;Ilumatobacter fluminis	55	56	29	29	1	3	7	0	180
Bacteria;Bacteria_none;Cyanobacteria;Cyanobacteria_Incertae_sedis;Oscillatoriales;Oscillatoriaceae;Tenebriella;Tenebriella amphibia	0	0	8	150	4	13	4	0	179
Bacteria;Bacteria_none;Actinobacteria;Acidimicrobiia;Acidimicrobiales;Acidimicrobiaceae;Acidithrix;Acidithrix ferrooxidans	13	50	26	58	6	8	9	9	179
Bacteria;Bacteria_none;Proteobacteria;Alphaproteobacteria;Micropepsales;Micropepsaceae;Rhizomicrobium;Rhizomicrobium electricum	72	32	22	39	2	8	1	1	177
Bacteria;Bacteria_none;Proteobacteria;Betaproteobacteria;Burkholderiales;Burkholderiaceae;Cupriavidus;Cupriavidus yeoncheonensis	120	22	10	9	4	7	2	3	177
Bacteria;Bacteria_none;Actinobacteria;Actinomycetia;Streptomycetales;Streptomycetaceae;Streptomyces;Streptomyces phytohabitans	0	4	101	43	8	1	12	8	177
Bacteria;Bacteria_none;Firmicutes;Firmicutes_Incertae_sedis;Firmicutes_Incertae_sedis;Firmicutes_Incertae_sedis;Hydrogenispora;Hydrogenispora ethanolica	2	10	46	11	65	25	5	12	176
Bacteria;Bacteria_none;Firmicutes;Clostridia;Eubacteriales;Oscillospiraceae;Marseillibacter;Marseillibacter massiliensis	11	25	56	20	9	16	21	18	176
Bacteria;Bacteria_none;Acidobacteria;Blastocatellia;Blastocatellales;Blastocatellaceae;Stenotrophobacter;Stenotrophobacter terrae	130	19	11	11	1	2	0	2	176
Bacteria;Bacteria_none;Firmicutes;Bacilli;Lactobacillales;Streptococcaceae;Streptococcus;Streptococcus didelphis	134	13	8	9	0	2	5	4	175
Bacteria;Bacteria_none;Firmicutes;Clostridia;Eubacteriales;Lachnospiraceae;Waltera;Waltera intestinalis	30	41	47	27	10	8	7	5	175
Bacteria;Bacteria_none;Chloroflexi;Anaerolineae;Anaerolineales;Anaerolineaceae;Anaerolinea;Anaerolinea thermophila	9	8	125	19	3	4	6	0	174
Bacteria;Bacteria_none;Firmicutes;Clostridia;Eubacteriales;Thermincolaceae;Thermincola;Thermincola ferriacetica	0	0	135	11	25	2	0	0	173
Bacteria;Bacteria_none;Firmicutes;Clostridia;Eubacteriales;Clostridiales Family XVII. Incertae Sedis;Sulfobacillus;Sulfobacillus thermotolerans	5	31	87	16	0	10	24	0	173
Bacteria;Bacteria_none;Proteobacteria;Gammaproteobacteria;Xanthomonadales;Xanthomonadaceae;Thermomonas;Thermomonas beijingensis	112	19	9	21	7	3	1	0	172
Bacteria;Bacteria_none;Proteobacteria;Betaproteobacteria;Burkholderiales;Comamonadaceae;Ottowia;Ottowia thiooxydans	113	23	18	5	4	5	3	1	172
Bacteria;Bacteria_none;Firmicutes;Erysipelotrichia;Erysipelotrichales;Erysipelotrichaceae;Erysipelothrix;Erysipelothrix piscisicarius	13	11	58	43	12	10	10	15	172
Bacteria;Bacteria_none;Firmicutes;Clostridia;Eubacteriales;Clostridiaceae;Clostridium;Clostridium oryzae	55	60	19	15	6	12	2	3	172
Bacteria;Bacteria_none;Proteobacteria;Betaproteobacteria;Neisseriales;Chromobacteriaceae;Chitinibacter;Chitinibacter alvei	93	53	15	3	4	4	0	0	172
Bacteria;Bacteria_none;Firmicutes;Clostridia;Thermoanaerobacterales;Zhaonellaceae;Zhaonella;Zhaonella formicivorans	0	2	102	12	12	37	2	4	171
Bacteria;Bacteria_none;Planctomycetota;Planctomycetia;Pirellulales;Pirellulaceae;Lignipirellula;Lignipirellula cremea	20	16	39	67	13	4	10	2	171
Bacteria;Bacteria_none;Proteobacteria;Betaproteobacteria;Burkholderiales;Comamonadaceae;Polaromonas;Polaromonas vacuolata	91	56	6	6	1	8	1	2	171
Bacteria;Bacteria_none;Proteobacteria;Gammaproteobacteria;Moraxellales;Moraxellaceae;Acinetobacter;Acinetobacter parvus	125	4	3	28	1	2	2	6	171
Bacteria;Bacteria_none;Firmicutes;Negativicutes;Selenomonadales;Selenomonadaceae;Selenomonas;Selenomonas lacticifex	82	21	15	15	2	14	9	13	171
Bacteria;Bacteria_none;Proteobacteria;Deltaproteobacteria;Desulfuromonadales;Geobacteraceae;Geobacter;Geobacter luticola	2	95	4	0	64	2	0	4	171
Bacteria;Bacteria_none;Proteobacteria;Alphaproteobacteria;Hyphomicrobiales;Pleomorphomonadaceae;Oharaeibacter;Oharaeibacter diazotrophicus	59	43	23	26	8	7	5	0	171
Bacteria;Bacteria_none;Proteobacteria;Alphaproteobacteria;Hyphomicrobiales;Hyphomicrobiaceae;Filomicrobium;Filomicrobium insigne	81	35	14	24	6	3	6	2	171
Bacteria;Bacteria_none;Planctomycetota;Planctomycetia;Gemmatales;Gemmataceae;Zavarzinella;Zavarzinella formosa	134	25	2	7	0	1	1	0	170
Bacteria;Bacteria_none;Proteobacteria;Alphaproteobacteria;Rhodobacterales;Rhodobacteraceae;Amaricoccus;Amaricoccus macauensis	29	34	25	68	1	3	7	2	169
Bacteria;Bacteria_none;Planctomycetota;Planctomycetia;Isosphaerales;Isosphaeraceae;Paludisphaera;Paludisphaera soli	83	53	10	6	3	12	1	1	169
Bacteria;Bacteria_none;Firmicutes;Clostridia;Eubacteriales;Defluviitaleaceae;Defluviitalea;Defluviitalea phaphyphila	1	19	79	23	18	21	1	6	168
Bacteria;Bacteria_none;Proteobacteria;Betaproteobacteria;Burkholderiales;Comamonadaceae;Pseudorhodoferax;Pseudorhodoferax soli	123	26	4	2	5	7	0	1	168
Bacteria;Bacteria_none;Proteobacteria;Alphaproteobacteria;Hyphomicrobiales;Rhizobiaceae;Shinella;Shinella pollutisoli	54	83	9	12	0	10	0	0	168
Bacteria;Bacteria_none;Bacteroidota;Chitinophagia;Chitinophagales;Chitinophagaceae;Terrimonas;Terrimonas suqianensis	133	10	7	9	2	3	3	0	167
Bacteria;Bacteria_none;Proteobacteria;Alphaproteobacteria;Hyphomicrobiales;Devosiaceae;Devosia;Devosia sediminis	53	34	14	45	6	4	7	4	167
Bacteria;Bacteria_none;Proteobacteria;Betaproteobacteria;Rhodocyclales;Zoogloeaceae;Pseudazoarcus;Pseudazoarcus pumilus	80	12	11	40	2	11	5	6	167
Bacteria;Bacteria_none;Firmicutes;Clostridia;Eubacteriales;Eubacteriales Family XIII. Incertae Sedis;Eubacteriales Family XIII. Incertae Sedis_Incertae_sedis;[Eubacterium] saphenum	5	22	47	49	6	21	13	3	166
Bacteria;Bacteria_none;Proteobacteria;Betaproteobacteria;Burkholderiales;Comamonadaceae;Delftia;Delftia acidovorans	123	25	5	1	4	8	0	0	166
Bacteria;Bacteria_none;Firmicutes;Clostridia;Eubacteriales;Lachnospiraceae;Lachnoclostridium;Lachnoclostridium urinimassiliense	18	29	56	23	9	20	4	7	166
Bacteria;Bacteria_none;Firmicutes;Clostridia;Eubacteriales;Clostridiaceae;Clostridium;Clostridium celatum	10	25	33	55	9	14	11	9	166
Bacteria;Bacteria_none;Firmicutes;Clostridia;Eubacteriales;Clostridiaceae;Clostridium;Clostridium estertheticum	13	12	24	91	6	8	8	4	166
Bacteria;Bacteria_none;Firmicutes;Bacilli;Bacillales;Bacillaceae;Ornithinibacillus;Ornithinibacillus heyuanensis	24	53	40	24	2	6	12	4	165
Bacteria;Bacteria_none;Actinobacteria;Actinomycetia;Propionibacteriales;Propionibacteriaceae;Aestuariimicrobium;Aestuariimicrobium ganziense	25	40	43	33	5	7	5	7	165
Bacteria;Bacteria_none;Firmicutes;Negativicutes;Acidaminococcales;Acidaminococcaceae;Acidaminococcus;Acidaminococcus massiliensis	53	1	26	50	10	13	7	5	165
Bacteria;Bacteria_none;Bacteroidota;Bacteroidia;Bacteroidales;Barnesiellaceae;Barnesiella;Barnesiella viscericola	1	13	82	16	33	0	3	16	164
Bacteria;Bacteria_none;Proteobacteria;Alphaproteobacteria;Rhodospirillales;Rhodospirillaceae;Dongia;Dongia mobilis	61	26	22	31	9	6	3	6	164
Bacteria;Bacteria_none;Proteobacteria;Deltaproteobacteria;Desulfovibrionales;Desulfovibrionaceae;Humidesulfovibrio;Humidesulfovibrio mexicanus	2	31	92	1	37	0	0	1	164
Bacteria;Bacteria_none;Bacteroidota;Bacteroidia;Bacteroidales;Bacteroidaceae;Bacteroides;Bacteroides gallinarum	6	145	2	9	0	2	0	0	164
Bacteria;Bacteria_none;Firmicutes;Bacilli;Lactobacillales;Streptococcaceae;Streptococcus;Streptococcus vestibularis	119	15	10	10	4	2	1	3	164
Bacteria;Bacteria_none;Firmicutes;Clostridia;Eubacteriales;Clostridiaceae;Paraclostridium;Paraclostridium bifermentans	10	35	38	31	14	24	7	5	164
Bacteria;Bacteria_none;Proteobacteria;Gammaproteobacteria;Enterobacterales;Enterobacteriaceae;Franconibacter;Franconibacter helveticus	125	9	1	12	1	2	6	7	163
Bacteria;Bacteria_none;Firmicutes;Clostridia;Eubacteriales;Eubacteriaceae;Eubacterium;Eubacterium callanderi	24	24	20	58	7	6	0	24	163
Bacteria;Bacteria_none;Nitrospirae;Nitrospira;Nitrospirales;Nitrospiraceae;Nitrospira;Nitrospira lenta	56	106	1	0	0	0	0	0	163
Bacteria;Bacteria_none;Proteobacteria;Betaproteobacteria;Burkholderiales;Comamonadaceae;Comamonas;Comamonas aquatica	97	14	17	5	4	24	2	0	163
Bacteria;Bacteria_none;Firmicutes;Bacilli;Lactobacillales;Streptococcaceae;Streptococcus;Streptococcus constellatus	134	5	5	10	3	2	3	1	163
Bacteria;Bacteria_none;Synergistetes;Synergistia;Synergistales;Synergistaceae;Thermovirga;Thermovirga lienii	7	90	24	23	7	5	5	2	163
Bacteria;Bacteria_none;Proteobacteria;Betaproteobacteria;Burkholderiales;Burkholderiaceae;Cupriavidus;Cupriavidus agavae	121	15	11	0	9	6	0	0	162
Bacteria;Bacteria_none;Firmicutes;Clostridia;Eubacteriales;Peptococcaceae;Desulfofarcimen;Desulfofarcimen acetoxidans	1	3	35	15	3	95	4	6	162
Bacteria;Bacteria_none;Verrucomicrobia;Verrucomicrobiae;Verrucomicrobiales;Verrucomicrobiaceae;Luteolibacter;Luteolibacter algae	7	150	5	0	0	0	0	0	162
Bacteria;Bacteria_none;Proteobacteria;Gammaproteobacteria;Legionellales;Legionellaceae;Legionella;Legionella cincinnatiensis	38	32	31	34	4	16	6	1	162
Bacteria;Bacteria_none;Proteobacteria;Betaproteobacteria;Burkholderiales;Comamonadaceae;Giesbergeria;Giesbergeria voronezhensis	115	22	6	6	2	6	1	4	162
Bacteria;Bacteria_none;Proteobacteria;Betaproteobacteria;Rhodocyclales;Zoogloeaceae;Thauera;Thauera terpenica	67	37	15	7	1	10	25	0	162
Bacteria;Bacteria_none;Proteobacteria;Deltaproteobacteria;Syntrophobacterales;Syntrophobacteraceae;Syntrophobacter;Syntrophobacter wolinii	15	87	35	13	6	3	1	2	162
Bacteria;Bacteria_none;Proteobacteria;Alphaproteobacteria;Hyphomicrobiales;Methylocystaceae;Methylopila;Methylopila jiangsuensis	8	38	33	54	1	5	6	16	161
Bacteria;Bacteria_none;Firmicutes;Bacilli;Lactobacillales;Streptococcaceae;Streptococcus;Streptococcus orisuis	115	13	17	5	1	4	2	4	161
Bacteria;Bacteria_none;Firmicutes;Clostridia;Eubacteriales;Oscillospiraceae;Faecalibacterium;Faecalibacterium duncaniae	102	11	17	13	6	2	4	6	161
Bacteria;Bacteria_none;Proteobacteria;Betaproteobacteria;Burkholderiales;Comamonadaceae;Melaminivora;Melaminivora jejuensis	56	8	22	45	5	2	18	5	161
Bacteria;Bacteria_none;Proteobacteria;Betaproteobacteria;Rhodocyclales;Azonexaceae;Ferribacterium;Ferribacterium limneticum	71	29	19	23	2	6	6	5	161
Bacteria;Bacteria_none;Firmicutes;Clostridia;Thermoanaerobacterales;Thermoanaerobacteraceae;Carboxydothermus;Carboxydothermus pertinax	0	1	24	118	1	3	13	0	160
Bacteria;Bacteria_none;Firmicutes;Erysipelotrichia;Erysipelotrichales;Turicibacteraceae;Turicibacter;Turicibacter sanguinis	18	23	43	25	7	19	10	15	160
Bacteria;Bacteria_none;Proteobacteria;Betaproteobacteria;Burkholderiales;Comamonadaceae;Rhodoferax;Rhodoferax aquaticus	84	32	29	5	4	5	0	0	159
Bacteria;Bacteria_none;Actinobacteria;Thermoleophilia;Solirubrobacterales;Conexibacteraceae;Conexibacter;Conexibacter woesei	19	21	31	51	9	17	6	5	159
Bacteria;Bacteria_none;Proteobacteria;Alphaproteobacteria;Hyphomicrobiales;Nitrobacteraceae;Bradyrhizobium;Bradyrhizobium lupini	24	54	35	22	9	3	6	6	159
Bacteria;Bacteria_none;Firmicutes;Clostridia;Eubacteriales;Christensenellaceae;Christensenella;Christensenella hongkongensis	18	115	6	7	0	10	3	0	159
Bacteria;Bacteria_none;Proteobacteria;Betaproteobacteria;Burkholderiales;Oxalobacteraceae;Herbaspirillum;Herbaspirillum piri	64	36	22	18	2	9	5	2	158
Bacteria;Bacteria_none;Proteobacteria;Alphaproteobacteria;Hyphomicrobiales;Nitrobacteraceae;Nitrobacter;Nitrobacter hamburgensis	33	37	36	41	11	0	0	0	158
Bacteria;Bacteria_none;Proteobacteria;Gammaproteobacteria;Enterobacterales;Enterobacteriaceae;Klebsiella;Klebsiella variicola	72	6	9	49	2	2	13	5	158
Bacteria;Bacteria_none;Actinobacteria;Thermoleophilia;Solirubrobacterales;Conexibacteraceae;Conexibacter;Conexibacter stalactiti	18	19	37	45	8	9	12	10	158
Bacteria;Bacteria_none;Firmicutes;Clostridia;Eubacteriales;Lachnospiraceae;Variimorphobacter;Variimorphobacter saccharofermentans	1	3	53	15	2	76	2	6	158
Bacteria;Bacteria_none;Firmicutes;Erysipelotrichia;Erysipelotrichales;Erysipelotrichaceae;Solobacterium;Solobacterium moorei	34	3	37	37	12	16	14	4	157
Bacteria;Bacteria_none;Proteobacteria;Betaproteobacteria;Burkholderiales;Alcaligenaceae;Parvibium;Parvibium lacunae	112	17	10	6	5	4	2	1	157
Bacteria;Bacteria_none;Firmicutes;Clostridia;Eubacteriales;Eubacteriaceae;Anaerofustis;Anaerofustis stercorihominis	41	63	25	11	6	6	3	1	156
Bacteria;Bacteria_none;Proteobacteria;Betaproteobacteria;Rhodocyclales;Azonexaceae;Dechloromonas;Dechloromonas agitata	5	107	8	19	1	11	5	0	156
Bacteria;Bacteria_none;Firmicutes;Bacilli;Lactobacillales;Streptococcaceae;Streptococcus;Streptococcus danieliae	136	4	4	8	0	0	1	2	155
Bacteria;Bacteria_none;Firmicutes;Tissierellia;Tissierellales;Peptoniphilaceae;Anaerococcus;Anaerococcus degeneri	26	35	40	18	11	12	4	9	155
Bacteria;Bacteria_none;Firmicutes;Bacilli;Bacillales;Paenibacillaceae;Paenibacillus;Paenibacillus caui	0	0	12	11	3	125	1	3	155
Bacteria;Bacteria_none;Proteobacteria;Alphaproteobacteria;Hyphomicrobiales;Methylobacteriaceae;Enterovirga;Enterovirga rhinocerotis	28	30	29	37	12	16	1	2	155
Bacteria;Bacteria_none;Proteobacteria;Alphaproteobacteria;Rhodobacterales;Rhodobacteraceae;Paracoccus;Paracoccus contaminans	72	34	11	20	3	5	7	2	154
Bacteria;Bacteria_none;Proteobacteria;Betaproteobacteria;Nitrosomonadales;Thiobacillaceae;Sulfuritortus;Sulfuritortus calidifontis	88	28	14	8	1	8	5	1	153
Bacteria;Bacteria_none;Firmicutes;Clostridia;Eubacteriales;Clostridiaceae;Clostridium;Clostridium nitrophenolicum	4	21	4	102	3	4	8	7	153
Bacteria;Bacteria_none;Proteobacteria;Betaproteobacteria;Rhodocyclales;Rhodocyclaceae;Rugosibacter;Rugosibacter aromaticivorans	77	26	17	12	9	4	4	2	151
Bacteria;Bacteria_none;Firmicutes;Clostridia;Eubacteriales;Desulfotomaculaceae;Pelotomaculum;Pelotomaculum thermopropionicum	4	10	17	8	3	107	2	0	151
Bacteria;Bacteria_none;Proteobacteria;Gammaproteobacteria;Enterobacterales;Enterobacteriaceae;Trabulsiella;Trabulsiella guamensis	121	8	1	9	0	0	3	9	151
Bacteria;Bacteria_none;Proteobacteria;Alphaproteobacteria;Rhodospirillales;Acetobacteraceae;Roseomonas;Roseomonas lacus	25	37	35	30	2	15	5	2	151
Bacteria;Bacteria_none;Proteobacteria;Betaproteobacteria;Burkholderiales;Comamonadaceae;Diaphorobacter;Diaphorobacter caeni	115	21	1	4	2	7	1	0	151
Bacteria;Bacteria_none;Verrucomicrobia;Verrucomicrobiae;Verrucomicrobiales;Verrucomicrobiaceae;Prosthecobacter;Prosthecobacter algae	23	114	13	0	0	0	0	0	150
Bacteria;Bacteria_none;Bacteroidota;Chitinophagia;Chitinophagales;Chitinophagaceae;Hanamia;Hanamia caeni	117	26	2	3	1	1	0	0	150
Bacteria;Bacteria_none;Actinobacteria;Actinomycetia;Corynebacteriales;Corynebacteriaceae;Corynebacterium;Corynebacterium maris	0	0	6	130	0	5	8	0	149
Bacteria;Bacteria_none;Proteobacteria;Betaproteobacteria;Rhodocyclales;Rhodocyclaceae;Propionivibrio;Propionivibrio limicola	65	10	32	24	3	8	2	5	149
Bacteria;Bacteria_none;Firmicutes;Clostridia;Eubacteriales;Lachnospiraceae;Anaerotignum;Anaerotignum aminivorans	20	3	53	24	15	21	5	7	148
Bacteria;Bacteria_none;Firmicutes;Clostridia;Eubacteriales;Eubacteriales Family XIII. Incertae Sedis;Mogibacterium;Mogibacterium kristiansenii	9	77	34	9	2	17	0	0	148
Bacteria;Bacteria_none;Firmicutes;Clostridia;Halanaerobiales;Halanaerobiaceae;Halothermothrix;Halothermothrix orenii	1	32	75	2	17	15	3	3	148
Bacteria;Bacteria_none;Proteobacteria;Betaproteobacteria;Burkholderiales;Comamonadaceae;Comamonas;Comamonas piscis	91	40	5	5	5	0	0	2	148
Bacteria;Bacteria_none;Firmicutes;Clostridia;Eubacteriales;Oscillospiraceae;Ruminiclostridium;Ruminiclostridium papyrosolvens	3	32	33	13	36	19	4	7	147
Bacteria;Bacteria_none;Planctomycetota;Planctomycetia;Planctomycetales;Planctomycetaceae;Planctomicrobium;Planctomicrobium piriforme	45	31	12	44	4	4	6	1	147
Bacteria;Bacteria_none;Proteobacteria;Betaproteobacteria;Burkholderiales;Comamonadaceae;Acidovorax;Acidovorax facilis	117	12	12	4	0	1	0	1	147
Bacteria;Bacteria_none;Firmicutes;Bacilli;Lactobacillales;Streptococcaceae;Streptococcus;Streptococcus mitis	113	11	12	7	0	0	0	3	146
Bacteria;Bacteria_none;Proteobacteria;Betaproteobacteria;Rhodocyclales;Azonexaceae;Azonexus;Azonexus fungiphilus	62	27	14	27	2	7	2	5	146
Bacteria;Bacteria_none;Proteobacteria;Gammaproteobacteria;Moraxellales;Moraxellaceae;Acinetobacter;Acinetobacter proteolyticus	57	0	14	43	0	0	10	22	146
Bacteria;Bacteria_none;Firmicutes;Clostridia;Eubacteriales;Oscillospiraceae;Oscillospiraceae_Incertae_sedis;[Eubacterium] siraeum	14	34	29	13	14	29	5	8	146
Bacteria;Bacteria_none;Firmicutes;Clostridia;Eubacteriales;Lachnospiraceae;Anaerobutyricum;Anaerobutyricum soehngenii	59	20	29	16	7	7	3	4	145
Bacteria;Bacteria_none;Actinobacteria;Actinomycetia;Pseudonocardiales;Pseudonocardiaceae;Lentzea;Lentzea tibetensis	2	2	19	92	5	3	12	10	145
Bacteria;Bacteria_none;Actinobacteria;Acidimicrobiia;Acidimicrobiales;Ilumatobacteraceae;Ilumatobacter;Ilumatobacter nonamiensis	43	65	14	15	1	6	1	0	145
Bacteria;Bacteria_none;Planctomycetota;Planctomycetia;Isosphaerales;Isosphaeraceae;Paludisphaera;Paludisphaera borealis	93	35	6	4	3	0	2	2	145
Bacteria;Bacteria_none;Proteobacteria;Gammaproteobacteria;Xanthomonadales;Rhodanobacteraceae;Dokdonella;Dokdonella kunshanensis	89	30	4	7	1	1	9	4	145
Bacteria;Bacteria_none;Proteobacteria;Epsilonproteobacteria;Campylobacterales;Thiovulaceae;Sulfurimonas;Sulfurimonas xiamenensis	0	20	18	83	0	9	14	0	144
Bacteria;Bacteria_none;Proteobacteria;Alphaproteobacteria;Caulobacterales;Caulobacteraceae;Phenylobacterium;Phenylobacterium haematophilum	26	38	21	39	8	5	5	2	144
Bacteria;Bacteria_none;Actinobacteria;Actinomycetia;Propionibacteriales;Propionibacteriaceae;Propioniciclava;Propioniciclava flava	54	37	14	30	3	0	4	2	144
Bacteria;Bacteria_none;Acidobacteria;Acidobacteriia;Bryobacterales;Bryobacteraceae;Paludibaculum;Paludibaculum fermentans	25	22	35	28	14	14	5	1	144
Bacteria;Bacteria_none;Bacteroidota;Bacteroidia;Bacteroidales;Prevotellaceae;Prevotella;Prevotella paludivivens	14	8	18	71	0	14	4	15	144
Bacteria;Bacteria_none;Proteobacteria;Betaproteobacteria;Burkholderiales;Alcaligenaceae;Achromobacter;Achromobacter marplatensis	104	15	13	2	0	6	1	3	144
Bacteria;Bacteria_none;Firmicutes;Clostridia;Thermoanaerobacterales;Thermoanaerobacteraceae;Thermoanaerobacter;Thermoanaerobacter sulfurophilus	1	6	70	36	12	5	12	1	143
Bacteria;Bacteria_none;Proteobacteria;Betaproteobacteria;Burkholderiales;Burkholderiaceae;Paraburkholderia;Paraburkholderia oxyphila	63	42	8	12	5	7	6	0	143
Bacteria;Bacteria_none;Proteobacteria;Betaproteobacteria;Burkholderiales;Comamonadaceae;Pelomonas;Pelomonas saccharophila	73	35	8	10	2	6	9	0	143
Bacteria;Bacteria_none;Actinobacteria;Actinomycetia;Propionibacteriales;Propionibacteriaceae;Nigerium;Nigerium massiliense	27	38	25	31	4	3	8	6	142
Bacteria;Bacteria_none;Firmicutes;Negativicutes;Selenomonadales;Sporomusaceae;Acetonema;Acetonema longum	9	0	66	21	9	33	1	3	142
Bacteria;Bacteria_none;Proteobacteria;Gammaproteobacteria;Xanthomonadales;Rhodanobacteraceae;Dokdonella;Dokdonella koreensis	108	19	6	4	1	1	1	1	141
Bacteria;Bacteria_none;Proteobacteria;Alphaproteobacteria;Hyphomicrobiales;Hyphomicrobiaceae;Pedomicrobium;Pedomicrobium manganicum	43	40	23	28	5	1	1	0	141
Bacteria;Bacteria_none;Proteobacteria;Alphaproteobacteria;Hyphomicrobiales;Beijerinckiaceae;Beijerinckia;Beijerinckia derxii	31	58	15	19	8	7	1	2	141
Bacteria;Bacteria_none;Proteobacteria;Gammaproteobacteria;Methylococcales;Methylococcaceae;Methylovulum;Methylovulum miyakonense	23	25	17	46	12	11	2	4	140
Bacteria;Bacteria_none;Actinobacteria;Actinomycetia;Micrococcales;Intrasporangiaceae;Phycicoccus;Phycicoccus elongatus	61	38	21	12	1	1	4	2	140
Bacteria;Bacteria_none;Actinobacteria;Actinomycetia;Pseudonocardiales;Pseudonocardiaceae;Lentzea;Lentzea kentuckyensis	0	0	139	0	0	0	0	0	139
Bacteria;Bacteria_none;Spirochaetes;Spirochaetia;Spirochaetales;Treponemataceae;Treponema;Treponema zuelzerae	2	89	19	12	2	7	3	5	139
Bacteria;Bacteria_none;Firmicutes;Clostridia;Eubacteriales;Clostridiaceae;Alkaliphilus;Alkaliphilus metalliredigens	10	21	53	5	24	19	3	3	138
Bacteria;Bacteria_none;Proteobacteria;Alphaproteobacteria;Hyphomicrobiales;Rhizobiaceae;Rhizobium;Rhizobium indigoferae	30	31	27	26	4	16	4	0	138
Bacteria;Bacteria_none;Proteobacteria;Alphaproteobacteria;Hyphomicrobiales;Phyllobacteriaceae;Mesorhizobium;Mesorhizobium septentrionale	35	65	9	16	2	5	1	5	138
Bacteria;Bacteria_none;Firmicutes;Clostridia;Eubacteriales;Desulfotomaculaceae;Desulfurispora;Desulfurispora thermophila	7	11	55	11	9	43	0	1	137
Bacteria;Bacteria_none;Planctomycetota;Phycisphaerae;Tepidisphaerales;Tepidisphaeraceae;Tepidisphaera;Tepidisphaera mucosa	28	4	41	16	8	38	1	1	137
Bacteria;Bacteria_none;Firmicutes;Clostridia;Eubacteriales;Clostridiaceae;Crassaminicella;Crassaminicella thermophila	1	12	87	3	19	14	1	0	137
Bacteria;Bacteria_none;Planctomycetota;Planctomycetia;Pirellulales;Thermoguttaceae;Thermogutta;Thermogutta hypogea	3	7	30	76	10	2	5	4	137
Bacteria;Bacteria_none;Proteobacteria;Alphaproteobacteria;Sphingomonadales;Sphingomonadaceae;Chakrabartia;Chakrabartia godavariana	31	59	10	30	3	3	0	1	137
Bacteria;Bacteria_none;Firmicutes;Bacilli;Bacillales;Paenibacillaceae;Paenibacillus;Paenibacillus taohuashanense	1	3	99	8	10	14	1	0	136
Bacteria;Bacteria_none;Firmicutes;Clostridia;Eubacteriales;Oscillospiraceae;Paludicola;Paludicola psychrotolerans	11	13	25	29	10	31	9	8	136
Bacteria;Bacteria_none;Proteobacteria;Betaproteobacteria;Burkholderiales;Comamonadaceae;Acidovorax;Acidovorax lacteus	115	13	2	0	0	0	0	6	136
Bacteria;Bacteria_none;Firmicutes;Bacilli;Lactobacillales;Streptococcaceae;Streptococcus;Streptococcus halotolerans	126	4	2	3	0	0	0	0	135
Bacteria;Bacteria_none;Firmicutes;Clostridia;Eubacteriales;Clostridiaceae;Clostridium;Clostridium amylolyticum	45	2	38	10	13	20	0	7	135
Bacteria;Bacteria_none;Proteobacteria;Alphaproteobacteria;Hyphomicrobiales;Rhizobiaceae;Rhizobium;Rhizobium flavescens	42	32	20	27	4	9	1	0	135
Bacteria;Bacteria_none;Spirochaetes;Spirochaetia;Spirochaetales;Spirochaetaceae;Spirochaeta;Spirochaeta thermophila	17	78	8	23	0	3	1	3	133
Bacteria;Bacteria_none;Proteobacteria;Gammaproteobacteria;Xanthomonadales;Xanthomonadaceae;Arenimonas;Arenimonas subflava	82	15	15	5	10	6	0	0	133
Bacteria;Bacteria_none;Firmicutes;Clostridia;Eubacteriales;Clostridiales Family XVII. Incertae Sedis;Sulfobacillus;Sulfobacillus harzensis	0	0	133	0	0	0	0	0	133
Bacteria;Bacteria_none;Firmicutes;Tissierellia;Tissierellales;Peptoniphilaceae;Miniphocaeibacter;Miniphocaeibacter halophilus	45	49	6	19	3	6	4	0	132
Bacteria;Bacteria_none;Firmicutes;Bacilli;Lactobacillales;Streptococcaceae;Streptococcus;Streptococcus phocae	111	7	8	4	0	0	1	1	132
Bacteria;Bacteria_none;Verrucomicrobia;Verrucomicrobiae;Verrucomicrobiales;Akkermansiaceae;Akkermansia;Akkermansia muciniphila	20	82	29	1	0	0	0	0	132
Bacteria;Bacteria_none;Proteobacteria;Deltaproteobacteria;Desulfovibrionales;Desulfovibrionaceae;Solidesulfovibrio;Solidesulfovibrio fructosivorans	16	98	8	9	0	1	0	0	132
Bacteria;Bacteria_none;Firmicutes;Clostridia;Eubacteriales;Peptostreptococcaceae;Peptostreptococcus;Peptostreptococcus russellii	41	19	44	7	8	5	6	1	131
Bacteria;Bacteria_none;Firmicutes;Clostridia;Eubacteriales;Lachnospiraceae;Roseburia;Roseburia faecis	23	17	19	32	12	12	7	9	131
Bacteria;Bacteria_none;Planctomycetota;Planctomycetia;Planctomycetales;Planctomycetaceae;Gimesia;Gimesia aquarii	30	18	19	39	8	8	7	2	131
Bacteria;Bacteria_none;Proteobacteria;Betaproteobacteria;Burkholderiales;Comamonadaceae;Comamonas;Comamonas odontotermitis	105	8	1	5	1	4	2	5	131
Bacteria;Bacteria_none;Firmicutes;Clostridia;Eubacteriales;Peptococcaceae;Desulfolucianica;Desulfolucianica intricata	3	33	37	21	3	19	4	11	131
Bacteria;Bacteria_none;Verrucomicrobia;Opitutae;Opitutales;Opitutaceae;Opitutus;Opitutus terrae	33	92	1	4	0	0	0	0	130
Bacteria;Bacteria_none;Firmicutes;Clostridia;Eubacteriales;Lachnospiraceae;Jutongia;Jutongia huaianensis	13	8	45	24	9	12	12	7	130
Bacteria;Bacteria_none;Proteobacteria;Alphaproteobacteria;Hyphomicrobiales;Nitrobacteraceae;Bradyrhizobium;Bradyrhizobium nitroreducens	32	57	8	17	3	5	3	5	130
Bacteria;Bacteria_none;Firmicutes;Bacilli;Bacillales;Paenibacillaceae;Paenibacillus;Paenibacillus endophyticus	5	17	79	6	12	7	3	1	130
Bacteria;Bacteria_none;Proteobacteria;Betaproteobacteria;Burkholderiales;Burkholderiaceae;Paraburkholderia;Paraburkholderia polaris	68	28	18	4	5	7	0	0	130
Bacteria;Bacteria_none;Proteobacteria;Betaproteobacteria;Rhodocyclales;Zoogloeaceae;Thauera;Thauera humireducens	8	7	67	1	34	7	3	2	129
Bacteria;Bacteria_none;Proteobacteria;Alphaproteobacteria;Hyphomicrobiales;Rhizobiaceae;Rhizobium;Rhizobium tropici	23	42	20	22	3	7	9	3	129
Bacteria;Bacteria_none;Firmicutes;Clostridia;Eubacteriales;Eubacteriales Family XIII. Incertae Sedis;Emergencia;Emergencia timonensis	3	7	21	48	8	26	7	8	128
Bacteria;Bacteria_none;Proteobacteria;Alphaproteobacteria;Hyphomicrobiales;Pleomorphomonadaceae;Pleomorphomonas;Pleomorphomonas diazotrophica	28	9	26	44	6	8	0	7	128
Bacteria;Bacteria_none;Firmicutes;Clostridia;Eubacteriales;Lachnospiraceae;Blautia;Blautia obeum	84	8	6	11	4	7	1	7	128
Bacteria;Bacteria_none;Proteobacteria;Betaproteobacteria;Burkholderiales;Comamonadaceae;Brachymonas;Brachymonas chironomi	69	14	21	7	6	6	5	0	128
Bacteria;Bacteria_none;Actinobacteria;Actinomycetia;Propionibacteriales;Propionibacteriaceae;Microlunatus;Microlunatus phosphovorus	23	37	32	25	0	3	5	3	128
Bacteria;Bacteria_none;Proteobacteria;Deltaproteobacteria;Syntrophobacterales;Syntrophobacteraceae;Desulfovirga;Desulfovirga adipica	8	97	11	5	5	0	0	1	127
Bacteria;Bacteria_none;Proteobacteria;Alphaproteobacteria;Hyphomicrobiales;Reyranellaceae;Reyranella;Reyranella soli	15	33	20	45	4	3	1	6	127
Bacteria;Bacteria_none;Firmicutes;Bacilli;Bacillales;Bacillaceae;Evansella;Evansella tamaricis	0	8	48	17	4	45	4	1	127
Bacteria;Bacteria_none;Firmicutes;Bacilli;Lactobacillales;Streptococcaceae;Streptococcus;Streptococcus chosunense	104	4	4	6	4	0	2	3	127
Bacteria;Bacteria_none;Proteobacteria;Alphaproteobacteria;Rhodobacterales;Rhodobacteraceae;Paracoccus;Paracoccus salipaludis	18	12	28	54	3	7	3	1	126
Bacteria;Bacteria_none;Proteobacteria;Gammaproteobacteria;Nevskiales;Steroidobacteraceae;Povalibacter;Povalibacter uvarum	84	32	1	6	1	0	0	2	126
Bacteria;Bacteria_none;Bacteroidota;Bacteroidia;Marinilabiliales;Prolixibacteraceae;Mangrovibacterium;Mangrovibacterium diazotrophicum	9	110	5	2	0	0	0	0	126
Bacteria;Bacteria_none;Actinobacteria;Actinomycetia;Corynebacteriales;Mycobacteriaceae;Mycobacterium;Mycobacterium szulgai	0	81	45	0	0	0	0	0	126
Bacteria;Bacteria_none;Firmicutes;Bacilli;Lactobacillales;Streptococcaceae;Streptococcus;Streptococcus macedonicus	91	13	14	6	1	0	1	0	126
Bacteria;Bacteria_none;Firmicutes;Clostridia;Eubacteriales;Syntrophomonadaceae;Syntrophomonas;Syntrophomonas palmitatica	2	17	63	9	9	25	1	0	126
Bacteria;Bacteria_none;Bacteroidota;Bacteroidia;Bacteroidales;Prevotellaceae;Prevotella;Prevotella oryzae	10	0	10	65	0	18	10	12	125
Bacteria;Bacteria_none;Proteobacteria;Gammaproteobacteria;Xanthomonadales;Xanthomonadaceae;Thermomonas;Thermomonas koreensis	46	27	8	25	0	9	5	5	125
Bacteria;Bacteria_none;Actinobacteria;Actinomycetia;Streptosporangiales;Streptosporangiaceae;Thermopolyspora;Thermopolyspora flexuosa	3	13	42	37	3	23	4	0	125
Bacteria;Bacteria_none;Firmicutes;Bacilli;Lactobacillales;Enterococcaceae;Enterococcus;Enterococcus italicus	97	13	3	10	1	0	0	1	125
Bacteria;Bacteria_none;Proteobacteria;Alphaproteobacteria;Hyphomicrobiales;Devosiaceae;Devosia;Devosia insulae	43	23	9	38	7	2	0	3	125
Bacteria;Bacteria_none;Firmicutes;Bacilli;Lactobacillales;Streptococcaceae;Lactococcus;Lactococcus hircilactis	111	4	3	3	3	0	0	0	124
Bacteria;Bacteria_none;Firmicutes;Clostridia;Eubacteriales;Oscillospiraceae;Solibaculum;Solibaculum mannosilyticum	4	15	17	13	15	50	6	4	124
Bacteria;Bacteria_none;Firmicutes;Clostridia;Eubacteriales;Eubacteriaceae;Pseudoramibacter;Pseudoramibacter porci	18	41	22	25	2	9	6	1	124
Bacteria;Bacteria_none;Chloroflexi;Chloroflexia;Chloroflexales;Roseiflexaceae;Roseiflexus;Roseiflexus castenholzii	24	7	7	86	0	0	0	0	124
Bacteria;Bacteria_none;Firmicutes;Clostridia;Eubacteriales;Eubacteriaceae;Acetobacterium;Acetobacterium woodii	33	23	17	10	18	7	15	0	123
Bacteria;Bacteria_none;Firmicutes;Bacilli;Bacillales;Bacillaceae;Fictibacillus;Fictibacillus solisalsi	0	7	45	16	16	35	0	4	123
Bacteria;Bacteria_none;Chloroflexi;Candidatus Thermofonsia;Phototrophicales;Phototrophicaceae;Phototrophicus;Phototrophicus methaneseepsis	2	8	70	21	6	12	4	0	123
Bacteria;Bacteria_none;Firmicutes;Negativicutes;Selenomonadales;Sporomusaceae;Anaerospora;Anaerospora hongkongensis	20	2	31	26	9	20	13	2	123
Bacteria;Bacteria_none;Proteobacteria;Betaproteobacteria;Burkholderiales;Comamonadaceae;Verminephrobacter;Verminephrobacter aporrectodeae	90	13	5	5	2	5	2	1	123
Bacteria;Bacteria_none;Bacteroidota;Cytophagia;Cytophagales;Spirosomaceae;Runella;Runella soli	94	14	10	2	2	0	1	0	123
Bacteria;Bacteria_none;Firmicutes;Bacilli;Lactobacillales;Aerococcaceae;Aerococcus;Aerococcus vaginalis	0	0	100	4	11	7	1	0	123
Bacteria;Bacteria_none;Actinobacteria;Actinomycetia;Propionibacteriales;Propionibacteriaceae;Tessaracoccus;Tessaracoccus defluvii	37	27	21	30	2	2	1	2	122
Bacteria;Bacteria_none;Actinobacteria;Rubrobacteria;Rubrobacterales;Baekduiaceae;Baekduia;Baekduia soli	17	9	11	69	3	4	7	2	122
Bacteria;Bacteria_none;Firmicutes;Bacilli;Bacillales;Bacillaceae;Bacillus;Bacillus aequororis	1	0	96	0	13	11	1	0	122
Bacteria;Bacteria_none;Proteobacteria;Betaproteobacteria;Burkholderiales;Burkholderiales_Incertae_sedis;Aquabacterium;Aquabacterium pictum	90	19	4	1	0	1	5	2	122
Bacteria;Bacteria_none;Proteobacteria;Betaproteobacteria;Burkholderiales;Comamonadaceae;Lampropedia;Lampropedia puyangensis	84	13	10	7	1	2	3	2	122
Bacteria;Bacteria_none;Proteobacteria;Betaproteobacteria;Rhodocyclales;Azonexaceae;Azonexus;Azonexus hydrophilus	57	10	16	15	3	11	4	6	122
Bacteria;Bacteria_none;Bacteroidota;Flavobacteriia;Flavobacteriales;Weeksellaceae;Cloacibacterium;Cloacibacterium normanense	68	18	4	16	0	0	2	14	122
Bacteria;Bacteria_none;Proteobacteria;Gammaproteobacteria;Enterobacterales;Enterobacteriaceae;Franconibacter;Franconibacter daqui	89	3	3	19	2	2	0	4	122
Bacteria;Bacteria_none;Proteobacteria;Deltaproteobacteria;Desulfobacterales;Desulfobacteraceae;Desulfobotulus;Desulfobotulus alkaliphilus	10	35	28	33	5	3	8	0	122
Bacteria;Bacteria_none;Proteobacteria;Epsilonproteobacteria;Campylobacterales;Arcobacteraceae;Arcobacter;Arcobacter aquimarinus	3	64	0	18	0	5	6	25	121
Bacteria;Bacteria_none;Actinobacteria;Actinomycetia;Propionibacteriales;Propionibacteriaceae;Propionibacterium;Propionibacterium westphaliense	11	40	25	27	2	4	3	9	121
Bacteria;Bacteria_none;Firmicutes;Negativicutes;Veillonellales;Veillonellaceae;Dialister;Dialister invisus	76	22	2	11	2	2	3	3	121
Bacteria;Bacteria_none;Actinobacteria;Actinomycetia;Jiangellales;Jiangellaceae;Haloactinopolyspora;Haloactinopolyspora alkaliphila	5	111	2	3	0	0	0	0	121
Bacteria;Bacteria_none;Firmicutes;Clostridia;Eubacteriales;Oscillospiraceae;Oscillospiraceae_Incertae_sedis;[Clostridium] cellulosi	1	8	41	11	13	39	7	1	121
Bacteria;Bacteria_none;Proteobacteria;Alphaproteobacteria;Rhodobacterales;Rhodobacteraceae;Paracoccus;Paracoccus haeundaensis	34	29	15	35	1	4	3	0	121
Bacteria;Bacteria_none;Firmicutes;Bacilli;Bacillales;Planococcaceae;Solibacillus;Solibacillus kalamii	4	17	49	17	8	17	3	5	120
Bacteria;Bacteria_none;Firmicutes;Clostridia;Eubacteriales;Clostridiaceae;Clostridium;Clostridium tyrobutyricum	4	3	47	43	5	1	0	16	119
Bacteria;Bacteria_none;Firmicutes;Bacilli;Lactobacillales;Streptococcaceae;Streptococcus;Streptococcus koreensis	71	8	16	12	6	3	1	2	119
Bacteria;Bacteria_none;Proteobacteria;Gammaproteobacteria;Moraxellales;Moraxellaceae;Acinetobacter;Acinetobacter seohaensis	30	1	23	36	2	24	1	2	119
Bacteria;Bacteria_none;Proteobacteria;Gammaproteobacteria;Xanthomonadales;Rhodanobacteraceae;Dokdonella;Dokdonella ginsengisoli	101	6	0	6	0	3	2	1	119
Bacteria;Bacteria_none;Proteobacteria;Alphaproteobacteria;Hyphomicrobiales;Nitrobacteraceae;Afipia;Afipia carboxidovorans	39	35	39	3	0	3	0	0	119
Bacteria;Bacteria_none;Firmicutes;Bacilli;Lactobacillales;Streptococcaceae;Streptococcus;Streptococcus thermophilus	51	17	13	20	5	7	2	4	119
Bacteria;Bacteria_none;Proteobacteria;Betaproteobacteria;Rhodocyclales;Rhodocyclaceae;Azospira;Azospira oryzae	63	12	12	14	4	6	5	3	119
Bacteria;Bacteria_none;Actinobacteria;Actinomycetia;Bifidobacteriales;Bifidobacteriaceae;Bifidobacterium;Bifidobacterium saguini	1	11	47	40	2	14	2	1	118
Bacteria;Bacteria_none;Proteobacteria;Gammaproteobacteria;Xanthomonadales;Xanthomonadaceae;Pseudoxanthomonas;Pseudoxanthomonas mexicana	40	49	9	7	7	2	2	2	118
Bacteria;Bacteria_none;Proteobacteria;Gammaproteobacteria;Xanthomonadales;Xanthomonadaceae;Pseudoxanthomonas;Pseudoxanthomonas kaohsiungensis	39	17	12	28	7	11	3	1	118
Bacteria;Bacteria_none;Proteobacteria;Gammaproteobacteria;Moraxellales;Moraxellaceae;Acinetobacter;Acinetobacter oryzae	73	10	2	24	2	3	0	4	118
Bacteria;Bacteria_none;Actinobacteria;Actinomycetia;Propionibacteriales;Propionibacteriaceae;Acidipropionibacterium;Acidipropionibacterium microaerophilum	13	27	14	42	2	5	12	3	118
Bacteria;Bacteria_none;Synergistetes;Synergistia;Synergistales;Synergistaceae;Thermanaerovibrio;Thermanaerovibrio acidaminovorans	1	25	21	53	0	1	13	4	118
Bacteria;Bacteria_none;Proteobacteria;Alphaproteobacteria;Caulobacterales;Caulobacteraceae;Phenylobacterium;Phenylobacterium koreense	19	40	13	35	4	3	2	2	118
Bacteria;Bacteria_none;Firmicutes;Clostridia;Eubacteriales;Clostridiaceae;Clostridium;Clostridium tunisiense	8	7	8	71	0	16	4	4	118
Bacteria;Bacteria_none;Bacteroidota;Bacteroidia;Bacteroidales;Dysgonomonadaceae;Dysgonomonas;Dysgonomonas oryzarvi	12	76	0	24	0	6	0	0	118
Bacteria;Bacteria_none;Proteobacteria;Gammaproteobacteria;Enterobacterales;Enterobacteriaceae;Scandinavium;Scandinavium goeteborgense	93	4	7	11	0	1	1	0	117
Bacteria;Bacteria_none;Firmicutes;Clostridia;Eubacteriales;Oscillospiraceae;Ruminococcus;Ruminococcus bovis	32	27	16	9	9	18	3	3	117
Bacteria;Bacteria_none;Planctomycetota;Planctomycetia;Pirellulales;Pirellulaceae;Mariniblastus;Mariniblastus fucicola	32	18	15	41	3	3	5	0	117
Bacteria;Bacteria_none;Firmicutes;Bacilli;Lactobacillales;Streptococcaceae;Floricoccus;Floricoccus penangensis	105	6	0	2	0	0	0	4	117
Bacteria;Bacteria_none;Proteobacteria;Alphaproteobacteria;Hyphomicrobiales;Nitrobacteraceae;Afipia;Afipia felis	28	45	32	12	0	0	0	0	117
Bacteria;Bacteria_none;Firmicutes;Clostridia;Eubacteriales;Clostridiaceae;Clostridium;Clostridium algifaecis	10	17	37	26	10	10	3	3	116
Bacteria;Bacteria_none;Proteobacteria;Alphaproteobacteria;Rhodobacterales;Rhodobacteraceae;Rhodobacter;Rhodobacter flagellatus	38	25	26	15	1	6	4	1	116
Bacteria;Bacteria_none;Proteobacteria;Alphaproteobacteria;Rhodobacterales;Rhodobacteraceae;Pikeienuella;Pikeienuella piscinae	26	29	13	31	4	7	4	2	116
Bacteria;Bacteria_none;Firmicutes;Bacilli;Bacillales;Paenibacillaceae;Brevibacillus;Brevibacillus brevis	0	0	73	16	21	0	0	6	116
Bacteria;Bacteria_none;Firmicutes;Negativicutes;Selenomonadales;Sporomusaceae;Pelosinus;Pelosinus fermentans	23	7	36	27	1	15	6	0	115
Bacteria;Bacteria_none;Verrucomicrobia;Verrucomicrobiae;Verrucomicrobiales;Verrucomicrobiaceae;Luteolibacter;Luteolibacter luteus	8	106	0	0	0	0	0	0	114
Bacteria;Bacteria_none;Bacteroidota;Bacteroidia;Bacteroidales;Prevotellaceae;Prevotella;Prevotella pallens	0	0	13	79	0	7	11	4	114
Bacteria;Bacteria_none;Firmicutes;Clostridia;Eubacteriales;Eubacteriales Family XIII. Incertae Sedis;Alterileibacterium;Alterileibacterium massiliense	15	11	25	24	15	17	4	3	114
Bacteria;Bacteria_none;Firmicutes;Clostridia;Eubacteriales;Lachnospiraceae;Marvinbryantia;Marvinbryantia formatexigens	38	13	21	19	4	10	4	5	114
Bacteria;Bacteria_none;Proteobacteria;Alphaproteobacteria;Rhodobacterales;Rhodobacteraceae;Paracoccus;Paracoccus aminovorans	20	12	19	45	4	10	2	2	114
Bacteria;Bacteria_none;Cyanobacteria;Cyanobacteria_Incertae_sedis;Oscillatoriales;Sirenicapillariaceae;Limnospira;Limnospira fusiformis	14	30	34	35	0	0	0	0	113
Bacteria;Bacteria_none;Firmicutes;Clostridia;Eubacteriales;Oscillospiraceae;Faecalibacterium;Faecalibacterium longum	56	16	11	13	1	8	5	3	113
Bacteria;Bacteria_none;Bacteroidota;Bacteroidia;Bacteroidales;Prevotellaceae;Prevotella;Prevotella multisaccharivorax	0	1	1	30	2	9	5	65	113
Bacteria;Bacteria_none;Firmicutes;Clostridia;Eubacteriales;Lachnospiraceae;Blautia;Blautia brookingsii	96	9	0	2	0	2	2	2	113
Bacteria;Bacteria_none;Proteobacteria;Betaproteobacteria;Burkholderiales;Burkholderiaceae;Paraburkholderia;Paraburkholderia acidisoli	80	13	11	1	2	4	1	1	113
Bacteria;Bacteria_none;Proteobacteria;Gammaproteobacteria;Pasteurellales;Pasteurellaceae;Haemophilus;Haemophilus pittmaniae	112	0	0	0	0	0	0	0	112
Bacteria;Bacteria_none;Proteobacteria;Alphaproteobacteria;Hyphomicrobiales;Rhizobiaceae;Pararhizobium;Pararhizobium arenae	27	9	25	38	2	9	1	1	112
Bacteria;Bacteria_none;Actinobacteria;Actinomycetia;Micrococcales;Microbacteriaceae;Clavibacter;Clavibacter michiganensis	13	12	18	49	4	5	10	1	112
Bacteria;Bacteria_none;Proteobacteria;Betaproteobacteria;Burkholderiales;Burkholderiaceae;Burkholderia;Burkholderia cepacia	59	18	9	14	6	0	5	1	112
Bacteria;Bacteria_none;Firmicutes;Clostridia;Eubacteriales;Clostridiaceae;Clostridium;Clostridium colicanis	25	43	11	16	2	4	5	6	112
Bacteria;Bacteria_none;Actinobacteria;Acidimicrobiia;Acidimicrobiales;Iamiaceae;Rhabdothermincola;Rhabdothermincola sediminis	23	49	10	15	3	7	2	2	111
Bacteria;Bacteria_none;Firmicutes;Bacilli;Lactobacillales;Streptococcaceae;Streptococcus;Streptococcus gallolyticus	91	6	2	5	0	1	4	2	111
Bacteria;Bacteria_none;Actinobacteria;Actinomycetia;Micrococcales;Dermatophilaceae;Kineosphaera;Kineosphaera nakaumiensis	35	29	18	18	7	0	3	1	111
Bacteria;Bacteria_none;Firmicutes;Clostridia;Eubacteriales;Lachnospiraceae;Lachnospira;Lachnospira eligens	47	23	14	12	4	5	3	3	111
Bacteria;Bacteria_none;Firmicutes;Clostridia;Eubacteriales;Eubacteriales_Incertae_sedis;Gemmiger;Gemmiger formicilis	86	6	5	8	2	1	0	3	111
Bacteria;Bacteria_none;Proteobacteria;Betaproteobacteria;Burkholderiales;Burkholderiales_Incertae_sedis;Aquabacterium;Aquabacterium limnoticum	68	21	2	12	2	4	1	0	110
Bacteria;Bacteria_none;Bacteroidota;Bacteroidia;Bacteroidales;Bacteroidaceae;Phocaeicola;Phocaeicola paurosaccharolyticus	6	92	1	8	1	1	1	0	110
Bacteria;Bacteria_none;Proteobacteria;Alphaproteobacteria;Hyphomicrobiales;Nitrobacteraceae;Variibacter;Variibacter gotjawalensis	47	22	16	13	1	8	1	2	110
Bacteria;Bacteria_none;Firmicutes;Clostridia;Eubacteriales;Oscillospiraceae;Anaerofilum;Anaerofilum agile	55	20	6	8	5	13	0	3	110
Bacteria;Bacteria_none;Proteobacteria;Alphaproteobacteria;Hyphomicrobiales;Pleomorphomonadaceae;Pleomorphomonas;Pleomorphomonas oryzae	33	14	25	29	1	7	0	1	110
Bacteria;Bacteria_none;Bacteroidota;Flavobacteriia;Flavobacteriales;Weeksellaceae;Cloacibacterium;Cloacibacterium rupense	73	12	0	8	0	6	4	7	110
Bacteria;Bacteria_none;Bacteroidota;Flavobacteriia;Flavobacteriales;Flavobacteriaceae;Flavobacterium;Flavobacterium limi	0	15	26	31	10	10	5	13	110
Bacteria;Bacteria_none;Proteobacteria;Betaproteobacteria;Burkholderiales;Comamonadaceae;Simplicispira;Simplicispira metamorpha	74	11	0	3	3	17	1	1	110
Bacteria;Bacteria_none;Proteobacteria;Alphaproteobacteria;Hyphomicrobiales;Hyphomicrobiaceae;Rhodoplanes;Rhodoplanes serenus	29	23	20	18	4	12	4	0	110
Bacteria;Bacteria_none;Proteobacteria;Betaproteobacteria;Rhodocyclales;Rhodocyclaceae;Propionivibrio;Propionivibrio dicarboxylicus	55	12	10	14	7	5	3	3	109
Bacteria;Bacteria_none;Firmicutes;Bacilli;Bacillales;Staphylococcaceae;Staphylococcus;Staphylococcus aureus	0	0	84	0	7	18	0	0	109
Bacteria;Bacteria_none;Proteobacteria;Gammaproteobacteria;Pasteurellales;Pasteurellaceae;Testudinibacter;Testudinibacter aquarius	80	3	15	5	4	1	0	1	109
Bacteria;Bacteria_none;Planctomycetota;Phycisphaerae;Phycisphaerales;Phycisphaeraceae;Mucisphaera;Mucisphaera calidilacus	3	1	26	44	6	15	11	3	109
Bacteria;Bacteria_none;Actinobacteria;Acidimicrobiia;Acidimicrobiales;Iamiaceae;Iamia;Iamia majanohamensis	19	60	12	8	2	3	1	4	109
Bacteria;Bacteria_none;Actinobacteria;Actinomycetia;Micrococcales;Dermabacteraceae;Brachybacterium;Brachybacterium endophyticum	6	8	19	60	2	3	8	3	109
Bacteria;Bacteria_none;Actinobacteria;Acidimicrobiia;Acidimicrobiales;Acidimicrobiaceae;Ferrithrix;Ferrithrix thermotolerans	13	33	20	34	2	3	2	2	109
Bacteria;Bacteria_none;Proteobacteria;Alphaproteobacteria;Rhodobacterales;Rhodobacteraceae;Paracoccus;Paracoccus baruchii	30	31	17	23	2	3	2	1	109
Bacteria;Bacteria_none;Planctomycetota;Planctomycetia;Pirellulales;Lacipirellulaceae;Lacipirellula;Lacipirellula limnantheis	15	10	27	31	9	3	8	5	108
Bacteria;Bacteria_none;Proteobacteria;Betaproteobacteria;Burkholderiales;Comamonadaceae;Rhodoferax;Rhodoferax ferrireducens	55	11	16	5	4	8	2	7	108
Bacteria;Bacteria_none;Bacteroidota;Bacteroidia;Bacteroidales;Tannerellaceae;Parabacteroides;Parabacteroides johnsonii	0	0	11	40	2	37	13	4	107
Bacteria;Bacteria_none;Proteobacteria;Alphaproteobacteria;Hyphomicrobiales;Hyphomicrobiaceae;Hyphomicrobium;Hyphomicrobium sulfonivorans	19	26	17	37	2	2	4	0	107
Bacteria;Bacteria_none;Actinobacteria;Actinomycetia;Propionibacteriales;Nocardioidaceae;Tenggerimyces;Tenggerimyces mesophilus	0	2	75	0	30	0	0	0	107
Bacteria;Bacteria_none;Bacteroidota;Bacteroidia;Marinilabiliales;Marinilabiliaceae;Breznakibacter;Breznakibacter xylanolyticus	10	17	42	8	14	14	0	2	107
Bacteria;Bacteria_none;Proteobacteria;Gammaproteobacteria;Moraxellales;Moraxellaceae;Acinetobacter;Acinetobacter bouvetii	75	4	3	21	1	0	1	2	107
Bacteria;Bacteria_none;Firmicutes;Bacilli;Bacillales;Bacillaceae;Geobacillus;Geobacillus thermoleovorans	4	8	57	12	5	21	0	0	107
Bacteria;Bacteria_none;Actinobacteria;Actinomycetia;Micrococcales;Intrasporangiaceae;Intrasporangium;Intrasporangium chromatireducens	7	28	20	43	3	3	2	0	106
Bacteria;Bacteria_none;Firmicutes;Clostridia;Eubacteriales;Lachnospiraceae;Cellulosilyticum;Cellulosilyticum lentocellum	11	14	46	14	10	5	2	4	106
Bacteria;Bacteria_none;Proteobacteria;Gammaproteobacteria;Chromatiales;Chromatiaceae;Allochromatium;Allochromatium phaeobacterium	91	15	0	0	0	0	0	0	106
Bacteria;Bacteria_none;Firmicutes;Clostridia;Eubacteriales;Oscillospiraceae;Acetivibrio;Acetivibrio aldrichii	4	28	41	6	7	17	0	3	106
Bacteria;Bacteria_none;Firmicutes;Clostridia;Eubacteriales;Oscillospiraceae;Oscillospiraceae_Incertae_sedis;[Clostridium] methylpentosum	3	18	12	3	68	1	1	0	106
Bacteria;Bacteria_none;Firmicutes;Clostridia;Eubacteriales;Lachnospiraceae;Anaerotignum;Anaerotignum neopropionicum	7	18	51	7	8	12	1	2	106
Bacteria;Bacteria_none;Proteobacteria;Alphaproteobacteria;Hyphomicrobiales;Phyllobacteriaceae;Hoeflea;Hoeflea olei	32	36	13	13	6	5	1	0	106
Bacteria;Bacteria_none;Proteobacteria;Deltaproteobacteria;Desulfobacterales;Desulfobacteraceae;Desulfatibacillum;Desulfatibacillum alkenivorans	6	13	21	50	1	2	8	5	106
Bacteria;Bacteria_none;Bacteroidota;Flavobacteriia;Flavobacteriales;Weeksellaceae;Weeksella;Weeksella virosa	4	33	22	25	2	0	0	20	106
Bacteria;Bacteria_none;Proteobacteria;Gammaproteobacteria;Aeromonadales;Aeromonadaceae;Tolumonas;Tolumonas auensis	15	4	14	36	1	11	3	21	105
Bacteria;Bacteria_none;Firmicutes;Clostridia;Eubacteriales;Lachnospiraceae;Blautia;Blautia faecis	59	2	9	21	1	3	3	7	105
Bacteria;Bacteria_none;Firmicutes;Clostridia;Eubacteriales;Oscillospiraceae;Pygmaiobacter;Pygmaiobacter massiliensis	36	16	20	13	4	8	5	3	105
Bacteria;Bacteria_none;Firmicutes;Clostridia;Eubacteriales;Clostridiaceae;Clostridium;Clostridium bovifaecis	7	6	12	61	7	5	3	4	105
Bacteria;Bacteria_none;Actinobacteria;Actinomycetia;Corynebacteriales;Tsukamurellaceae;Tsukamurella;Tsukamurella paurometabola	1	3	57	18	5	15	3	3	105
Bacteria;Bacteria_none;Proteobacteria;Alphaproteobacteria;Hyphomicrobiales;Phyllobacteriaceae;Mesorhizobium;Mesorhizobium shonense	46	38	20	0	0	0	0	0	104
Bacteria;Bacteria_none;Proteobacteria;Alphaproteobacteria;Rhodobacterales;Rhodobacteraceae;Gemmobacter;Gemmobacter aquaticus	27	22	22	18	4	7	3	1	104
Bacteria;Bacteria_none;Proteobacteria;Alphaproteobacteria;Rhodobacterales;Rhodobacteraceae;Neotabrizicola;Neotabrizicola shimadae	39	37	12	10	1	3	2	0	104
Bacteria;Bacteria_none;Verrucomicrobia;Verrucomicrobiae;Verrucomicrobiales;Verrucomicrobiaceae;Prosthecobacter;Prosthecobacter fusiformis	99	0	0	5	0	0	0	0	104
Bacteria;Bacteria_none;Actinobacteria;Actinomycetia;Corynebacteriales;Corynebacteriaceae;Corynebacterium;Corynebacterium mycetoides	5	23	30	33	4	5	4	0	104
Bacteria;Bacteria_none;Proteobacteria;Gammaproteobacteria;Alteromonadales;Pseudoalteromonadaceae;Pseudoalteromonas;Pseudoalteromonas agarivorans	13	64	10	12	4	0	0	1	104
Bacteria;Bacteria_none;Proteobacteria;Gammaproteobacteria;Chromatiales;Chromatiaceae;Thiocystis;Thiocystis minor	91	10	2	1	0	0	0	0	104
Bacteria;Bacteria_none;Firmicutes;Clostridia;Eubacteriales;Lachnospiraceae;Blautia;Blautia glucerasea	42	15	30	4	4	5	3	0	103
Bacteria;Bacteria_none;Chloroflexi;Anaerolineae;Anaerolineales;Anaerolineaceae;Longilinea;Longilinea arvoryzae	2	26	43	9	12	5	3	3	103
Bacteria;Bacteria_none;Firmicutes;Bacilli;Lactobacillales;Lactobacillaceae;Weissella;Weissella koreensis	11	23	29	24	2	5	3	6	103
Bacteria;Bacteria_none;Firmicutes;Clostridia;Eubacteriales;Lachnospiraceae;Butyrivibrio;Butyrivibrio crossotus	36	8	22	15	3	10	4	5	103
Bacteria;Bacteria_none;Proteobacteria;Gammaproteobacteria;Xanthomonadales;Rhodanobacteraceae;Dyella;Dyella dinghuensis	8	31	19	31	2	1	4	7	103
Bacteria;Bacteria_none;Actinobacteria;Actinomycetia;Propionibacteriales;Nocardioidaceae;Nocardioides;Nocardioides islandensis	12	16	27	18	6	14	5	5	103
Bacteria;Bacteria_none;Firmicutes;Bacilli;Bacillales;Paenibacillaceae;Cohnella;Cohnella thailandensis	2	6	73	3	9	8	1	1	103
Bacteria;Bacteria_none;Bacteroidota;Bacteroidia;Bacteroidales;Dysgonomonadaceae;Dysgonomonas;Dysgonomonas capnocytophagoides	4	22	24	36	0	10	3	4	103
Bacteria;Bacteria_none;Proteobacteria;Gammaproteobacteria;Legionellales;Coxiellaceae;Rickettsiella;Rickettsiella massiliensis	17	15	19	32	4	13	1	2	103
Bacteria;Bacteria_none;Proteobacteria;Betaproteobacteria;Rhodocyclales;Azonexaceae;Quatrionicoccus;Quatrionicoccus australiensis	19	51	13	15	1	0	2	1	102
Bacteria;Bacteria_none;Firmicutes;Negativicutes;Selenomonadales;Selenomonadaceae;Selenomonas;Selenomonas felix	12	0	45	12	11	12	3	7	102
Bacteria;Bacteria_none;Proteobacteria;Alphaproteobacteria;Hyphomicrobiales;Phyllobacteriaceae;Phyllobacterium;Phyllobacterium zundukense	13	20	13	37	4	6	8	1	102
Bacteria;Bacteria_none;Proteobacteria;Alphaproteobacteria;Rhodospirillales;Acetobacteraceae;Swaminathania;Swaminathania salitolerans	17	27	12	29	1	3	6	7	102
Bacteria;Bacteria_none;Proteobacteria;Gammaproteobacteria;Enterobacterales;Erwiniaceae;Pantoea;Pantoea ananatis	12	45	14	19	1	4	0	7	102
Bacteria;Bacteria_none;Proteobacteria;Alphaproteobacteria;Hyphomicrobiales;Phyllobacteriaceae;Mesorhizobium;Mesorhizobium mediterraneum	24	25	17	36	0	0	0	0	102
Bacteria;Bacteria_none;Proteobacteria;Alphaproteobacteria;Rhodospirillales;Geminicoccaceae;Geminicoccus;Geminicoccus roseus	35	39	16	7	2	0	1	2	102
Bacteria;Bacteria_none;Proteobacteria;Betaproteobacteria;Burkholderiales;Comamonadaceae;Ramlibacter;Ramlibacter tataouinensis	51	25	13	5	5	2	1	0	102
Bacteria;Bacteria_none;Firmicutes;Clostridia;Eubacteriales;Christensenellaceae;Christensenella;Christensenella intestinihominis	0	7	64	5	6	19	0	0	101
Bacteria;Bacteria_none;Proteobacteria;Betaproteobacteria;Burkholderiales;Comamonadaceae;Hydrogenophaga;Hydrogenophaga flava	38	21	14	13	4	4	3	4	101
Bacteria;Bacteria_none;Firmicutes;Bacilli;Bacillales;Paenibacillaceae;Paenibacillus;Paenibacillus jamilae	4	6	54	7	8	18	2	2	101
Bacteria;Bacteria_none;Actinobacteria;Actinomycetia;Propionibacteriales;Propionibacteriaceae;Mariniluteicoccus;Mariniluteicoccus flavus	14	25	24	25	0	7	3	3	101
Bacteria;Bacteria_none;Proteobacteria;Gammaproteobacteria;Thiotrichales;Thiotrichaceae;Thiothrix;Thiothrix unzii	94	2	0	4	0	0	0	0	100
Bacteria;Bacteria_none;Actinobacteria;Actinomycetia;Micrococcales;Microbacteriaceae;Gulosibacter;Gulosibacter chungangensis	10	14	21	36	2	7	5	5	100
Bacteria;Bacteria_none;Firmicutes;Clostridia;Eubacteriales;Clostridiaceae;Butyricicoccus;Butyricicoccus pullicaecorum	17	3	48	8	15	5	1	3	100
Bacteria;Bacteria_none;Proteobacteria;Alphaproteobacteria;Rhodobacterales;Rhodobacteraceae;Paracoccus;Paracoccus sulfuroxidans	37	18	6	24	4	6	2	3	100
Bacteria;Bacteria_none;Proteobacteria;Deltaproteobacteria;Desulfobacterales;Desulfobacteraceae;Desulfatirhabdium;Desulfatirhabdium butyrativorans	36	26	18	14	2	3	0	0	99
Bacteria;Bacteria_none;Firmicutes;Bacilli;Lactobacillales;Streptococcaceae;Streptococcus;Streptococcus equi	55	9	13	14	2	3	1	2	99
Bacteria;Bacteria_none;Firmicutes;Clostridia;Eubacteriales;Clostridiales Family XVII. Incertae Sedis;Thermaerobacter;Thermaerobacter litoralis	5	25	48	5	7	8	1	0	99
Bacteria;Bacteria_none;Proteobacteria;Gammaproteobacteria;Pseudomonadales;Pseudomonadaceae;Pseudomonas;Pseudomonas bijieensis	22	17	18	26	4	7	2	3	99
Bacteria;Bacteria_none;Firmicutes;Bacilli;Bacillales;Paenibacillaceae;Paenibacillus;Paenibacillus nicotianae	0	0	81	0	10	8	0	0	99
Bacteria;Bacteria_none;Proteobacteria;Betaproteobacteria;Burkholderiales;Comamonadaceae;Acidovorax;Acidovorax citrulli	69	18	0	0	3	7	0	2	99
Bacteria;Bacteria_none;Proteobacteria;Epsilonproteobacteria;Campylobacterales;Arcobacteraceae;Arcobacter;Arcobacter suis	8	25	20	16	0	3	6	20	98
Bacteria;Bacteria_none;Proteobacteria;Alphaproteobacteria;Rhodobacterales;Rhodobacteraceae;Pseudorhodobacter;Pseudorhodobacter ferrugineus	25	15	17	22	5	9	3	2	98
Bacteria;Bacteria_none;Proteobacteria;Alphaproteobacteria;Sphingomonadales;Sphingomonadaceae;Novosphingobium;Novosphingobium arabidopsis	53	22	4	14	0	1	1	3	98
Bacteria;Bacteria_none;Firmicutes;Bacilli;Bacillales;Bacillaceae;Priestia;Priestia paraflexa	6	7	58	3	6	11	2	5	98
Bacteria;Bacteria_none;Proteobacteria;Gammaproteobacteria;Xanthomonadales;Xanthomonadaceae;Stenotrophomonas;Stenotrophomonas acidaminiphila	50	15	11	15	0	4	2	1	98
Bacteria;Bacteria_none;Firmicutes;Clostridia;Eubacteriales;Peptococcaceae;Desulfocucumis;Desulfocucumis palustris	4	11	44	12	4	17	4	2	98
Bacteria;Bacteria_none;Proteobacteria;Betaproteobacteria;Burkholderiales;Sphaerotilaceae;Sphaerotilus;Sphaerotilus sulfidivorans	88	8	0	0	1	0	0	0	97
Bacteria;Bacteria_none;Proteobacteria;Betaproteobacteria;Burkholderiales;Comamonadaceae;Comamonas;Comamonas guangdongensis	55	18	7	5	8	3	1	0	97
Bacteria;Bacteria_none;Firmicutes;Clostridia;Eubacteriales;Oscillospiraceae;Ruminiclostridium;Ruminiclostridium sufflavum	1	13	45	15	0	9	0	14	97
Bacteria;Bacteria_none;Proteobacteria;Gammaproteobacteria;Enterobacterales;Enterobacteriaceae;Klebsiella;Klebsiella quasipneumoniae	29	24	11	23	3	1	2	4	97
Bacteria;Bacteria_none;Proteobacteria;Gammaproteobacteria;Legionellales;Coxiellaceae;Aquicella;Aquicella lusitana	26	32	14	15	2	5	2	0	96
Bacteria;Bacteria_none;Proteobacteria;Alphaproteobacteria;Rhodobacterales;Roseobacteraceae;Rubellimicrobium;Rubellimicrobium thermophilum	19	71	1	2	0	1	0	2	96
Bacteria;Bacteria_none;Firmicutes;Bacilli;Lactobacillales;Streptococcaceae;Streptococcus;Streptococcus infantarius	82	8	2	2	0	0	2	0	96
Bacteria;Bacteria_none;Firmicutes;Clostridia;Eubacteriales;Peptostreptococcaceae;Peptacetobacter;Peptacetobacter hiranonis	10	14	30	22	4	7	4	5	96
Bacteria;Bacteria_none;Firmicutes;Clostridia;Eubacteriales;Lachnospiraceae;Herbinix;Herbinix luporum	24	13	17	12	2	22	5	1	96
Bacteria;Bacteria_none;Firmicutes;Bacilli;Lactobacillales;Streptococcaceae;Streptococcus;Streptococcus australis	80	9	3	3	0	1	0	0	96
Bacteria;Bacteria_none;Proteobacteria;Betaproteobacteria;Burkholderiales;Comamonadaceae;Simplicispira;Simplicispira soli	54	20	8	4	5	3	1	1	96
Bacteria;Bacteria_none;Proteobacteria;Betaproteobacteria;Burkholderiales;Comamonadaceae;Comamonas;Comamonas sediminis	50	18	5	5	1	16	0	1	96
Bacteria;Bacteria_none;Proteobacteria;Deltaproteobacteria;Desulfovibrionales;Desulfovibrionaceae;Solidesulfovibrio;Solidesulfovibrio marrakechensis	8	61	18	1	6	1	0	0	95
Bacteria;Bacteria_none;Firmicutes;Bacilli;Lactobacillales;Carnobacteriaceae;Trichococcus;Trichococcus pasteurii	75	10	0	7	1	0	1	1	95
Bacteria;Bacteria_none;Proteobacteria;Gammaproteobacteria;Xanthomonadales;Xanthomonadaceae;Pseudoxanthomonas;Pseudoxanthomonas japonensis	53	13	7	13	1	3	2	3	95
Bacteria;Bacteria_none;Tenericutes;Mollicutes;Mycoplasmatales;Mycoplasmataceae;Mycoplasmopsis;Mycoplasmopsis pullorum	10	62	5	8	1	8	1	0	95
Bacteria;Bacteria_none;Firmicutes;Clostridia;Eubacteriales;Eubacteriaceae;Eubacterium;Eubacterium pyruvativorans	3	5	25	13	10	33	4	2	95
Bacteria;Bacteria_none;Firmicutes;Negativicutes;Veillonellales;Veillonellaceae;Veillonella;Veillonella criceti	72	19	1	2	0	1	0	0	95
Bacteria;Bacteria_none;Proteobacteria;Betaproteobacteria;Burkholderiales;Sutterellaceae;Turicimonas;Turicimonas muris	3	1	0	51	0	18	18	4	95
Bacteria;Bacteria_none;Firmicutes;Clostridia;Eubacteriales;Lachnospiraceae;Oliverpabstia;Oliverpabstia intestinalis	55	0	16	0	7	15	2	0	95
Bacteria;Bacteria_none;Firmicutes;Clostridia;Eubacteriales;Peptococcaceae;Peptococcus;Peptococcus niger	20	2	36	16	7	10	2	2	95
Bacteria;Bacteria_none;Firmicutes;Clostridia;Eubacteriales;Lachnospiraceae;Blautia;Blautia hydrogenotrophica	11	50	16	9	2	3	2	2	95
Bacteria;Bacteria_none;Proteobacteria;Betaproteobacteria;Burkholderiales;Sphaerotilaceae;Azohydromonas;Azohydromonas lata	65	16	8	0	4	0	1	0	94
Bacteria;Bacteria_none;Proteobacteria;Betaproteobacteria;Burkholderiales;Comamonadaceae;Verminephrobacter;Verminephrobacter eiseniae	55	17	2	9	2	6	0	3	94
Bacteria;Bacteria_none;Proteobacteria;Betaproteobacteria;Burkholderiales;Comamonadaceae;Ramlibacter;Ramlibacter algicola	78	14	1	0	0	0	0	1	94
Bacteria;Bacteria_none;Firmicutes;Bacilli;Lactobacillales;Enterococcaceae;Enterococcus;Enterococcus saccharolyticus	90	0	2	2	0	0	0	0	94
Bacteria;Bacteria_none;Proteobacteria;Gammaproteobacteria;Enterobacterales;Enterobacteriaceae;Cedecea;Cedecea lapagei	74	4	3	11	0	0	2	0	94
Bacteria;Bacteria_none;Firmicutes;Negativicutes;Veillonellales;Veillonellaceae;Megasphaera;'Megasphaera vaginalis' Bordigoni et al. 2020	20	2	21	14	7	11	11	8	94
Bacteria;Bacteria_none;Firmicutes;Clostridia;Eubacteriales;Clostridiaceae;Fervidicella;Fervidicella metallireducens	0	6	33	20	11	9	2	12	93
Bacteria;Bacteria_none;Proteobacteria;Deltaproteobacteria;Myxococcales;Nannocystaceae;Nannocystis;Nannocystis konarekensis	68	0	0	18	0	0	2	5	93
Bacteria;Bacteria_none;Proteobacteria;Alphaproteobacteria;Hyphomicrobiales;Kaistiaceae;Bauldia;Bauldia litoralis	12	17	11	36	6	5	2	4	93
Bacteria;Bacteria_none;Firmicutes;Clostridia;Eubacteriales;Lachnospiraceae;Stomatobaculum;Stomatobaculum longum	3	2	41	34	4	5	2	2	93
Bacteria;Bacteria_none;Firmicutes;Negativicutes;Veillonellales;Veillonellaceae;Dialister;Dialister massiliensis	35	0	6	30	2	0	10	10	93
Bacteria;Bacteria_none;Proteobacteria;Gammaproteobacteria;Enterobacterales;Enterobacteriaceae;Buttiauxella;Buttiauxella ferragutiae	79	3	1	4	0	0	1	5	93
Bacteria;Bacteria_none;Firmicutes;Clostridia;Eubacteriales;Lachnospiraceae;Anaerocolumna;Anaerocolumna aminovalerica	27	16	14	14	3	7	4	8	93
Bacteria;Bacteria_none;Proteobacteria;Alphaproteobacteria;Rhodobacterales;Rhodobacteraceae;Pseudorhodobacter;Pseudorhodobacter antarcticus	18	22	18	26	1	5	3	0	93
Bacteria;Bacteria_none;Bacteroidota;Bacteroidia;Marinilabiliales;Prolixibacteraceae;Tangfeifania;Tangfeifania diversioriginum	5	76	3	5	1	2	0	0	92
Bacteria;Bacteria_none;Firmicutes;Bacilli;Lactobacillales;Streptococcaceae;Streptococcus;Streptococcus catagoni	72	4	0	7	2	0	4	3	92
Bacteria;Bacteria_none;Proteobacteria;Betaproteobacteria;Burkholderiales;Comamonadaceae;Hydrogenophaga;Hydrogenophaga carboriunda	64	11	8	6	1	1	1	0	92
Bacteria;Bacteria_none;Firmicutes;Clostridia;Eubacteriales;Lachnospiraceae;Lachnoclostridium;[Clostridium] scindens	18	3	31	17	5	8	6	4	92
Bacteria;Bacteria_none;Firmicutes;Clostridia;Eubacteriales;Eubacteriales_Incertae_sedis;Evtepia;Evtepia gabavorous	8	4	57	5	3	13	1	1	92
Bacteria;Bacteria_none;Actinobacteria;Actinomycetia;Micrococcales;Micrococcaceae;Rothia;Rothia aerolata	16	73	0	0	0	3	0	0	92
Bacteria;Bacteria_none;Firmicutes;Clostridia;Eubacteriales;Clostridiales Family XVII. Incertae Sedis;Sulfobacillus;Sulfobacillus acidophilus	0	5	41	8	0	38	0	0	92
Bacteria;Bacteria_none;Firmicutes;Bacilli;Lactobacillales;Lactobacillaceae;Leuconostoc;Leuconostoc lactis	57	2	0	25	5	0	3	0	92
Bacteria;Bacteria_none;Firmicutes;Clostridia;Eubacteriales;Oscillospiraceae;Pusillibacter;Pusillibacter faecalis	1	3	34	11	18	18	4	2	91
Bacteria;Bacteria_none;Firmicutes;Negativicutes;Selenomonadales;Sporomusaceae;Sporomusa;Sporomusa silvacetica	55	14	14	0	0	7	0	1	91
Bacteria;Bacteria_none;Firmicutes;Clostridia;Eubacteriales;Clostridiaceae;Hungatella;Hungatella xylanolytica	14	0	26	18	13	8	6	6	91
Bacteria;Bacteria_none;Firmicutes;Bacilli;Bacillales;Thermoactinomycetaceae;Novibacillus;Novibacillus thermophilus	2	80	8	0	0	0	0	0	90
Bacteria;Bacteria_none;Firmicutes;Clostridia;Eubacteriales;Clostridiaceae;Clostridium;Clostridium frigidicarnis	8	15	18	26	6	9	8	0	90
Bacteria;Bacteria_none;Firmicutes;Clostridia;Eubacteriales;Oscillospiraceae;Subdoligranulum;Subdoligranulum variabile	68	7	1	6	3	2	1	2	90
Bacteria;Bacteria_none;Acidobacteria;Holophagae;Holophagales;Holophagaceae;Holophaga;Holophaga foetida	20	68	0	2	0	0	0	0	90
Bacteria;Bacteria_none;Proteobacteria;Alphaproteobacteria;Sphingomonadales;Sphingomonadaceae;Sphingobium;Sphingobium fluviale	26	35	10	15	1	0	2	1	90
Bacteria;Bacteria_none;Actinobacteria;Actinomycetia;Micrococcales;Microbacteriaceae;Microbacterium;Microbacterium deminutum	0	43	0	47	0	0	0	0	90
Bacteria;Bacteria_none;Firmicutes;Clostridia;Eubacteriales;Lachnospiraceae;Anaerobutyricum;Anaerobutyricum hallii	72	2	11	1	0	2	0	2	90
Bacteria;Bacteria_none;Firmicutes;Clostridia;Eubacteriales;Lachnospiraceae;Butyribacter;Butyribacter intestini	7	14	35	17	4	4	3	6	90
Bacteria;Bacteria_none;Firmicutes;Bacilli;Bacillales;Bacillaceae;Amphibacillus;Amphibacillus tropicus	1	7	37	12	14	15	3	1	90
Bacteria;Bacteria_none;Proteobacteria;Gammaproteobacteria;Alteromonadales;Pseudoalteromonadaceae;Pseudoalteromonas;Pseudoalteromonas donghaensis	1	34	5	35	0	8	5	2	90
Bacteria;Bacteria_none;Proteobacteria;Betaproteobacteria;Nitrosomonadales;Sterolibacteriaceae;Georgfuchsia;Georgfuchsia toluolica	80	1	2	5	0	0	0	2	90
Bacteria;Bacteria_none;Firmicutes;Negativicutes;Selenomonadales;Selenomonadaceae;Pectinatus;Pectinatus frisingensis	27	27	3	13	0	5	11	4	90
Bacteria;Bacteria_none;Firmicutes;Clostridia;Eubacteriales;Caldicoprobacteraceae;Caldicoprobacter;Caldicoprobacter faecalis	8	24	25	0	6	26	0	0	89
Bacteria;Bacteria_none;Proteobacteria;Betaproteobacteria;Burkholderiales;Comamonadaceae;Simplicispira;Simplicispira suum	52	20	5	3	3	5	1	0	89
Bacteria;Bacteria_none;Proteobacteria;Gammaproteobacteria;Enterobacterales;Enterobacteriaceae;Cronobacter;Cronobacter dublinensis	60	5	8	11	0	0	2	3	89
Bacteria;Bacteria_none;Firmicutes;Clostridia;Eubacteriales;Peptostreptococcaceae;Peptoanaerobacter;[Eubacterium] yurii	5	11	31	23	7	9	1	2	89
Bacteria;Bacteria_none;Proteobacteria;Alphaproteobacteria;Rhodobacterales;Rhodobacteraceae;Paracoccus;Paracoccus pacificus	37	10	11	23	1	5	1	1	89
Bacteria;Bacteria_none;Proteobacteria;Betaproteobacteria;Burkholderiales;Comamonadaceae;Variovorax;Variovorax gossypii	48	28	3	3	1	4	1	1	89
Bacteria;Bacteria_none;Firmicutes;Clostridia;Eubacteriales;Lachnospiraceae;Lachnospira;Lachnospira multipara	10	18	35	5	5	13	2	1	89
Bacteria;Bacteria_none;Firmicutes;Clostridia;Eubacteriales;Peptococcaceae;Peptococcus;Peptococcus simiae	0	13	56	3	7	5	2	2	88
Bacteria;Bacteria_none;Proteobacteria;Betaproteobacteria;Burkholderiales;Comamonadaceae;Rhodoferax;Rhodoferax fermentans	70	9	4	1	0	4	0	0	88
Bacteria;Bacteria_none;Bacteroidota;Flavobacteriia;Flavobacteriales;Schleiferiaceae;Owenweeksia;Owenweeksia hongkongensis	16	64	5	2	0	1	0	0	88
Bacteria;Bacteria_none;Firmicutes;Clostridia;Eubacteriales;Oscillospiraceae;Caproiciproducens;Caproiciproducens galactitolivorans	2	18	13	7	7	28	2	11	88
Bacteria;Bacteria_none;Proteobacteria;Betaproteobacteria;Burkholderiales;Burkholderiaceae;Polynucleobacter;Polynucleobacter necessarius	88	0	0	0	0	0	0	0	88
Bacteria;Bacteria_none;Verrucomicrobia;Verrucomicrobiae;Verrucomicrobiales;Verrucomicrobiaceae;Brevifollis;Brevifollis gellanilyticus	6	79	3	0	0	0	0	0	88
Bacteria;Bacteria_none;Proteobacteria;Alphaproteobacteria;Hyphomicrobiales;Methylobacteriaceae;Microvirga;Microvirga tunisiensis	22	22	10	27	4	3	0	0	88
Bacteria;Bacteria_none;Firmicutes;Clostridia;Eubacteriales;Lachnospiraceae;Lachnobacterium;Lachnobacterium bovis	25	20	11	12	5	4	4	7	88
Bacteria;Bacteria_none;Proteobacteria;Alphaproteobacteria;Rhodobacterales;Rhodobacteraceae;Cereibacter;[Luteovulum] alkalitolerans	20	26	9	14	5	9	3	2	88
Bacteria;Bacteria_none;Firmicutes;Clostridia;Eubacteriales;Clostridiaceae;Butyricicoccus;Butyricicoccus porcorum	10	43	11	9	2	10	0	3	88
Bacteria;Bacteria_none;Proteobacteria;Gammaproteobacteria;Legionellales;Legionellaceae;Legionella;Legionella thermalis	19	15	10	22	5	7	7	2	87
Bacteria;Bacteria_none;Proteobacteria;Deltaproteobacteria;Desulfovibrionales;Desulfovibrionaceae;Cupidesulfovibrio;Cupidesulfovibrio oxamicus	11	70	4	2	0	0	0	0	87
Bacteria;Bacteria_none;Firmicutes;Clostridia;Eubacteriales;Clostridiaceae;Clostridium;Clostridium cellulovorans	13	16	26	10	10	2	6	4	87
Bacteria;Bacteria_none;Firmicutes;Clostridia;Eubacteriales;Lachnospiraceae;Anaerostipes;Anaerostipes hominis	1	11	14	26	4	12	13	6	87
Bacteria;Bacteria_none;Firmicutes;Clostridia;Eubacteriales;Oscillospiraceae;Ruminiclostridium;Ruminiclostridium herbifermentans	2	0	32	4	18	25	0	6	87
Bacteria;Bacteria_none;Firmicutes;Clostridia;Eubacteriales;Peptostreptococcaceae;Peptostreptococcus;Peptostreptococcus anaerobius	7	36	16	16	2	4	0	6	87
Bacteria;Bacteria_none;Actinobacteria;Actinomycetia;Propionibacteriales;Propionibacteriaceae;Acidipropionibacterium;Acidipropionibacterium jensenii	8	8	27	32	2	8	0	2	87
Bacteria;Bacteria_none;Firmicutes;Clostridia;Eubacteriales;Lachnospiraceae;Cellulosilyticum;Cellulosilyticum ruminicola	8	9	22	20	6	4	6	11	86
Bacteria;Bacteria_none;Proteobacteria;Deltaproteobacteria;Syntrophales;Syntrophaceae;Syntrophus;Syntrophus gentianae	3	69	2	0	11	1	0	0	86
Bacteria;Bacteria_none;Firmicutes;Clostridia;Eubacteriales;Clostridiaceae;Clostridium;Clostridium thermobutyricum	50	3	10	10	4	5	0	4	86
Bacteria;Bacteria_none;Firmicutes;Clostridia;Eubacteriales;Clostridiaceae;Clostridium;Clostridium neonatale	33	8	7	19	5	8	3	3	86
Bacteria;Bacteria_none;Actinobacteria;Actinomycetia;Micrococcales;Brevibacteriaceae;Brevibacterium;Brevibacterium ihuae	6	57	9	7	4	0	1	2	86
Bacteria;Bacteria_none;Chloroflexi;Thermomicrobia;Sphaerobacterales;Sphaerobacteraceae;Nitrolancea;Nitrolancea hollandica	8	13	20	34	7	0	2	2	86
Bacteria;Bacteria_none;Proteobacteria;Gammaproteobacteria;Legionellales;Legionellaceae;Legionella;Legionella lansingensis	24	8	17	22	5	7	0	2	85
Bacteria;Bacteria_none;Bacteroidota;Bacteroidia;Marinilabiliales;Marinilabiliaceae;Saccharicrinis;Saccharicrinis carchari	5	10	11	31	1	2	18	7	85
Bacteria;Bacteria_none;Planctomycetota;Planctomycetia;Planctomycetales;Planctomycetaceae;Planctopirus;Planctopirus limnophila	39	18	6	14	3	5	0	0	85
Bacteria;Bacteria_none;Bacteroidota;Bacteroidia;Marinilabiliales;Marinilabiliaceae;Marinilabilia;Marinilabilia salmonicolor	2	9	6	51	3	4	1	9	85
Bacteria;Bacteria_none;Proteobacteria;Gammaproteobacteria;Enterobacterales;Enterobacteriaceae;Salmonella;Salmonella enterica	62	4	0	9	1	7	0	2	85
Bacteria;Bacteria_none;Firmicutes;Bacilli;Bacillales;Bacillaceae;Bacillus;Bacillus weihaiensis	0	0	74	4	2	5	0	0	85
Bacteria;Bacteria_none;Firmicutes;Bacilli;Lactobacillales;Streptococcaceae;Streptococcus;Streptococcus iniae	46	11	10	14	0	1	3	0	85
Bacteria;Bacteria_none;Firmicutes;Tissierellia;Tissierellales;Tissierellaceae;Tissierella;Tissierella creatinophila	12	7	38	10	2	4	9	3	85
Bacteria;Bacteria_none;Proteobacteria;Betaproteobacteria;Burkholderiales;Comamonadaceae;Comamonas;Comamonas composti	51	11	7	2	5	5	1	2	84
Bacteria;Bacteria_none;Bacteroidota;Saprospiria;Saprospirales;Lewinellaceae;Flavilitoribacter;Flavilitoribacter nigricans	62	16	2	2	0	0	0	2	84
Bacteria;Bacteria_none;Actinobacteria;Actinomycetia;Streptosporangiales;Streptosporangiaceae;Streptosporangium;Streptosporangium subfuscum	11	12	16	34	3	0	4	4	84
Bacteria;Bacteria_none;Planctomycetota;Planctomycetia;Pirellulales;Pirellulaceae;Rubripirellula;Rubripirellula obstinata	5	9	13	41	0	3	12	1	84
Bacteria;Bacteria_none;Firmicutes;Clostridia;Eubacteriales;Symbiobacteriaceae;Symbiobacterium;Symbiobacterium thermophilum	0	2	17	57	4	3	0	0	83
Bacteria;Bacteria_none;Proteobacteria;Gammaproteobacteria;Xanthomonadales;Xanthomonadaceae;Lysobacter;Lysobacter oligotrophicus	83	0	0	0	0	0	0	0	83
Bacteria;Bacteria_none;Firmicutes;Tissierellia;Tissierellales;Peptoniphilaceae;Peptoniphilus;Peptoniphilus duerdenii	4	79	0	0	0	0	0	0	83
Bacteria;Bacteria_none;Actinobacteria;Actinomycetia;Pseudonocardiales;Pseudonocardiaceae;Actinokineospora;Actinokineospora soli	0	1	3	79	0	0	0	0	83
Bacteria;Bacteria_none;Bacteroidota;Bacteroidia;Bacteroidales;Rikenellaceae;Alistipes;Alistipes provencensis	0	0	10	68	0	0	5	0	83
Bacteria;Bacteria_none;Planctomycetota;Planctomycetia;Pirellulales;Lacipirellulaceae;Botrimarina;Botrimarina mediterranea	7	13	15	37	2	5	1	3	83
Bacteria;Bacteria_none;Proteobacteria;Alphaproteobacteria;Hyphomicrobiales;Rhizobiaceae;Shinella;Shinella granuli	0	0	83	0	0	0	0	0	83
Bacteria;Bacteria_none;Firmicutes;Clostridia;Eubacteriales;Eubacteriaceae;Acetobacterium;Acetobacterium psammolithicum	16	3	11	42	0	10	0	0	82
Bacteria;Bacteria_none;Proteobacteria;Betaproteobacteria;Burkholderiales;Comamonadaceae;Comamonas;Comamonas zonglianii	54	12	1	3	2	1	5	4	82
Bacteria;Bacteria_none;Fusobacteria;Fusobacteriia;Fusobacteriales;Leptotrichiaceae;Pseudoleptotrichia;Pseudoleptotrichia goodfellowii	57	3	2	8	0	3	2	7	82
Bacteria;Bacteria_none;Firmicutes;Clostridia;Eubacteriales;Eubacteriales Family XII. Incertae Sedis;Guggenheimella;Guggenheimella bovis	6	24	8	3	3	38	0	0	82
Bacteria;Bacteria_none;Proteobacteria;Betaproteobacteria;Burkholderiales;Alcaligenaceae;Pelistega;Pelistega indica	58	11	6	3	1	1	1	0	81
Bacteria;Bacteria_none;Firmicutes;Clostridia;Eubacteriales;Lachnospiraceae;Anaerocolumna;Anaerocolumna xylanovorans	0	1	26	10	0	42	2	0	81
Bacteria;Bacteria_none;Proteobacteria;Betaproteobacteria;Burkholderiales;Comamonadaceae;Variovorax;Variovorax ginsengisoli	37	27	6	2	3	3	2	1	81
Bacteria;Bacteria_none;Proteobacteria;Gammaproteobacteria;Enterobacterales;Enterobacteriaceae;Leclercia;Leclercia pneumoniae	69	4	1	5	0	1	1	0	81
Bacteria;Bacteria_none;Proteobacteria;Deltaproteobacteria;Desulfobacterales;Desulfocapsaceae;Desulfocapsa;Desulfocapsa thiozymogenes	1	40	4	2	34	0	0	0	81
Bacteria;Bacteria_none;Proteobacteria;Deltaproteobacteria;Desulfovibrionales;Desulfovibrionaceae;Oleidesulfovibrio;Oleidesulfovibrio alaskensis	0	62	0	17	0	2	0	0	81
Bacteria;Bacteria_none;Firmicutes;Negativicutes;Selenomonadales;Selenomonadaceae;Pectinatus;Pectinatus brassicae	50	9	13	1	2	4	1	1	81
Bacteria;Bacteria_none;Proteobacteria;Alphaproteobacteria;Rhodospirillales;Acetobacteraceae;Acetobacter;Acetobacter oryzoeni	0	81	0	0	0	0	0	0	81
Bacteria;Bacteria_none;Firmicutes;Negativicutes;Selenomonadales;Selenomonadaceae;Mitsuokella;Mitsuokella jalaludinii	23	12	10	21	0	0	12	2	80
Bacteria;Bacteria_none;Proteobacteria;Gammaproteobacteria;Xanthomonadales;Xanthomonadaceae;Xylella;Xylella fastidiosa	6	14	27	21	2	1	1	8	80
Bacteria;Bacteria_none;Firmicutes;Bacilli;Lactobacillales;Streptococcaceae;Streptococcus;Streptococcus panodentis	64	6	2	6	1	0	1	0	80
Bacteria;Bacteria_none;Bacteroidota;Bacteroidia;Bacteroidales;Porphyromonadaceae;Porphyromonas;Porphyromonas bennonis	0	7	6	27	1	26	8	5	80
Bacteria;Bacteria_none;Proteobacteria;Alphaproteobacteria;Rickettsiales;Anaplasmataceae;Ehrlichia;Ehrlichia minasensis	3	31	15	19	0	3	5	4	80
Bacteria;Bacteria_none;Firmicutes;Negativicutes;Veillonellales;Veillonellaceae;Veillonella;Veillonella nakazawae	64	11	0	3	0	0	2	0	80
Bacteria;Bacteria_none;Proteobacteria;Betaproteobacteria;Rhodocyclales;Zoogloeaceae;Thauera;Thauera selenatis	30	31	0	8	4	4	1	2	80
Bacteria;Bacteria_none;Proteobacteria;Alphaproteobacteria;Rhodobacterales;Rhodobacteraceae;Defluviimonas;Defluviimonas denitrificans	24	28	11	12	3	0	1	1	80
Bacteria;Bacteria_none;Proteobacteria;Gammaproteobacteria;Xanthomonadales;Xanthomonadaceae;Pseudoxanthomonas;Pseudoxanthomonas suwonensis	26	15	9	17	4	3	4	2	80
Bacteria;Bacteria_none;Proteobacteria;Deltaproteobacteria;Syntrophobacterales;Syntrophobacteraceae;Syntrophobacterium;Syntrophobacterium sulfatireducens	1	11	31	24	6	6	1	0	80
Bacteria;Bacteria_none;Proteobacteria;Gammaproteobacteria;Xanthomonadales;Xanthomonadaceae;Lysobacter;Lysobacter sediminicola	76	3	0	0	0	0	0	0	79
Bacteria;Bacteria_none;Firmicutes;Clostridia;Thermoanaerobacterales;Thermoanaerobacteraceae;Moorella;Moorella thermoacetica	1	0	53	1	15	9	0	0	79
Bacteria;Bacteria_none;Proteobacteria;Alphaproteobacteria;Rhodobacterales;Rhodobacteraceae;Rhodovulum;Rhodovulum euryhalinum	37	29	3	8	0	2	0	0	79
Bacteria;Bacteria_none;Bacteroidota;Saprospiria;Saprospirales;Haliscomenobacteraceae;Phaeodactylibacter;Phaeodactylibacter xiamenensis	56	10	6	3	0	1	0	2	78
Bacteria;Bacteria_none;Firmicutes;Clostridia;Eubacteriales;Eubacteriales Family XIII. Incertae Sedis;Zhenpiania;Zhenpiania hominis	8	4	11	38	4	8	2	3	78
Bacteria;Bacteria_none;Proteobacteria;Betaproteobacteria;Burkholderiales;Burkholderiaceae;Paraburkholderia;Paraburkholderia phytofirmans	34	22	11	4	2	0	3	2	78
Bacteria;Bacteria_none;Firmicutes;Clostridia;Eubacteriales;Lachnospiraceae;Parasporobacterium;Parasporobacterium paucivorans	12	5	34	5	5	14	1	2	78
Bacteria;Bacteria_none;Synergistetes;Synergistia;Synergistales;Synergistaceae;Aminobacterium;Aminobacterium mobile	1	70	3	1	1	2	0	0	78
Bacteria;Bacteria_none;Firmicutes;Clostridia;Thermosediminibacterales;Tepidanaerobacteraceae;Biomaibacter;Biomaibacter acetigenes	1	3	59	6	3	4	0	2	78
Bacteria;Bacteria_none;Proteobacteria;Gammaproteobacteria;Moraxellales;Moraxellaceae;Psychrobacter;Psychrobacter adeliensis	26	34	8	2	4	1	2	1	78
Bacteria;Bacteria_none;Firmicutes;Clostridia;Eubacteriales;Lachnospiraceae;Coprococcus;Coprococcus comes	59	10	1	5	0	0	2	1	78
Bacteria;Bacteria_none;Firmicutes;Bacilli;Lactobacillales;Lactobacillaceae;Leuconostoc;Leuconostoc holzapfelii	49	7	12	7	0	2	1	0	78
Bacteria;Bacteria_none;Proteobacteria;Alphaproteobacteria;Hyphomicrobiales;Boseaceae;Bosea;Bosea lupini	37	27	0	0	0	14	0	0	78
Bacteria;Bacteria_none;Firmicutes;Clostridia;Eubacteriales;Lachnospiraceae;Agathobacter;Agathobacter ruminis	18	19	7	19	4	4	5	1	77
Bacteria;Bacteria_none;Candidatus Melainabacteria;Candidatus Melainabacteria_Incertae_sedis;Vampirovibrionales;Vampirovibrionales_Incertae_sedis;Vampirovibrio;Vampirovibrio chlorellavorus	65	5	1	1	1	0	1	3	77
Bacteria;Bacteria_none;Proteobacteria;Betaproteobacteria;Burkholderiales;Comamonadaceae;Rhodoferax;Rhodoferax antarcticus	57	8	4	5	0	0	0	2	76
Bacteria;Bacteria_none;Fibrobacteres;Chitinispirillia;Chitinispirillales;Chitinispirillaceae;Chitinispirillum;Chitinispirillum alkaliphilum	2	16	40	3	6	8	1	0	76
Bacteria;Bacteria_none;Proteobacteria;Gammaproteobacteria;Pseudomonadales;Pseudomonadaceae;Pseudomonas;Pseudomonas taetrolens	5	31	8	23	0	0	0	9	76
Bacteria;Bacteria_none;Firmicutes;Bacilli;Bacillales;Paenibacillaceae;Cohnella;Cohnella xylanilytica	1	3	31	5	3	33	0	0	76
Bacteria;Bacteria_none;Proteobacteria;Betaproteobacteria;Burkholderiales;Comamonadaceae;Acidovorax;Acidovorax valerianellae	55	16	0	1	2	2	0	0	76
Bacteria;Bacteria_none;Actinobacteria;Actinomycetia;Micrococcales;Microbacteriaceae;Agromyces;Agromyces hippuratus	2	11	24	17	10	8	2	2	76
Bacteria;Bacteria_none;Firmicutes;Clostridia;Eubacteriales;Lachnospiraceae;Anaerotignum;Anaerotignum propionicum	17	10	25	12	5	3	3	1	76
Bacteria;Bacteria_none;Proteobacteria;Alphaproteobacteria;Hyphomicrobiales;Alsobacteraceae;Alsobacter;Alsobacter soli	14	34	10	11	3	1	2	0	75
Bacteria;Bacteria_none;Proteobacteria;Gammaproteobacteria;Xanthomonadales;Rhodanobacteraceae;Tahibacter;Tahibacter caeni	60	6	0	9	0	0	0	0	75
Bacteria;Bacteria_none;Tenericutes;Mollicutes;Mycoplasmatales;Mycoplasmataceae;Mesomycoplasma;Mesomycoplasma mobile	0	19	38	2	13	0	3	0	75
Bacteria;Bacteria_none;Proteobacteria;Alphaproteobacteria;Holosporales;Caedimonadaceae;Caedimonas;Caedimonas varicaedens	13	13	21	25	2	0	1	0	75
Bacteria;Bacteria_none;Proteobacteria;Alphaproteobacteria;Rhodobacterales;Rhodobacteraceae;Paracoccus;Paracoccus sordidisoli	18	15	17	10	3	8	1	2	74
Bacteria;Bacteria_none;Proteobacteria;Alphaproteobacteria;Hyphomicrobiales;Stappiaceae;Roseibium;Roseibium suaedae	20	20	15	14	0	3	0	2	74
Bacteria;Bacteria_none;Firmicutes;Clostridia;Eubacteriales;Eubacteriales Family XIII. Incertae Sedis;Eubacteriales Family XIII. Incertae Sedis_Incertae_sedis;[Eubacterium] brachy	5	17	23	14	3	7	4	1	74
Bacteria;Bacteria_none;Proteobacteria;Gammaproteobacteria;Pseudomonadales;Pseudomonadaceae;Stutzerimonas;Stutzerimonas stutzeri	2	19	28	15	2	2	0	6	74
Bacteria;Bacteria_none;Firmicutes;Clostridia;Eubacteriales;Peptococcaceae;Desulfitibacter;Desulfitibacter alkalitolerans	0	2	52	9	8	2	1	0	74
Bacteria;Bacteria_none;Firmicutes;Clostridia;Eubacteriales;Desulfitobacteriaceae;Desulfosporosinus;Desulfosporosinus meridiei	0	21	36	4	4	9	0	0	74
Bacteria;Bacteria_none;Proteobacteria;Alphaproteobacteria;Hyphomicrobiales;Nitrobacteraceae;Bradyrhizobium;Bradyrhizobium campsiandrae	19	18	7	19	3	1	4	3	74
Bacteria;Bacteria_none;Firmicutes;Negativicutes;Acidaminococcales;Acidaminococcaceae;Phascolarctobacterium;Phascolarctobacterium succinatutens	23	2	22	5	4	9	4	5	74
Bacteria;Bacteria_none;Firmicutes;Clostridia;Eubacteriales;Oscillospiraceae;Oscillibacter;Oscillibacter valericigenes	35	1	19	6	5	5	0	3	74
Bacteria;Bacteria_none;Firmicutes;Bacilli;Bacillales;Paenibacillaceae;Paenibacillus;Paenibacillus zeae	0	1	62	0	11	0	0	0	74
Bacteria;Bacteria_none;Proteobacteria;Gammaproteobacteria;Xanthomonadales;Xanthomonadaceae;Thermomonas;Thermomonas fusca	32	14	2	14	5	1	4	2	74
Bacteria;Bacteria_none;Firmicutes;Clostridia;Eubacteriales;Eubacteriales Family XIII. Incertae Sedis;Mogibacterium;Mogibacterium diversum	13	7	36	3	6	9	0	0	74
Bacteria;Bacteria_none;Firmicutes;Negativicutes;Veillonellales;Veillonellaceae;Megasphaera;Megasphaera massiliensis	13	2	0	44	1	1	9	4	74
Bacteria;Bacteria_none;Bacteroidota;Sphingobacteriia;Sphingobacteriales;Filobacteriaceae;Filobacterium;Filobacterium rodentium	5	13	21	23	2	0	1	9	74
Bacteria;Bacteria_none;Actinobacteria;Actinomycetia;Corynebacteriales;Mycobacteriaceae;Mycolicibacter;Mycolicibacter hiberniae	6	13	23	24	0	1	7	0	74
Bacteria;Bacteria_none;Firmicutes;Clostridia;Eubacteriales;Clostridiales Family XVII. Incertae Sedis;Sulfobacillus;Sulfobacillus sibiricus	0	0	0	73	0	0	0	0	73
Bacteria;Bacteria_none;Firmicutes;Bacilli;Bacillales;Paenibacillaceae;Cohnella;Cohnella laeviribosi	0	3	31	2	9	26	2	0	73
Bacteria;Bacteria_none;Proteobacteria;Alphaproteobacteria;Rhodobacterales;Rhodobacteraceae;Paracoccus;Paracoccus zeaxanthinifaciens	7	0	12	38	7	9	0	0	73
Bacteria;Bacteria_none;Spirochaetes;Spirochaetia;Brachyspirales;Brachyspiraceae;Brachyspira;Brachyspira pilosicoli	1	12	26	12	9	3	6	4	73
Bacteria;Bacteria_none;Firmicutes;Negativicutes;Selenomonadales;Sporomusaceae;Sporomusa;Sporomusa acidovorans	28	11	12	10	6	2	3	1	73
Bacteria;Bacteria_none;Proteobacteria;Betaproteobacteria;Burkholderiales;Comamonadaceae;Ottowia;Ottowia oryzae	38	0	22	0	0	13	0	0	73
Bacteria;Bacteria_none;Planctomycetota;Planctomycetia;Planctomycetales;Planctomycetaceae;Calycomorphotria;Calycomorphotria hydatis	27	13	4	17	3	3	0	6	73
Bacteria;Bacteria_none;Proteobacteria;Alphaproteobacteria;Rhodobacterales;Rhodobacteraceae;Paracoccus;Paracoccus angustae	27	19	10	10	0	6	0	1	73
Bacteria;Bacteria_none;Bacteroidota;Bacteroidia;Bacteroidales;Tannerellaceae;Parabacteroides;Parabacteroides merdae	1	0	11	42	2	5	10	2	73
Bacteria;Bacteria_none;Proteobacteria;Alphaproteobacteria;Hyphomicrobiales;Nitrobacteraceae;Bradyrhizobium;Bradyrhizobium centrolobii	15	19	9	22	7	1	0	0	73
Bacteria;Bacteria_none;Proteobacteria;Gammaproteobacteria;Enterobacterales;Enterobacteriaceae;Enterobacter;Enterobacter asburiae	57	4	2	4	0	1	0	4	72
Bacteria;Bacteria_none;Proteobacteria;Alphaproteobacteria;Rhodospirillales;Acetobacteraceae;Roseomonas;Roseomonas cervicalis	15	17	16	16	4	0	4	0	72
Bacteria;Bacteria_none;Proteobacteria;Gammaproteobacteria;Xanthomonadales;Xanthomonadaceae;Arenimonas;Arenimonas daechungensis	44	9	6	7	3	0	2	1	72
Bacteria;Bacteria_none;Bacteroidota;Chitinophagia;Chitinophagales;Chitinophagaceae;Ferruginibacter;Ferruginibacter alkalilentus	63	6	1	0	1	0	0	1	72
Bacteria;Bacteria_none;Firmicutes;Clostridia;Eubacteriales;Clostridiaceae;Clostridium;Clostridium acetireducens	9	6	8	29	2	11	2	5	72
Bacteria;Bacteria_none;Firmicutes;Clostridia;Eubacteriales;Oscillospiraceae;Angelakisella;Angelakisella massiliensis	14	3	19	14	15	4	0	3	72
Bacteria;Bacteria_none;Proteobacteria;Gammaproteobacteria;Moraxellales;Moraxellaceae;Acinetobacter;Acinetobacter tandoii	40	2	6	18	1	1	2	2	72
Bacteria;Bacteria_none;Firmicutes;Bacilli;Lactobacillales;Lactobacillaceae;Limosilactobacillus;Limosilactobacillus mucosae	41	4	11	10	4	1	0	0	71
Bacteria;Bacteria_none;Proteobacteria;Alphaproteobacteria;Hyphomicrobiales;Hyphomicrobiaceae;Hyphomicrobium;Hyphomicrobium methylovorum	15	19	14	14	1	6	0	2	71
Bacteria;Bacteria_none;Proteobacteria;Alphaproteobacteria;Hyphomicrobiales;Xanthobacteraceae;Xanthobacter;Xanthobacter aminoxidans	19	15	4	16	6	6	2	3	71
Bacteria;Bacteria_none;Proteobacteria;Gammaproteobacteria;Xanthomonadales;Xanthomonadaceae;Stenotrophomonas;Stenotrophomonas daejeonensis	50	2	7	11	0	0	0	1	71
Bacteria;Bacteria_none;Proteobacteria;Alphaproteobacteria;Rhodobacterales;Rhodobacteraceae;Paracoccus;Paracoccus aeridis	18	17	12	13	1	8	2	0	71
Bacteria;Bacteria_none;Bacteroidota;Flavobacteriia;Flavobacteriales;Flavobacteriaceae;Gangjinia;Gangjinia marincola	0	0	5	41	1	14	2	8	71
Bacteria;Bacteria_none;Firmicutes;Clostridia;Eubacteriales;Oscillospiraceae;Ruminiclostridium;Ruminiclostridium hungatei	6	51	5	1	3	2	0	3	71
Bacteria;Bacteria_none;Proteobacteria;Gammaproteobacteria;Moraxellales;Moraxellaceae;Acinetobacter;Acinetobacter gerneri	38	1	9	21	0	0	0	2	71
Bacteria;Bacteria_none;Proteobacteria;Betaproteobacteria;Burkholderiales;Burkholderiales_Incertae_sedis;Aquabacterium;Aquabacterium olei	36	12	9	2	5	4	0	3	71
Bacteria;Bacteria_none;Firmicutes;Clostridia;Eubacteriales;Christensenellaceae;Christensenella;Christensenella massiliensis	19	18	2	6	2	20	0	3	70
Bacteria;Bacteria_none;Firmicutes;Clostridia;Eubacteriales;Clostridiaceae;Clostridium;Clostridium cylindrosporum	2	25	9	11	8	1	1	13	70
Bacteria;Bacteria_none;Proteobacteria;Gammaproteobacteria;Chromatiales;Chromatiaceae;Thiocystis;Thiocystis violascens	33	13	11	10	0	3	0	0	70
Bacteria;Bacteria_none;Proteobacteria;Gammaproteobacteria;Pseudomonadales;Pseudomonadaceae;Pseudomonas;Pseudomonas jinjuensis	0	0	7	49	6	5	0	3	70
Bacteria;Bacteria_none;Proteobacteria;Alphaproteobacteria;Rhodobacterales;Rhodobacteraceae;Roseibaca;Roseibaca ekhonensis	46	12	2	2	1	6	0	1	70
Bacteria;Bacteria_none;Proteobacteria;Alphaproteobacteria;Rhodobacterales;Rhodobacteraceae;Limibaculum;Limibaculum halophilum	17	30	6	9	2	4	2	0	70
Bacteria;Bacteria_none;Proteobacteria;Alphaproteobacteria;Rhodospirillales;Thalassobaculaceae;Thalassobaculum;Thalassobaculum salexigens	0	68	2	0	0	0	0	0	70
Bacteria;Bacteria_none;Bacteroidota;Bacteroidia;Bacteroidales;Bacteroidaceae;Bacteroides;Bacteroides graminisolvens	32	10	7	5	0	7	4	5	70
Bacteria;Bacteria_none;Verrucomicrobia;Verrucomicrobiae;Verrucomicrobiales;Verrucomicrobiaceae;Verrucomicrobium;Verrucomicrobium spinosum	13	57	0	0	0	0	0	0	70
Bacteria;Bacteria_none;Firmicutes;Clostridia;Eubacteriales;Peptostreptococcaceae;Asaccharospora;Asaccharospora irregularis	4	7	10	20	5	6	7	11	70
Bacteria;Bacteria_none;Planctomycetota;Planctomycetia;Isosphaerales;Isosphaeraceae;Isosphaera;Isosphaera pallida	12	16	11	11	3	11	5	1	70
Bacteria;Bacteria_none;Firmicutes;Negativicutes;Selenomonadales;Selenomonadaceae;Schwartzia;Schwartzia succinivorans	7	8	37	3	3	4	5	2	69
Bacteria;Bacteria_none;Proteobacteria;Gammaproteobacteria;Chromatiales;Chromatiaceae;Allochromatium;Allochromatium renukae	59	10	0	0	0	0	0	0	69
Bacteria;Bacteria_none;Proteobacteria;Alphaproteobacteria;Hyphomicrobiales;Rhabdaerophilaceae;Rhabdaerophilum;Rhabdaerophilum calidifontis	24	23	9	5	2	5	1	0	69
Bacteria;Bacteria_none;Firmicutes;Clostridia;Eubacteriales;Heliobacteriaceae;Heliomicrobium;Heliomicrobium modesticaldum	2	49	5	3	3	5	0	2	69
Bacteria;Bacteria_none;Synergistetes;Synergistia;Synergistales;Synergistaceae;Synergistes;Synergistes jonesii	1	22	26	4	2	11	0	2	68
Bacteria;Bacteria_none;Proteobacteria;Betaproteobacteria;Burkholderiales;Comamonadaceae;Pulveribacter;Pulveribacter suum	49	11	1	2	1	3	0	1	68
Bacteria;Bacteria_none;Acidobacteria;Vicinamibacteria;Vicinamibacterales;Vicinamibacteraceae;Luteitalea;Luteitalea pratensis	46	3	15	1	2	0	0	1	68
Bacteria;Bacteria_none;Firmicutes;Clostridia;Eubacteriales;Lachnospiraceae;Acetatifactor;Acetatifactor muris	5	11	20	14	2	12	3	1	68
Bacteria;Bacteria_none;Proteobacteria;Alphaproteobacteria;Rhodobacterales;Rhodobacteraceae;Rhabdonatronobacter;Rhabdonatronobacter sediminivivens	19	18	10	13	2	4	1	1	68
Bacteria;Bacteria_none;Firmicutes;Clostridia;Eubacteriales;Lachnospiraceae;Faecalicatena;Faecalicatena orotica	36	1	19	3	1	6	0	2	68
Bacteria;Bacteria_none;Bacteroidota;Flavobacteriia;Flavobacteriales;Flavobacteriaceae;Leeuwenhoekiella;Leeuwenhoekiella aequorea	9	12	29	9	0	0	4	5	68
Bacteria;Bacteria_none;Actinobacteria;Actinomycetia;Micrococcales;Micrococcaceae;Arthrobacter;Arthrobacter psychrolactophilus	2	5	24	28	1	3	2	2	67
Bacteria;Bacteria_none;Bacteroidota;Chitinophagia;Chitinophagales;Chitinophagaceae;Flavihumibacter;Flavihumibacter petaseus	31	30	3	2	0	1	0	0	67
Bacteria;Bacteria_none;Firmicutes;Bacilli;Bacillales;Bacillaceae;Salibacterium;Salibacterium halotolerans	4	12	23	11	4	11	0	2	67
Bacteria;Bacteria_none;Proteobacteria;Alphaproteobacteria;Rhodobacterales;Rhodobacteraceae;Paracoccus;Paracoccus shandongensis	21	10	12	17	1	3	1	2	67
Bacteria;Bacteria_none;Firmicutes;Negativicutes;Selenomonadales;Selenomonadaceae;Mitsuokella;Mitsuokella multacida	34	11	13	1	0	4	2	1	66
Bacteria;Bacteria_none;Bacteroidota;Bacteroidia;Bacteroidales;Lentimicrobiaceae;Lentimicrobium;Lentimicrobium saccharophilum	9	3	9	28	2	7	3	5	66
Bacteria;Bacteria_none;Proteobacteria;Alphaproteobacteria;Hyphomicrobiales;Phyllobacteriaceae;Mesorhizobium;Mesorhizobium microcysteis	18	25	6	4	6	7	0	0	66
Bacteria;Bacteria_none;Firmicutes;Bacilli;Bacillales;Bacillaceae;Bacillus;Bacillus gaemokensis	3	12	14	22	0	12	0	3	66
Bacteria;Bacteria_none;Actinobacteria;Actinomycetia;Propionibacteriales;Nocardioidaceae;Marmoricola;Marmoricola endophyticus	11	20	14	12	0	2	4	3	66
Bacteria;Bacteria_none;Cyanobacteria;Cyanobacteria_Incertae_sedis;Oscillatoriales;Coleofasciculaceae;Olisthonema;Olisthonema eestii	3	15	22	13	3	0	0	10	66
Bacteria;Bacteria_none;Firmicutes;Clostridia;Thermoanaerobacterales;Thermoanaerobacteraceae;Thermanaeromonas;Thermanaeromonas toyohensis	1	22	6	20	3	14	0	0	66
Bacteria;Bacteria_none;Firmicutes;Bacilli;Bacillales;Paenibacillaceae;Paenibacillus;Paenibacillus cisolokensis	0	6	38	10	6	4	1	1	66
Bacteria;Bacteria_none;Proteobacteria;Gammaproteobacteria;Oceanospirillales;Oceanospirillaceae;Pseudospirillum;Pseudospirillum japonicum	1	6	14	31	4	2	5	2	65
Bacteria;Bacteria_none;Proteobacteria;Alphaproteobacteria;Sphingomonadales;Sphingomonadaceae;Sphingobium;Sphingobium chlorophenolicum	4	18	13	22	1	1	0	6	65
Bacteria;Bacteria_none;Proteobacteria;Betaproteobacteria;Burkholderiales;Alcaligenaceae;Advenella;Advenella alkanexedens	0	0	5	1	0	58	1	0	65
Bacteria;Bacteria_none;Proteobacteria;Gammaproteobacteria;Legionellales;Legionellaceae;Legionella;Legionella geestiana	19	3	9	23	5	4	1	1	65
Bacteria;Bacteria_none;Proteobacteria;Alphaproteobacteria;Rhodospirillales;Acetobacteraceae;Humitalea;Humitalea rosea	25	12	7	13	2	5	1	0	65
Bacteria;Bacteria_none;Proteobacteria;Gammaproteobacteria;Nevskiales;Steroidobacteraceae;Steroidobacter;Steroidobacter gossypii	56	9	0	0	0	0	0	0	65
Bacteria;Bacteria_none;Bacteroidota;Bacteroidia;Bacteroidales;Muribaculaceae;Muribaculum;Muribaculum intestinale	3	45	3	3	1	5	1	4	65
Bacteria;Bacteria_none;Firmicutes;Clostridia;Eubacteriales;Lachnospiraceae;Dorea;Dorea phocaeensis	57	5	0	2	0	0	0	1	65
Bacteria;Bacteria_none;Actinobacteria;Actinomycetia;Micromonosporales;Micromonosporaceae;Dactylosporangium;Dactylosporangium aurantiacum	1	17	14	20	2	5	1	5	65
Bacteria;Bacteria_none;Proteobacteria;Betaproteobacteria;Burkholderiales;Burkholderiaceae;Paraburkholderia;Paraburkholderia kirstenboschensis	35	14	11	1	0	1	2	1	65
Bacteria;Bacteria_none;Firmicutes;Bacilli;Bacillales;Paenibacillaceae;Paenibacillus;Paenibacillus sanguinis	0	7	34	2	6	15	1	0	65
Bacteria;Bacteria_none;Proteobacteria;Alphaproteobacteria;Rhodospirillales;Acetobacteraceae;Acetobacter;Acetobacter nitrogenifigens	8	22	6	18	1	4	2	3	64
Bacteria;Bacteria_none;Bacteroidota;Bacteroidia;Bacteroidales;Dysgonomonadaceae;Dysgonomonas;Dysgonomonas hofstadii	12	11	12	20	0	2	3	4	64
Bacteria;Bacteria_none;Proteobacteria;Betaproteobacteria;Neisseriales;Chromobacteriaceae;Leeia;Leeia oryzae	31	14	11	5	1	2	0	0	64
Bacteria;Bacteria_none;Proteobacteria;Gammaproteobacteria;Enterobacterales;Enterobacteriaceae;Raoultella;Raoultella electrica	58	1	1	4	0	0	0	0	64
Bacteria;Bacteria_none;Actinobacteria;Actinomycetia;Micrococcales;Microbacteriaceae;Microbacterium;Microbacterium aureliae	12	18	17	6	0	2	6	3	64
Bacteria;Bacteria_none;Proteobacteria;Gammaproteobacteria;Enterobacterales;Enterobacteriaceae;Pseudocitrobacter;Pseudocitrobacter faecalis	42	2	2	9	0	8	0	1	64
Bacteria;Bacteria_none;Proteobacteria;Betaproteobacteria;Burkholderiales;Comamonadaceae;Comamonas;Comamonas testosteroni	41	3	8	1	1	7	0	3	64
Bacteria;Bacteria_none;Firmicutes;Tissierellia;Tissierellales;Tissierellaceae;Soehngenia;Soehngenia saccharolytica	0	0	5	27	1	17	11	3	64
Bacteria;Bacteria_none;Firmicutes;Bacilli;Bacillales;Paenibacillaceae;Paenibacillus;Paenibacillus provencensis	0	0	8	24	2	28	1	1	64
Bacteria;Bacteria_none;Actinobacteria;Actinomycetia;Corynebacteriales;Gordoniaceae;Gordonia;Gordonia rubripertincta	0	27	0	37	0	0	0	0	64
Bacteria;Bacteria_none;Proteobacteria;Gammaproteobacteria;Enterobacterales;Enterobacteriaceae;Pseudescherichia;Pseudescherichia vulneris	51	6	1	1	0	2	1	2	64
Bacteria;Bacteria_none;Proteobacteria;Alphaproteobacteria;Hyphomicrobiales;Boseaceae;Bosea;Bosea lathyri	11	8	16	25	0	4	0	0	64
Bacteria;Bacteria_none;Firmicutes;Bacilli;Lactobacillales;Streptococcaceae;Streptococcus;Streptococcus acidominimus	44	6	2	5	1	1	4	1	64
Bacteria;Bacteria_none;Proteobacteria;Alphaproteobacteria;Hyphomicrobiales;Parvibaculaceae;Parvibaculum;Parvibaculum lavamentivorans	0	3	39	0	22	0	0	0	64
Bacteria;Bacteria_none;Bacteroidota;Bacteroidia;Bacteroidales;Dysgonomonadaceae;Dysgonomonas;Dysgonomonas mossii	10	0	53	0	0	0	0	0	63
Bacteria;Bacteria_none;Firmicutes;Clostridia;Eubacteriales;Oscillospiraceae;Oscillibacter;Oscillibacter ruminantium	8	2	22	9	5	9	0	8	63
Bacteria;Bacteria_none;Proteobacteria;Deltaproteobacteria;Myxococcales;Anaeromyxobacteraceae;Anaeromyxobacter;Anaeromyxobacter dehalogenans	44	5	4	5	0	1	1	3	63
Bacteria;Bacteria_none;Proteobacteria;Alphaproteobacteria;Hyphomicrobiales;Phyllobacteriaceae;Mesorhizobium;Mesorhizobium composti	19	5	19	15	5	0	0	0	63
Bacteria;Bacteria_none;Firmicutes;Clostridia;Eubacteriales;Clostridiaceae;Clostridium;Clostridium sardiniense	8	24	7	9	6	4	1	4	63
Bacteria;Bacteria_none;Actinobacteria;Actinomycetia;Propionibacteriales;Propionibacteriaceae;Propioniciclava;Propioniciclava coleopterorum	26	8	10	14	1	3	1	0	63
Bacteria;Bacteria_none;Bacteroidota;Chitinophagia;Chitinophagales;Chitinophagaceae;Terrimonas;Terrimonas ferruginea	42	6	6	6	1	1	0	1	63
Bacteria;Bacteria_none;Firmicutes;Clostridia;Eubacteriales;Oscillospiraceae;Papillibacter;Papillibacter cinnamivorans	5	6	15	18	8	3	4	4	63
Bacteria;Bacteria_none;Firmicutes;Bacilli;Lactobacillales;Enterococcaceae;Enterococcus;Enterococcus lemanii	34	26	0	3	0	0	0	0	63
Bacteria;Bacteria_none;Proteobacteria;Gammaproteobacteria;Pasteurellales;Pasteurellaceae;Chelonobacter;Chelonobacter oris	45	1	3	10	2	1	0	1	63
Bacteria;Bacteria_none;Actinobacteria;Actinomycetia;Propionibacteriales;Propionibacteriaceae;Brooklawnia;Brooklawnia cerclae	7	18	18	12	1	4	1	2	63
Bacteria;Bacteria_none;Firmicutes;Clostridia;Eubacteriales;Lachnospiraceae;Roseburia;Roseburia inulinivorans	12	4	17	8	4	9	3	6	63
Bacteria;Bacteria_none;Firmicutes;Bacilli;Bacillales;Bacillaceae;Thermolongibacillus;Thermolongibacillus kozakliensis	1	0	48	0	5	8	1	0	63
Bacteria;Bacteria_none;Proteobacteria;Betaproteobacteria;Rhodocyclales;Zoogloeaceae;Azoarcus;Azoarcus olearius	53	2	1	1	1	2	2	1	63
Bacteria;Bacteria_none;Bacteroidota;Bacteroidia;Bacteroidales;Rikenellaceae;Mucinivorans;Mucinivorans hirudinis	5	53	0	3	0	0	1	0	62
Bacteria;Bacteria_none;Proteobacteria;Deltaproteobacteria;Desulfovibrionales;Desulfovibrionaceae;Humidesulfovibrio;Humidesulfovibrio idahonensis	0	48	9	2	0	0	2	1	62
Bacteria;Bacteria_none;Firmicutes;Clostridia;Eubacteriales;Lachnospiraceae;Diplocloster;Diplocloster agilis	30	0	14	6	5	6	0	1	62
Bacteria;Bacteria_none;Firmicutes;Clostridia;Eubacteriales;Clostridiaceae;Clostridium;Clostridium transplantifaecale	12	1	21	5	4	12	4	3	62
Bacteria;Bacteria_none;Proteobacteria;Alphaproteobacteria;Hyphomicrobiales;Rhizobiaceae;Rhizobium;Rhizobium arsenicireducens	8	18	13	16	1	3	1	2	62
Bacteria;Bacteria_none;Proteobacteria;Alphaproteobacteria;Rhodospirillales;Acetobacteraceae;Roseomonas;Roseomonas fluminis	22	23	10	4	1	2	0	0	62
Bacteria;Bacteria_none;Proteobacteria;Betaproteobacteria;Burkholderiales;Sphaerotilaceae;Ideonella;Ideonella azotifigens	43	10	2	4	0	2	0	1	62
Bacteria;Bacteria_none;Firmicutes;Clostridia;Eubacteriales;Clostridiaceae;Clostridium;Clostridium formicaceticum	7	6	30	8	6	2	2	1	62
Bacteria;Bacteria_none;Proteobacteria;Alphaproteobacteria;Rhodospirillales;Thalassospiraceae;Magnetovibrio;Magnetovibrio blakemorei	19	17	8	11	0	5	0	2	62
Bacteria;Bacteria_none;Firmicutes;Bacilli;Bacillales;Bacillaceae;Bacillus;Bacillus alkalicola	1	5	31	8	7	9	1	0	62
Bacteria;Bacteria_none;Firmicutes;Tissierellia;Tissierellales;Peptoniphilaceae;Anaerosphaera;Anaerosphaera massiliensis	13	41	8	0	0	0	0	0	62
Bacteria;Bacteria_none;Proteobacteria;Betaproteobacteria;Burkholderiales;Comamonadaceae;Melaminivora;Melaminivora alkalimesophila	20	3	2	36	0	0	0	0	61
Bacteria;Bacteria_none;Proteobacteria;Gammaproteobacteria;Legionellales;Legionellaceae;Legionella;Legionella beliardensis	12	14	12	14	2	5	1	1	61
Bacteria;Bacteria_none;Firmicutes;Bacilli;Lactobacillales;Lactobacillaceae;Liquorilactobacillus;Liquorilactobacillus nagelii	19	2	22	11	2	3	1	1	61
Bacteria;Bacteria_none;Proteobacteria;Betaproteobacteria;Burkholderiales;Comamonadaceae;Curvibacter;Curvibacter fontanus	37	15	2	1	0	3	2	1	61
Bacteria;Bacteria_none;Firmicutes;Bacilli;Bacillales;Alicyclobacillaceae;Alicyclobacillus;Alicyclobacillus fastidiosus	1	4	32	11	5	6	0	2	61
Bacteria;Bacteria_none;Firmicutes;Negativicutes;Veillonellales;Veillonellaceae;Veillonella;Veillonella ratti	40	7	0	7	0	4	3	0	61
Bacteria;Bacteria_none;Proteobacteria;Deltaproteobacteria;Myxococcales;Kofleriaceae;Haliangium;Haliangium tepidum	40	10	2	0	7	1	0	1	61
Bacteria;Bacteria_none;Proteobacteria;Deltaproteobacteria;Desulfovibrionales;Desulfovibrionaceae;Maridesulfovibrio;Maridesulfovibrio bastinii	5	19	18	0	14	2	0	3	61
Bacteria;Bacteria_none;Firmicutes;Bacilli;Bacillales;Paenibacillaceae;Paenibacillus;Paenibacillus mucilaginosus	1	6	28	5	4	17	0	0	61
Bacteria;Bacteria_none;Proteobacteria;Betaproteobacteria;Burkholderiales;Burkholderiaceae;Caballeronia;Caballeronia telluris	36	12	5	5	0	2	0	0	60
Bacteria;Bacteria_none;Firmicutes;Clostridia;Thermoanaerobacterales;Thermoanaerobacteraceae;Caldanaerobacter;Caldanaerobacter subterraneus	0	5	18	23	0	13	0	1	60
Bacteria;Bacteria_none;Proteobacteria;Epsilonproteobacteria;Campylobacterales;Arcobacteraceae;Aliarcobacter;Aliarcobacter faecis	5	8	16	15	0	5	2	9	60
Bacteria;Bacteria_none;Spirochaetes;Spirochaetia;Spirochaetales;Spirochaetales_Incertae_sedis;Exilispira;Exilispira thermophila	4	23	20	3	1	7	2	0	60
Bacteria;Bacteria_none;Firmicutes;Negativicutes;Veillonellales;Veillonellaceae;Veillonella;Veillonella infantium	43	9	1	3	2	1	1	0	60
Bacteria;Bacteria_none;Proteobacteria;Betaproteobacteria;Burkholderiales;Comamonadaceae;Ramlibacter;Ramlibacter agri	53	3	3	1	0	0	0	0	60
Bacteria;Bacteria_none;Firmicutes;Clostridia;Eubacteriales;Clostridiaceae;Anoxynatronum;Anoxynatronum buryatiense	6	11	23	9	5	6	0	0	60
Bacteria;Bacteria_none;Firmicutes;Clostridia;Eubacteriales;Peptostreptococcaceae;Terrisporobacter;Terrisporobacter glycolicus	6	12	15	14	2	5	1	4	59
Bacteria;Bacteria_none;Bacteroidota;Bacteroidia;Bacteroidales;Rikenellaceae;Alistipes;Alistipes communis	28	20	2	6	0	0	2	1	59
Bacteria;Bacteria_none;Firmicutes;Clostridia;Eubacteriales;Eubacteriales Family XIII. Incertae Sedis;Anaerovorax;Anaerovorax odorimutans	2	10	18	11	12	5	0	1	59
Bacteria;Bacteria_none;Proteobacteria;Gammaproteobacteria;Pseudomonadales;Pseudomonadaceae;Pseudomonas;Pseudomonas thermotolerans	0	0	8	40	2	6	1	2	59
Bacteria;Bacteria_none;Firmicutes;Bacilli;Lactobacillales;Enterococcaceae;Enterococcus;Enterococcus asini	37	7	9	3	1	1	0	1	59
Bacteria;Bacteria_none;Actinobacteria;Actinomycetia;Streptomycetales;Streptomycetaceae;Kitasatospora;Kitasatospora mediocidica	3	8	10	31	0	5	1	1	59
Bacteria;Bacteria_none;Proteobacteria;Gammaproteobacteria;Chromatiales;Chromatiaceae;Isochromatium;Isochromatium buderi	39	10	1	4	2	2	1	0	59
Bacteria;Bacteria_none;Firmicutes;Clostridia;Eubacteriales;Clostridiaceae;Clostridium;Clostridium luticellarii	4	6	7	30	4	4	2	2	59
Bacteria;Bacteria_none;Bacteroidota;Cytophagia;Cytophagales;Cyclobacteriaceae;Mongoliicoccus;Mongoliicoccus alkaliphilus	0	7	35	0	13	0	0	4	59
Bacteria;Bacteria_none;Proteobacteria;Alphaproteobacteria;Hyphomicrobiales;Hyphomicrobiaceae;Methylothermalis;Methylothermalis aethiopiae	11	14	9	18	4	2	0	1	59
Bacteria;Bacteria_none;Firmicutes;Bacilli;Lactobacillales;Streptococcaceae;Streptococcus;Streptococcus dentasini	47	1	2	5	1	0	1	2	59
Bacteria;Bacteria_none;Actinobacteria;Actinomycetia;Micrococcales;Microbacteriaceae;Leucobacter;Leucobacter luti	5	19	8	23	0	0	0	4	59
Bacteria;Bacteria_none;Firmicutes;Clostridia;Eubacteriales;Oscillospiraceae;Flavonifractor;Flavonifractor plautii	20	5	9	12	8	3	1	1	59
Bacteria;Bacteria_none;Proteobacteria;Alphaproteobacteria;Hyphomicrobiales;Xanthobacteraceae;Labrys;Labrys neptuniae	13	23	19	0	0	0	4	0	59
Bacteria;Bacteria_none;Proteobacteria;Betaproteobacteria;Burkholderiales;Comamonadaceae;Comamonas;Comamonas jiangduensis	18	2	11	5	7	13	0	3	59
Bacteria;Bacteria_none;Actinobacteria;Actinomycetia;Propionibacteriales;Propionibacteriaceae;Luteococcus;Luteococcus japonicus	30	2	7	17	2	0	0	1	59
Bacteria;Bacteria_none;Proteobacteria;Gammaproteobacteria;Moraxellales;Moraxellaceae;Acinetobacter;Acinetobacter kookii	42	0	3	9	0	1	1	3	59
Bacteria;Bacteria_none;Firmicutes;Bacilli;Lactobacillales;Streptococcaceae;Streptococcus;Streptococcus oricebi	44	8	1	4	0	1	0	1	59
Bacteria;Bacteria_none;Proteobacteria;Betaproteobacteria;Burkholderiales;Burkholderiaceae;Paraburkholderia;Paraburkholderia ginsengiterrae	37	10	6	1	1	0	1	2	58
Bacteria;Bacteria_none;Proteobacteria;Gammaproteobacteria;Moraxellales;Moraxellaceae;Acinetobacter;Acinetobacter septicus	30	7	4	13	2	2	0	0	58
Bacteria;Bacteria_none;Proteobacteria;Gammaproteobacteria;Moraxellales;Moraxellaceae;Acinetobacter;Acinetobacter johnsonii	41	0	4	9	0	0	0	4	58
Bacteria;Bacteria_none;Proteobacteria;Betaproteobacteria;Burkholderiales;Comamonadaceae;Delftia;Delftia lacustris	40	0	12	6	0	0	0	0	58
Bacteria;Bacteria_none;Proteobacteria;Betaproteobacteria;Burkholderiales;Comamonadaceae;Delftia;Delftia litopenaei	40	6	5	2	3	2	0	0	58
Bacteria;Bacteria_none;Proteobacteria;Gammaproteobacteria;Aeromonadales;Aeromonadaceae;Pseudaeromonas;Pseudaeromonas sharmana	7	3	24	8	8	4	2	2	58
Bacteria;Bacteria_none;Proteobacteria;Deltaproteobacteria;Desulfobacterales;Desulfobacteraceae;Desulfonema;Desulfonema limicola	2	29	8	10	0	1	0	8	58
Bacteria;Bacteria_none;Proteobacteria;Deltaproteobacteria;Desulfovibrionales;Desulfovibrionaceae;Desulfovibrio;Desulfovibrio dechloracetivorans	5	38	7	3	5	0	0	0	58
Bacteria;Bacteria_none;Firmicutes;Bacilli;Lactobacillales;Lactobacillaceae;Lactobacillus;Lactobacillus rogosae	7	7	12	12	5	6	7	2	58
Bacteria;Bacteria_none;Firmicutes;Clostridia;Eubacteriales;Clostridiaceae;Clostridium;Clostridium tetani	3	4	16	20	0	3	2	10	58
Bacteria;Bacteria_none;Firmicutes;Bacilli;Bacillales;Bacillaceae;Bacillus;Bacillus badius	0	2	40	6	3	4	1	2	58
Bacteria;Bacteria_none;Proteobacteria;Gammaproteobacteria;Legionellales;Legionellaceae;Legionella;Legionella jamestowniensis	8	15	9	12	3	8	1	1	57
Bacteria;Bacteria_none;Proteobacteria;Alphaproteobacteria;Rhodobacterales;Rhodobacteraceae;Paracoccus;Paracoccus luteus	16	13	11	8	0	5	2	2	57
Bacteria;Bacteria_none;Firmicutes;Bacilli;Bacillales;Paenibacillaceae;Paenibacillus;Paenibacillus apiarius	1	0	36	4	8	7	0	1	57
Bacteria;Bacteria_none;Firmicutes;Clostridia;Eubacteriales;Lachnospiraceae;Tyzzerella;[Clostridium] colinum	8	1	24	6	8	6	2	2	57
Bacteria;Bacteria_none;Bacteroidota;Flavobacteriia;Flavobacteriales;Flavobacteriaceae;Tamlana;Tamlana fucoidanivorans	0	3	20	10	4	16	4	0	57
Bacteria;Bacteria_none;Firmicutes;Clostridia;Eubacteriales;Clostridiaceae;Tindallia;Tindallia texcoconensis	1	4	34	6	7	5	0	0	57
Bacteria;Bacteria_none;Proteobacteria;Deltaproteobacteria;Desulfovibrionales;Desulfovibrionaceae;Desulfovibrio;Desulfovibrio oxyclinae	6	51	0	0	0	0	0	0	57
Bacteria;Bacteria_none;Proteobacteria;Alphaproteobacteria;Caulobacterales;Caulobacteraceae;Aquidulcibacter;Aquidulcibacter paucihalophilus	21	25	3	8	0	0	0	0	57
Bacteria;Bacteria_none;Firmicutes;Clostridia;Eubacteriales;Oscillospiraceae;Anaeromassilibacillus;Anaeromassilibacillus senegalensis	1	3	20	13	3	13	2	2	57
Bacteria;Bacteria_none;Proteobacteria;Alphaproteobacteria;Rhodospirillales;Rhodospirillaceae;Insolitispirillum;Insolitispirillum peregrinum	10	14	11	9	5	5	2	0	56
Bacteria;Bacteria_none;Firmicutes;Clostridia;Eubacteriales;Desulfitobacteriaceae;Desulfitobacterium;Desulfitobacterium dehalogenans	8	6	13	17	4	2	3	3	56
Bacteria;Bacteria_none;Firmicutes;Bacilli;Lactobacillales;Enterococcaceae;Enterococcus;Enterococcus hermanniensis	42	5	2	3	0	1	1	2	56
Bacteria;Bacteria_none;Proteobacteria;Alphaproteobacteria;Hyphomicrobiales;Hyphomicrobiaceae;Filomicrobium;Filomicrobium fusiforme	9	6	4	21	3	1	12	0	56
Bacteria;Bacteria_none;Firmicutes;Erysipelotrichia;Erysipelotrichales;Erysipelotrichaceae;Galactobacillus;Galactobacillus timonensis	0	0	32	13	1	4	5	1	56
Bacteria;Bacteria_none;Firmicutes;Clostridia;Eubacteriales;Oscillospiraceae;Phocea;Phocea massiliensis	21	5	1	13	5	1	3	7	56
Bacteria;Bacteria_none;Actinobacteria;Actinomycetia;Micrococcales;Intrasporangiaceae;Terrabacter;Terrabacter aerolatus	20	14	6	11	0	1	2	2	56
Bacteria;Bacteria_none;Firmicutes;Clostridia;Eubacteriales;Clostridiaceae;Senegalia;Senegalia massiliensis	1	3	23	2	8	18	0	1	56
Bacteria;Bacteria_none;Firmicutes;Bacilli;Lactobacillales;Streptococcaceae;Streptococcus;Streptococcus massiliensis	48	0	2	3	0	1	0	2	56
Bacteria;Bacteria_none;Actinobacteria;Actinomycetia;Micrococcales;Microbacteriaceae;Microbacterium;Microbacterium lacticum	1	12	16	21	1	1	1	3	56
Bacteria;Bacteria_none;Firmicutes;Clostridia;Eubacteriales;Caldicoprobacteraceae;Caldicoprobacter;Caldicoprobacter guelmensis	1	6	10	2	1	36	0	0	56
Bacteria;Bacteria_none;Actinobacteria;Actinomycetia;Propionibacteriales;Nocardioidaceae;Propionicimonas;Propionicimonas paludicola	5	14	17	10	1	4	2	3	56
Bacteria;Bacteria_none;Firmicutes;Bacilli;Lactobacillales;Streptococcaceae;Lactococcus;Lactococcus fujiensis	52	3	0	1	0	0	0	0	56
Bacteria;Bacteria_none;Firmicutes;Bacilli;Lactobacillales;Streptococcaceae;Streptococcus;Streptococcus varani	30	5	4	8	2	1	5	0	55
Bacteria;Bacteria_none;Bacteroidota;Bacteroidia;Marinilabiliales;Marinilabiliaceae;Carboxylicivirga;Carboxylicivirga flava	24	17	2	4	3	0	0	5	55
Bacteria;Bacteria_none;Proteobacteria;Deltaproteobacteria;Desulfovibrionales;Desulfovibrionaceae;Desulfovibrio;Desulfovibrio vulgaris	0	49	5	0	0	0	0	1	55
Bacteria;Bacteria_none;Proteobacteria;Alphaproteobacteria;Rhodobacterales;Rhodobacteraceae;Gemmobacter;Gemmobacter serpentinus	8	1	12	25	4	3	2	0	55
Bacteria;Bacteria_none;Proteobacteria;Alphaproteobacteria;Rhodobacterales;Rhodobacteraceae;Methylarcula;Methylarcula terricola	18	14	10	10	2	1	0	0	55
Bacteria;Bacteria_none;Cyanobacteria;Cyanobacteria_Incertae_sedis;Oscillatoriales;Microcoleaceae;Planktothrix;Planktothrix serta	0	0	36	0	8	0	0	11	55
Bacteria;Bacteria_none;Proteobacteria;Deltaproteobacteria;Desulfovibrionales;Desulfovibrionaceae;Desulfovibrio;Desulfovibrio desulfuricans	12	9	27	1	0	6	0	0	55
Bacteria;Bacteria_none;Proteobacteria;Alphaproteobacteria;Hyphomicrobiales;Phyllobacteriaceae;Tianweitania;Tianweitania sediminis	9	38	3	0	0	3	1	1	55
Bacteria;Bacteria_none;Proteobacteria;Alphaproteobacteria;Hyphomicrobiales;Rhizobiaceae;Agrobacterium;Agrobacterium salinitolerans	0	0	33	22	0	0	0	0	55
Bacteria;Bacteria_none;Proteobacteria;Alphaproteobacteria;Hyphomicrobiales;Phyllobacteriaceae;Mesorhizobium;Mesorhizobium hawassense	15	15	8	6	1	5	0	5	55
Bacteria;Bacteria_none;Proteobacteria;Betaproteobacteria;Burkholderiales;Oxalobacteraceae;Massilia;Massilia tieshanensis	35	5	5	4	2	1	1	2	55
Bacteria;Bacteria_none;Firmicutes;Clostridia;Halanaerobiales;Halobacteroidaceae;Acetohalobium;Acetohalobium arabaticum	2	4	27	11	7	2	0	2	55
Bacteria;Bacteria_none;Firmicutes;Bacilli;Bacillales;Bacillaceae;Pelagirhabdus;Pelagirhabdus fermentum	5	4	30	7	1	8	0	0	55
Bacteria;Bacteria_none;Firmicutes;Bacilli;Bacillales;Bacillales_Incertae_sedis;Exiguobacterium;Exiguobacterium acetylicum	0	0	41	5	7	1	0	0	54
Bacteria;Bacteria_none;Proteobacteria;Deltaproteobacteria;Desulfovibrionales;Desulfovibrionaceae;Pseudodesulfovibrio;Pseudodesulfovibrio aespoeensis	5	49	0	0	0	0	0	0	54
Bacteria;Bacteria_none;Proteobacteria;Alphaproteobacteria;Hyphomicrobiales;Nitrobacteraceae;Bradyrhizobium;Bradyrhizobium lablabi	0	30	0	0	0	24	0	0	54
Bacteria;Bacteria_none;Proteobacteria;Gammaproteobacteria;Xanthomonadales;Xanthomonadaceae;Lysobacter;Lysobacter oculi	7	8	12	18	1	7	0	1	54
Bacteria;Bacteria_none;Firmicutes;Clostridia;Eubacteriales;Lachnospiraceae;Lachnoclostridium;[Clostridium] polysaccharolyticum	8	42	1	2	1	0	0	0	54
Bacteria;Bacteria_none;Proteobacteria;Alphaproteobacteria;Hyphomicrobiales;Kaistiaceae;Kaistia;Kaistia soli	19	7	7	9	6	5	1	0	54
Bacteria;Bacteria_none;Proteobacteria;Gammaproteobacteria;Enterobacterales;Enterobacteriaceae;Kluyvera;Kluyvera sichuanensis	42	4	0	8	0	0	0	0	54
Bacteria;Bacteria_none;Bacteroidota;Bacteroidia;Marinilabiliales;Prolixibacteraceae;Meniscus;Meniscus glaucopis	8	39	3	2	0	0	0	2	54
Bacteria;Bacteria_none;Firmicutes;Clostridia;Eubacteriales;Lachnospiraceae;Mediterraneibacter;[Ruminococcus] torques	40	6	0	5	0	1	1	1	54
Bacteria;Bacteria_none;Proteobacteria;Alphaproteobacteria;Hyphomicrobiales;Rhizobiaceae;Rhizobium;Rhizobium lemnae	19	14	8	9	1	2	1	0	54
Bacteria;Bacteria_none;Actinobacteria;Actinomycetia;Actinomycetales;Actinomycetaceae;Boudabousia;Boudabousia marimammalium	21	9	8	10	0	4	1	1	54
Bacteria;Bacteria_none;Bacteroidota;Bacteroidia;Bacteroidales;Tannerellaceae;Parabacteroides;Parabacteroides distasonis	2	4	2	21	1	2	1	21	54
Bacteria;Bacteria_none;Proteobacteria;Deltaproteobacteria;Desulfuromonadales;Geobacteraceae;Geobacter;Geobacter chapellei	24	24	0	5	0	0	0	0	53
Bacteria;Bacteria_none;Chloroflexi;Ktedonobacteria;Thermogemmatisporales;Thermogemmatisporaceae;Thermogemmatispora;Thermogemmatispora aurantia	0	30	17	0	0	0	0	6	53
Bacteria;Bacteria_none;Proteobacteria;Alphaproteobacteria;Hyphomicrobiales;Rhizobiaceae;Rhizobium;Rhizobium cremeum	11	25	5	7	3	2	0	0	53
Bacteria;Bacteria_none;Bacteroidota;Cytophagia;Cytophagales;Fulvivirgaceae;Fulvivirga;Fulvivirga kasyanovii	4	12	8	23	0	2	1	3	53
Bacteria;Bacteria_none;Firmicutes;Clostridia;Eubacteriales;Lachnospiraceae;Mediterraneibacter;[Ruminococcus] gnavus	17	11	1	7	1	11	3	2	53
Bacteria;Bacteria_none;Proteobacteria;Alphaproteobacteria;Rhodobacterales;Rhodobacteraceae;Paracoccus;Paracoccus methylutens	23	4	4	9	2	6	3	2	53
Bacteria;Bacteria_none;Firmicutes;Clostridia;Eubacteriales;Oscillospiraceae;Massiliimalia;Massiliimalia massiliensis	5	31	13	0	0	3	0	1	53
Bacteria;Bacteria_none;Proteobacteria;Alphaproteobacteria;Hyphomicrobiales;Chelatococcaceae;Camelimonas;Camelimonas fluminis	10	5	20	11	0	2	4	1	53
Bacteria;Bacteria_none;Proteobacteria;Alphaproteobacteria;Rhodobacterales;Rhodobacteraceae;Falsirhodobacter;Falsirhodobacter deserti	19	4	11	13	4	0	1	0	52
Bacteria;Bacteria_none;Firmicutes;Clostridia;Eubacteriales;Oscillospiraceae;Massiliimalia;Massiliimalia timonensis	5	5	16	6	4	10	6	0	52
Bacteria;Bacteria_none;Actinobacteria;Actinomycetia;Corynebacteriales;Nocardiaceae;Nocardia;Nocardia exalbida	0	3	12	33	3	1	0	0	52
Bacteria;Bacteria_none;Proteobacteria;Deltaproteobacteria;Desulfovibrionales;Desulfovibrionaceae;Desulfovibrio;Desulfovibrio intestinalis	10	20	18	4	0	0	0	0	52
Bacteria;Bacteria_none;Planctomycetota;Planctomycetia;Isosphaerales;Isosphaeraceae;Tautonia;Tautonia plasticadhaerens	16	17	3	11	3	0	0	2	52
Bacteria;Bacteria_none;Proteobacteria;Gammaproteobacteria;Enterobacterales;Enterobacteriaceae;Enterobacter;Enterobacter mori	49	0	0	2	1	0	0	0	52
Bacteria;Bacteria_none;Actinobacteria;Actinomycetia;Streptomycetales;Streptomycetaceae;Streptomyces;Streptomyces coeruleofuscus	1	14	5	25	0	5	1	1	52
Bacteria;Bacteria_none;Actinobacteria;Actinomycetia;Streptomycetales;Streptomycetaceae;Streptomyces;Streptomyces rectiverticillatus	7	11	3	23	5	3	0	0	52
Bacteria;Bacteria_none;Proteobacteria;Alphaproteobacteria;Hyphomicrobiales;Beijerinckiaceae;Rhodoblastus;Rhodoblastus sphagnicola	10	8	17	11	1	3	2	0	52
Bacteria;Bacteria_none;Proteobacteria;Alphaproteobacteria;Hyphomicrobiales;Kaistiaceae;Kaistia;Kaistia geumhonensis	14	12	7	10	2	2	3	2	52
Bacteria;Bacteria_none;Firmicutes;Clostridia;Eubacteriales;Lachnospiraceae;Lachnoclostridium;Lachnoclostridium pacaense	3	43	4	0	2	0	0	0	52
Bacteria;Bacteria_none;Proteobacteria;Alphaproteobacteria;Hyphomicrobiales;Hyphomicrobiaceae;Rhodoplanes;Rhodoplanes oryzae	7	24	13	8	0	0	0	0	52
Bacteria;Bacteria_none;Firmicutes;Erysipelotrichia;Erysipelotrichales;Coprobacillaceae;Catenibacterium;Catenibacterium mitsuokai	34	5	9	2	0	1	0	1	52
Bacteria;Bacteria_none;Firmicutes;Bacilli;Bacillales;Paenibacillaceae;Cohnella;Cohnella algarum	0	1	46	0	2	2	1	0	52
Bacteria;Bacteria_none;Proteobacteria;Gammaproteobacteria;Enterobacterales;Pectobacteriaceae;Brenneria;Brenneria rubrifaciens	38	2	2	4	1	0	1	3	51
Bacteria;Bacteria_none;Bacteroidota;Sphingobacteriia;Sphingobacteriales;Sphingobacteriaceae;Anseongella;Anseongella ginsenosidimutans	34	3	4	5	0	1	0	4	51
Bacteria;Bacteria_none;Proteobacteria;Gammaproteobacteria;Aeromonadales;Aeromonadaceae;Aeromonas;Aeromonas hydrophila	11	20	6	4	4	0	3	3	51
Bacteria;Bacteria_none;Firmicutes;Bacilli;Lactobacillales;Streptococcaceae;Streptococcus;Streptococcus agalactiae	40	4	2	1	0	1	1	2	51
Bacteria;Bacteria_none;Firmicutes;Clostridia;Eubacteriales;Oscillospiraceae;Hydrogeniiclostridium;Hydrogeniiclostridium mannosilyticum	6	27	7	3	2	4	2	0	51
Bacteria;Bacteria_none;Firmicutes;Negativicutes;Selenomonadales;Selenomonadaceae;Selenomonas;Selenomonas ruminantium	0	6	0	22	3	2	3	15	51
Bacteria;Bacteria_none;Firmicutes;Bacilli;Bacillales;Paenibacillaceae;Cohnella;Cohnella fontinalis	4	10	25	3	7	0	1	1	51
Bacteria;Bacteria_none;Proteobacteria;Alphaproteobacteria;Sphingomonadales;Sphingomonadaceae;Sphingorhabdus;Sphingorhabdus pulchriflava	26	22	0	0	3	0	0	0	51
Bacteria;Bacteria_none;Bacteroidota;Bacteroidia;Bacteroidales;Bacteroidaceae;Phocaeicola;Phocaeicola abscessus	2	4	10	27	2	1	3	2	51
Bacteria;Bacteria_none;Proteobacteria;Betaproteobacteria;Burkholderiales;Burkholderiaceae;Zeimonas;Zeimonas arvi	24	10	7	3	0	6	0	1	51
Bacteria;Bacteria_none;Actinobacteria;Coriobacteriia;Eggerthellales;Eggerthellaceae;Slackia;Slackia isoflavoniconvertens	3	42	4	0	2	0	0	0	51
Bacteria;Bacteria_none;Firmicutes;Clostridia;Eubacteriales;Oscillospiraceae;Caproicibacterium;Caproicibacterium amylolyticum	4	19	10	3	5	5	1	4	51
Bacteria;Bacteria_none;Firmicutes;Clostridia;Eubacteriales;Lachnospiraceae;Hespellia;Hespellia stercorisuis	23	6	3	8	2	6	1	2	51
Bacteria;Bacteria_none;Proteobacteria;Alphaproteobacteria;Rhodospirillales;Acetobacteraceae;Roseomonas;Roseomonas terrae	11	3	13	17	2	2	2	1	51
Bacteria;Bacteria_none;Actinobacteria;Actinomycetia;Micrococcales;Microbacteriaceae;Leucobacter;Leucobacter denitrificans	8	8	14	16	0	3	0	1	50
Bacteria;Bacteria_none;Actinobacteria;Actinomycetia;Corynebacteriales;Mycobacteriaceae;Mycolicibacterium;Mycolicibacterium peregrinum	9	14	15	6	6	0	0	0	50
Bacteria;Bacteria_none;Firmicutes;Clostridia;Eubacteriales;Peptostreptococcaceae;Clostridioides;Clostridioides mangenotii	7	5	16	8	1	4	6	3	50
Bacteria;Bacteria_none;Firmicutes;Bacilli;Lactobacillales;Lactobacillaceae;Leuconostoc;Leuconostoc citreum	29	5	1	6	1	1	4	3	50
Bacteria;Bacteria_none;Actinobacteria;Actinomycetia;Streptomycetales;Streptomycetaceae;Kitasatospora;Kitasatospora azatica	3	7	10	26	1	2	1	0	50
Bacteria;Bacteria_none;Synergistetes;Synergistia;Synergistales;Synergistaceae;Aminiphilus;Aminiphilus circumscriptus	0	34	11	1	1	3	0	0	50
Bacteria;Bacteria_none;Proteobacteria;Epsilonproteobacteria;Campylobacterales;Helicobacteraceae;Helicobacter;Helicobacter canis	0	0	45	0	0	0	0	5	50
Bacteria;Bacteria_none;Firmicutes;Clostridia;Eubacteriales;Clostridiaceae;Clostridium;Clostridium septicum	2	3	1	37	2	1	4	0	50
Bacteria;Bacteria_none;Firmicutes;Clostridia;Eubacteriales;Lachnospiraceae;Blautia;Blautia faecicola	40	1	4	2	0	0	3	0	50
Bacteria;Bacteria_none;Firmicutes;Bacilli;Bacillales;Bacillaceae;Anaerobacillus;Anaerobacillus arseniciselenatis	1	5	17	6	7	12	1	1	50
Bacteria;Bacteria_none;Proteobacteria;Alphaproteobacteria;Rhodobacterales;Rhodobacteraceae;Paracoccus;Paracoccus mangrovi	13	15	5	12	2	2	1	0	50
Bacteria;Bacteria_none;Proteobacteria;Gammaproteobacteria;Moraxellales;Moraxellaceae;Acinetobacter;Acinetobacter rudis	33	2	2	11	1	0	0	1	50
Bacteria;Bacteria_none;Proteobacteria;Betaproteobacteria;Burkholderiales;Burkholderiaceae;Lautropia;Lautropia dentalis	19	13	5	3	4	3	0	3	50
Bacteria;Bacteria_none;Proteobacteria;Gammaproteobacteria;Xanthomonadales;Xanthomonadaceae;Thermomonas;Thermomonas haemolytica	21	4	2	14	2	3	4	0	50
Bacteria;Bacteria_none;Proteobacteria;Betaproteobacteria;Burkholderiales;Burkholderiaceae;Cupriavidus;Cupriavidus necator	37	10	0	0	0	0	3	0	50
Bacteria;Bacteria_none;Firmicutes;Bacilli;Lactobacillales;Carnobacteriaceae;Trichococcus;Trichococcus ilyis	40	6	1	0	0	2	1	0	50
Bacteria;Bacteria_none;Firmicutes;Clostridia;Eubacteriales;Clostridiaceae;Thermotalea;Thermotalea metallivorans	0	1	34	4	5	6	0	0	50
Bacteria;Bacteria_none;Proteobacteria;Alphaproteobacteria;Rhodospirillales;Rhodospirillaceae;Aliidongia;Aliidongia dinghuensis	7	41	1	0	0	1	0	0	50
Bacteria;Bacteria_none;Firmicutes;Clostridia;Eubacteriales;Oscillospiraceae;Pseudoflavonifractor;Pseudoflavonifractor phocaeensis	4	6	20	6	5	3	4	2	50
Bacteria;Bacteria_none;Bacteroidota;Chitinophagia;Chitinophagales;Chitinophagaceae;Ferruginibacter;Ferruginibacter profundus	39	6	1	1	0	2	0	1	50
Bacteria;Bacteria_none;Proteobacteria;Deltaproteobacteria;Desulfuromonadales;Geobacteraceae;Geobacter;Geobacter sulfurreducens	10	2	36	2	0	0	0	0	50
Bacteria;Bacteria_none;Firmicutes;Clostridia;Eubacteriales;Eubacteriales Family XIII. Incertae Sedis;Hornefia;Hornefia butyriciproducens	0	0	1	17	0	1	2	28	49
Bacteria;Bacteria_none;Firmicutes;Bacilli;Bacillales;Bacillaceae;Niallia;Niallia circulans	1	7	16	16	4	4	1	0	49
Bacteria;Bacteria_none;Actinobacteria;Actinomycetia;Micrococcales;Microbacteriaceae;Agromyces;Agromyces fucosus	0	16	8	17	0	4	1	3	49
Bacteria;Bacteria_none;Actinobacteria;Actinomycetia;Kineosporiales;Kineosporiaceae;Kineosporia;Kineosporia rhizophila	9	22	7	9	1	1	0	0	49
Bacteria;Bacteria_none;Firmicutes;Clostridia;Eubacteriales;Lachnospiraceae;Diplocloster;Diplocloster modestus	2	5	13	24	5	0	0	0	49
Bacteria;Bacteria_none;Proteobacteria;Betaproteobacteria;Burkholderiales;Alcaligenaceae;Alcaligenes;Alcaligenes faecalis	18	4	22	2	0	1	0	2	49
Bacteria;Bacteria_none;Firmicutes;Clostridia;Eubacteriales;Eubacteriaceae;Eubacterium;Eubacterium limosum	6	20	0	16	4	3	0	0	49
Bacteria;Bacteria_none;Firmicutes;Bacilli;Bacillales;Staphylococcaceae;Salinicoccus;Salinicoccus amylolyticus	5	7	3	16	2	11	4	1	49
Bacteria;Bacteria_none;Proteobacteria;Alphaproteobacteria;Rhodobacterales;Roseobacteraceae;Roseovarius;Roseovarius lacus	3	23	7	10	1	2	2	1	49
Bacteria;Bacteria_none;Firmicutes;Clostridia;Eubacteriales;Clostridiaceae;Clostridium;Clostridium gasigenes	13	7	6	11	0	4	6	2	49
Bacteria;Bacteria_none;Firmicutes;Clostridia;Eubacteriales;Peptostreptococcaceae;Peptostreptococcus;Peptostreptococcus porci	2	46	1	0	0	0	0	0	49
Bacteria;Bacteria_none;Proteobacteria;Gammaproteobacteria;Aeromonadales;Aeromonadaceae;Aeromonas;Aeromonas eucrenophila	0	23	0	26	0	0	0	0	49
Bacteria;Bacteria_none;Proteobacteria;Deltaproteobacteria;Myxococcales;Phaselicystidaceae;Phaselicystis;Phaselicystis flava	36	0	1	11	0	0	0	1	49
Bacteria;Bacteria_none;Firmicutes;Bacilli;Lactobacillales;Lactobacillaceae;Limosilactobacillus;Limosilactobacillus reuteri	21	23	1	3	1	0	0	0	49
Bacteria;Bacteria_none;Firmicutes;Bacilli;Lactobacillales;Streptococcaceae;Streptococcus;Streptococcus canis	35	3	3	5	0	0	2	1	49
Bacteria;Bacteria_none;Proteobacteria;Gammaproteobacteria;Xanthomonadales;Rhodanobacteraceae;Dokdonella;Dokdonella soli	18	4	8	11	0	3	2	3	49
Bacteria;Bacteria_none;Actinobacteria;Acidimicrobiia;Acidimicrobiales;Ilumatobacteraceae;Desertimonas;Desertimonas flava	8	18	12	3	1	5	1	0	48
Bacteria;Bacteria_none;Actinobacteria;Actinomycetia;Corynebacteriales;Corynebacteriaceae;Corynebacterium;Corynebacterium jeikeium	1	9	10	15	1	5	4	3	48
Bacteria;Bacteria_none;Proteobacteria;Alphaproteobacteria;Hyphomicrobiales;Methylocystaceae;Methylocystis;Methylocystis parvus	7	7	13	8	0	8	0	5	48
Bacteria;Bacteria_none;Proteobacteria;Deltaproteobacteria;Desulfovibrionales;Desulfovibrionaceae;Lawsonia;Lawsonia intracellularis	28	18	1	1	0	0	0	0	48
Bacteria;Bacteria_none;Proteobacteria;Betaproteobacteria;Neisseriales;Neisseriaceae;Conchiformibius;Conchiformibius steedae	34	3	3	5	0	1	1	1	48
Bacteria;Bacteria_none;Firmicutes;Clostridia;Eubacteriales;Syntrophomonadaceae;Pelospora;Pelospora glutarica	18	2	18	0	3	7	0	0	48
Bacteria;Bacteria_none;Bacteroidota;Bacteroidia;Bacteroidales;Muribaculaceae;Paramuribaculum;Paramuribaculum intestinale	0	1	1	22	2	6	4	12	48
Bacteria;Bacteria_none;Firmicutes;Clostridia;Eubacteriales;Syntrophomonadaceae;Syntrophomonas;Syntrophomonas erecta	0	1	40	4	2	0	1	0	48
Bacteria;Bacteria_none;Firmicutes;Clostridia;Eubacteriales;Clostridiaceae;Clostridium;Clostridium chromiireducens	2	15	9	15	0	2	2	3	48
Bacteria;Bacteria_none;Proteobacteria;Alphaproteobacteria;Hyphomicrobiales;Phyllobacteriaceae;Aquibium;Aquibium oceanicum	21	8	8	5	1	4	1	0	48
Bacteria;Bacteria_none;Bacteroidota;Saprospiria;Saprospirales;Haliscomenobacteraceae;Portibacter;Portibacter lacus	34	7	1	2	1	3	0	0	48
Bacteria;Bacteria_none;Firmicutes;Bacilli;Lactobacillales;Lactobacillaceae;Lacticaseibacillus;Lacticaseibacillus paracasei	25	7	6	5	2	2	0	1	48
Bacteria;Bacteria_none;Actinobacteria;Actinomycetia;Propionibacteriales;Propionibacteriaceae;Acidipropionibacterium;Acidipropionibacterium damnosum	14	0	0	34	0	0	0	0	48
Bacteria;Bacteria_none;Firmicutes;Clostridia;Eubacteriales;Lachnospiraceae;Pseudobutyrivibrio;Pseudobutyrivibrio xylanivorans	9	7	12	11	1	6	2	0	48
Bacteria;Bacteria_none;Bacteroidota;Chitinophagia;Chitinophagales;Chitinophagaceae;Flavisolibacter;Flavisolibacter ginsengiterrae	39	7	0	2	0	0	0	0	48
Bacteria;Bacteria_none;Proteobacteria;Gammaproteobacteria;Enterobacterales;Erwiniaceae;Rosenbergiella;Rosenbergiella nectarea	42	0	0	4	0	0	1	1	48
Bacteria;Bacteria_none;Proteobacteria;Alphaproteobacteria;Rhodobacterales;Rhodobacteraceae;Meinhardsimonia;Meinhardsimonia xiamenensis	22	10	6	6	1	1	1	1	48
Bacteria;Bacteria_none;Firmicutes;Bacilli;Bacillales;Paenibacillaceae;Paenibacillus;Paenibacillus dendritiformis	0	0	23	8	6	10	0	0	47
Bacteria;Bacteria_none;Actinobacteria;Acidimicrobiia;Acidimicrobiales;Iamiaceae;Actinomarinicola;Actinomarinicola tropica	20	16	4	4	2	0	1	0	47
Bacteria;Bacteria_none;Verrucomicrobia;Opitutae;Opitutales;Opitutaceae;Rariglobus;Rariglobus hedericola	5	0	33	0	6	0	0	3	47
Bacteria;Bacteria_none;Bacteroidota;Bacteroidia;Bacteroidales;Prevotellaceae;Prevotella;Prevotella phocaeensis	0	31	0	6	1	2	7	0	47
Bacteria;Bacteria_none;Proteobacteria;Gammaproteobacteria;Xanthomonadales;Xanthomonadaceae;Pseudolysobacter;Pseudolysobacter antarcticus	42	2	1	0	1	0	1	0	47
Bacteria;Bacteria_none;Bacteroidota;Bacteroidia;Marinilabiliales;Marinilabiliaceae;Anaerophaga;Anaerophaga thermohalophila	6	40	0	0	0	1	0	0	47
Bacteria;Bacteria_none;Proteobacteria;Gammaproteobacteria;Xanthomonadales;Xanthomonadaceae;Lysobacter;Lysobacter chengduensis	9	7	6	20	1	2	2	0	47
Bacteria;Bacteria_none;Firmicutes;Bacilli;Lactobacillales;Streptococcaceae;Streptococcus;Streptococcus henryi	42	3	0	1	1	0	0	0	47
Bacteria;Bacteria_none;Proteobacteria;Alphaproteobacteria;Rhodobacterales;Rhodobacteraceae;Frigidibacter;Frigidibacter albus	14	18	7	8	0	0	0	0	47
Bacteria;Bacteria_none;Firmicutes;Clostridia;Eubacteriales;Oscillospiraceae;Oscillospiraceae_Incertae_sedis;[Clostridium] sporosphaeroides	6	10	13	6	6	2	3	1	47
Bacteria;Bacteria_none;Proteobacteria;Betaproteobacteria;Burkholderiales;Oxalobacteraceae;Duganella;Duganella phyllosphaerae	26	16	0	1	2	1	0	1	47
Bacteria;Bacteria_none;Proteobacteria;Alphaproteobacteria;Hyphomicrobiales;Phyllobacteriaceae;Mesorhizobium;Mesorhizobium sediminum	8	16	8	7	0	8	0	0	47
Bacteria;Bacteria_none;Firmicutes;Clostridia;Eubacteriales;Eubacteriales_Incertae_sedis;Proteiniborus;Proteiniborus indolifex	0	0	39	0	0	8	0	0	47
Bacteria;Bacteria_none;Proteobacteria;Alphaproteobacteria;Hyphomicrobiales;Nitrobacteraceae;Rhodopseudomonas;Rhodopseudomonas palustris	12	4	13	13	2	1	2	0	47
Bacteria;Bacteria_none;Firmicutes;Bacilli;Lactobacillales;Enterococcaceae;Vagococcus;Vagococcus hydrophili	10	33	0	3	1	0	0	0	47
Bacteria;Bacteria_none;Firmicutes;Clostridia;Eubacteriales;Eubacteriaceae;Acetobacterium;Acetobacterium bakii	15	7	7	16	1	1	0	0	47
Bacteria;Bacteria_none;Spirochaetes;Spirochaetia;Spirochaetales;Spirochaetaceae;Oceanispirochaeta;Oceanispirochaeta sediminicola	0	16	24	0	7	0	0	0	47
Bacteria;Bacteria_none;Proteobacteria;Alphaproteobacteria;Rhodobacterales;Rhodobacteraceae;Pseudothioclava;Pseudothioclava arenosa	11	12	7	11	3	2	0	1	47
Bacteria;Bacteria_none;Actinobacteria;Actinomycetia;Propionibacteriales;Propionibacteriaceae;Propioniciclava;Propioniciclava soli	11	9	4	19	1	1	1	1	47
Bacteria;Bacteria_none;Proteobacteria;Betaproteobacteria;Burkholderiales;Comamonadaceae;Hydrogenophaga;Hydrogenophaga luteola	34	5	3	0	0	1	3	1	47
Bacteria;Bacteria_none;Deinococcus-Thermus;Deinococci;Deinococcales;Deinococcaceae;Deinococcus;Deinococcus aquaedulcis	1	15	6	15	3	1	5	1	47
Bacteria;Bacteria_none;Proteobacteria;Alphaproteobacteria;Caulobacterales;Caulobacteraceae;Brevundimonas;Brevundimonas vitisensis	21	18	2	3	0	1	2	0	47
Bacteria;Bacteria_none;Rhodothermaeota;Rhodothermia;Rhodothermales;Salinibacteraceae;Salinivenus;Salinivenus iranica	2	11	9	18	0	0	3	4	47
Bacteria;Bacteria_none;Firmicutes;Clostridia;Eubacteriales;Heliobacteriaceae;Heliorestis;Heliorestis baculata	1	14	24	0	3	1	2	1	46
Bacteria;Bacteria_none;Proteobacteria;Gammaproteobacteria;Gammaproteobacteria_Incertae_sedis;Candidatus Competibacteraceae;Plasticicumulans;Plasticicumulans acidivorans	34	9	2	0	1	0	0	0	46
Bacteria;Bacteria_none;Proteobacteria;Betaproteobacteria;Burkholderiales;Comamonadaceae;Diaphorobacter;Diaphorobacter nitroreducens	31	11	1	0	0	2	0	1	46
Bacteria;Bacteria_none;Proteobacteria;Alphaproteobacteria;Rhodospirillales;Rhodospirillaceae;Dongia;Dongia rigui	25	3	4	11	0	2	0	1	46
Bacteria;Bacteria_none;Proteobacteria;Alphaproteobacteria;Hyphomicrobiales;Phyllobacteriaceae;Mesorhizobium;Mesorhizobium soli	13	11	9	5	5	3	0	0	46
Bacteria;Bacteria_none;Proteobacteria;Alphaproteobacteria;Hyphomicrobiales;Beijerinckiaceae;Rhodoblastus;Rhodoblastus acidophilus	9	6	11	14	1	3	2	0	46
Bacteria;Bacteria_none;Proteobacteria;Gammaproteobacteria;Enterobacterales;Yersiniaceae;Rahnella;Rahnella contaminans	46	0	0	0	0	0	0	0	46
Bacteria;Bacteria_none;Firmicutes;Clostridia;Thermoanaerobacterales;Thermoanaerobacteraceae;Moorella;Moorella humiferrea	0	0	28	15	0	2	1	0	46
Bacteria;Bacteria_none;Proteobacteria;Betaproteobacteria;Burkholderiales;Burkholderiaceae;Paraburkholderia;Paraburkholderia hospita	31	10	0	0	0	5	0	0	46
Bacteria;Bacteria_none;Proteobacteria;Gammaproteobacteria;Chromatiales;Ectothiorhodospiraceae;Thiorhodospira;Thiorhodospira sibirica	8	12	9	12	0	0	2	3	46
Bacteria;Bacteria_none;Proteobacteria;Gammaproteobacteria;Legionellales;Coxiellaceae;Coxiella;Coxiella cheraxi	15	9	8	3	3	6	2	0	46
Bacteria;Bacteria_none;Proteobacteria;Alphaproteobacteria;Holosporales;Holosporaceae;Holospora;Holospora caryophila	13	4	11	14	1	1	0	2	46
Bacteria;Bacteria_none;Proteobacteria;Gammaproteobacteria;Legionellales;Legionellaceae;Legionella;Legionella tunisiensis	8	2	6	22	1	5	1	1	46
Bacteria;Bacteria_none;Proteobacteria;Alphaproteobacteria;Hyphomicrobiales;Methylocystaceae;Albibacter;Albibacter helveticus	15	14	5	6	1	5	0	0	46
Bacteria;Bacteria_none;Bacteroidota;Bacteroidia;Bacteroidales;Balneicellaceae;Balneicella;Balneicella halophila	0	5	20	11	1	4	0	5	46
Bacteria;Bacteria_none;Proteobacteria;Betaproteobacteria;Burkholderiales;Burkholderiaceae;Mycetohabitans;Mycetohabitans rhizoxinica	20	12	4	4	0	4	1	1	46
Bacteria;Bacteria_none;Actinobacteria;Actinomycetia;Streptomycetales;Streptomycetaceae;Streptacidiphilus;Streptacidiphilus jiangxiensis	0	8	18	9	3	6	0	2	46
Bacteria;Bacteria_none;Firmicutes;Clostridia;Eubacteriales;Eubacteriales Family XIII. Incertae Sedis;Ihubacter;Ihubacter massiliensis	8	19	13	2	1	3	0	0	46
Bacteria;Bacteria_none;Actinobacteria;Actinomycetia;Micrococcales;Micrococcaceae;Sinomonas;Sinomonas halotolerans	0	3	19	13	7	0	3	1	46
Bacteria;Bacteria_none;Firmicutes;Bacilli;Bacillales;Sporolactobacillaceae;Sinobaca;Sinobaca qinghaiensis	0	4	20	7	1	12	1	1	46
Bacteria;Bacteria_none;Firmicutes;Bacilli;Bacillales;Paenibacillaceae;Paenibacillus;Paenibacillus lutrae	6	13	9	9	3	3	2	0	45
Bacteria;Bacteria_none;Bacteroidota;Bacteroidia;Bacteroidales;Prevotellaceae;Prevotella;Prevotella colorans	4	40	1	0	0	0	0	0	45
Bacteria;Bacteria_none;Firmicutes;Bacilli;Lactobacillales;Enterococcaceae;Enterococcus;Enterococcus malodoratus	34	5	2	3	0	1	0	0	45
Bacteria;Bacteria_none;Proteobacteria;Alphaproteobacteria;Hyphomicrobiales;Rhizobiaceae;Xaviernesmea;Xaviernesmea rhizosphaerae	7	17	6	10	1	1	3	0	45
Bacteria;Bacteria_none;Proteobacteria;Gammaproteobacteria;Xanthomonadales;Xanthomonadaceae;Xanthomonas;Xanthomonas citri	12	8	10	10	0	0	4	1	45
Bacteria;Bacteria_none;Proteobacteria;Alphaproteobacteria;Hyphomicrobiales;Rhodobiaceae;Rhodobium;Rhodobium gokarnense	10	12	9	12	0	1	1	0	45
Bacteria;Bacteria_none;Proteobacteria;Alphaproteobacteria;Hyphomicrobiales;Xanthobacteraceae;Labrys;Labrys methylaminiphilus	24	11	0	10	0	0	0	0	45
Bacteria;Bacteria_none;Proteobacteria;Alphaproteobacteria;Rhodospirillales;Acetobacteraceae;Falsiroseomonas;Falsiroseomonas selenitidurans	16	8	10	7	2	1	1	0	45
Bacteria;Bacteria_none;Firmicutes;Clostridia;Eubacteriales;Clostridiaceae;Clostridium;Clostridium polynesiense	5	5	6	16	3	4	5	1	45
Bacteria;Bacteria_none;Proteobacteria;Alphaproteobacteria;Rhodospirillales;Rhodospirillaceae;Hypericibacter;Hypericibacter terrae	13	12	7	5	3	5	0	0	45
Bacteria;Bacteria_none;Proteobacteria;Betaproteobacteria;Nitrosomonadales;Nitrosomonadaceae;Nitrosomonas;Nitrosomonas nitrosa	41	1	1	0	1	1	0	0	45
Bacteria;Bacteria_none;Proteobacteria;Gammaproteobacteria;Alteromonadales;Pseudoalteromonadaceae;Pseudoalteromonas;Pseudoalteromonas phenolica	8	20	4	8	1	3	1	0	45
Bacteria;Bacteria_none;Proteobacteria;Alphaproteobacteria;Hyphomicrobiales;Devosiaceae;Devosia;Devosia mishustinii	8	6	5	18	4	4	0	0	45
Bacteria;Bacteria_none;Proteobacteria;Alphaproteobacteria;Hyphomicrobiales;Beijerinckiaceae;Beijerinckia;Beijerinckia mobilis	8	25	7	4	0	1	0	0	45
Bacteria;Bacteria_none;Proteobacteria;Alphaproteobacteria;Hyphomicrobiales;Alsobacteraceae;Alsobacter;Alsobacter metallidurans	20	16	6	2	0	1	0	0	45
Bacteria;Bacteria_none;Proteobacteria;Betaproteobacteria;Burkholderiales;Comamonadaceae;Lampropedia;Lampropedia cohaerens	28	7	6	2	1	1	0	0	45
Bacteria;Bacteria_none;Firmicutes;Clostridia;Eubacteriales;Peptostreptococcaceae;Acetoanaerobium;Acetoanaerobium pronyense	25	8	6	0	2	3	1	0	45
Bacteria;Bacteria_none;Cyanobacteria;Cyanobacteria_Incertae_sedis;Oscillatoriales;Cyanothecaceae;Cyanothece;Cyanothece aeruginosa	7	6	20	9	0	1	2	0	45
Bacteria;Bacteria_none;Firmicutes;Bacilli;Bacillales;Bacillaceae;Sutcliffiella;Sutcliffiella zhanjiangensis	0	0	33	7	0	0	1	4	45
Bacteria;Bacteria_none;Bacteroidota;Saprospiria;Saprospirales;Haliscomenobacteraceae;Haliscomenobacter;Haliscomenobacter hydrossis	37	7	0	0	0	0	0	1	45
Bacteria;Bacteria_none;Bacteroidota;Flavobacteriia;Flavobacteriales;Weeksellaceae;Kaistella;Kaistella solincola	0	2	6	27	0	2	4	4	45
Bacteria;Bacteria_none;Firmicutes;Clostridia;Eubacteriales;Symbiobacteriaceae;Caldinitratiruptor;Caldinitratiruptor microaerophilus	0	2	26	9	1	5	2	0	45
Bacteria;Bacteria_none;Fusobacteria;Fusobacteriia;Fusobacteriales;Leptotrichiaceae;Sebaldella;Sebaldella termitidis	31	2	3	2	2	3	1	1	45
Bacteria;Bacteria_none;Proteobacteria;Alphaproteobacteria;Hyphomicrobiales;Rhizobiaceae;Rhizobium;Rhizobium leguminosarum	11	18	7	7	1	0	1	0	45
Bacteria;Bacteria_none;Firmicutes;Clostridia;Eubacteriales;Clostridiaceae;Clostridium;Clostridium hydrogeniproducens	0	15	8	17	2	2	1	0	45
Bacteria;Bacteria_none;Planctomycetota;Planctomycetia;Pirellulales;Pirellulaceae;Rubripirellula;Rubripirellula tenax	0	0	13	24	2	1	0	4	44
Bacteria;Bacteria_none;Bacteroidota;Bacteroidia;Bacteroidales;Bacteroidaceae;Bacteroides;Bacteroides uniformis	6	6	5	12	0	13	0	2	44
Bacteria;Bacteria_none;Firmicutes;Bacilli;Lactobacillales;Streptococcaceae;Streptococcus;Streptococcus sanguinis	32	9	1	1	0	0	1	0	44
Bacteria;Bacteria_none;Firmicutes;Clostridia;Eubacteriales;Peptococcaceae;Paradesulfitobacterium;Paradesulfitobacterium ferrireducens	0	1	27	1	6	9	0	0	44
Bacteria;Bacteria_none;Proteobacteria;Gammaproteobacteria;Enterobacterales;Enterobacteriaceae;Enterobacter;Enterobacter chuandaensis	34	1	0	6	0	0	3	0	44
Bacteria;Bacteria_none;Actinobacteria;Actinomycetia;Streptosporangiales;Nocardiopsaceae;Thermobifida;Thermobifida fusca	6	7	6	14	2	5	2	2	44
Bacteria;Bacteria_none;Firmicutes;Bacilli;Bacillales;Bacillales_Incertae_sedis;Exiguobacterium;Exiguobacterium indicum	2	2	23	0	15	1	1	0	44
Bacteria;Bacteria_none;Proteobacteria;Deltaproteobacteria;Myxococcales;Polyangiaceae;Chondromyces;Chondromyces robustus	14	30	0	0	0	0	0	0	44
Bacteria;Bacteria_none;Proteobacteria;Gammaproteobacteria;Xanthomonadales;Xanthomonadaceae;Lysobacter;Lysobacter brunescens	42	2	0	0	0	0	0	0	44
Bacteria;Bacteria_none;Bacteroidota;Bacteroidia;Bacteroidales;Prevotellaceae;Prevotella;Prevotella jejuni	3	0	0	38	0	3	0	0	44
Bacteria;Bacteria_none;Actinobacteria;Actinomycetia;Micromonosporales;Micromonosporaceae;Actinoplanes;Actinoplanes palleronii	0	12	13	18	0	1	0	0	44
Bacteria;Bacteria_none;Proteobacteria;Gammaproteobacteria;Methylococcales;Methylococcaceae;Methylocaldum;Methylocaldum marinum	13	19	6	0	5	0	0	0	43
Bacteria;Bacteria_none;Proteobacteria;Gammaproteobacteria;Enterobacterales;Morganellaceae;Xenorhabdus;Xenorhabdus japonica	20	0	3	15	0	1	0	4	43
Bacteria;Bacteria_none;Firmicutes;Clostridia;Eubacteriales;Clostridiaceae;Clostridium;Clostridium tepidum	9	14	5	4	3	4	4	0	43
Bacteria;Bacteria_none;Actinobacteria;Actinomycetia;Actinomycetales;Actinomycetaceae;Changpingibacter;Changpingibacter yushuensis	12	13	5	6	2	0	5	0	43
Bacteria;Bacteria_none;Actinobacteria;Actinomycetia;Micrococcales;Microbacteriaceae;Microbacterium;Microbacterium yannicii	6	0	12	13	0	7	0	5	43
Bacteria;Bacteria_none;Proteobacteria;Gammaproteobacteria;Enterobacterales;Enterobacteriaceae;Cronobacter;Cronobacter malonaticus	32	1	0	9	0	0	1	0	43
Bacteria;Bacteria_none;Firmicutes;Clostridia;Eubacteriales;Syntrophomonadaceae;Syntrophomonas;Syntrophomonas curvata	4	30	4	0	1	3	1	0	43
Bacteria;Bacteria_none;Planctomycetota;Planctomycetia;Pirellulales;Lacipirellulaceae;Pirellulimonas;Pirellulimonas nuda	3	7	6	15	6	5	1	0	43
Bacteria;Bacteria_none;Firmicutes;Clostridia;Eubacteriales;Clostridiaceae;Clostridium;Clostridium schirmacherense	1	0	3	33	0	3	3	0	43
Bacteria;Bacteria_none;Proteobacteria;Alphaproteobacteria;Rhodospirillales;Acetobacteraceae;Acidibrevibacterium;Acidibrevibacterium fodinaquatile	3	16	8	10	2	0	0	4	43
Bacteria;Bacteria_none;Bacteroidota;Cytophagia;Cytophagales;Thermonemataceae;Thermonema;Thermonema lapsum	9	0	0	34	0	0	0	0	43
Bacteria;Bacteria_none;Proteobacteria;Alphaproteobacteria;Hyphomicrobiales;Xanthobacteraceae;Azorhizobium;Azorhizobium caulinodans	14	8	11	8	0	1	1	0	43
Bacteria;Bacteria_none;Proteobacteria;Alphaproteobacteria;Hyphomicrobiales;Methylocystaceae;Hansschlegelia;Hansschlegelia beijingensis	5	15	5	14	1	1	0	2	43
Bacteria;Bacteria_none;Actinobacteria;Actinomycetia;Propionibacteriales;Kribbellaceae;Kribbella;Kribbella monticola	0	0	29	6	7	0	0	1	43
Bacteria;Bacteria_none;Proteobacteria;Alphaproteobacteria;Hyphomicrobiales;Devosiaceae;Devosia;Devosia riboflavina	14	6	1	15	1	3	3	0	43
Bacteria;Bacteria_none;Actinobacteria;Thermoleophilia;Solirubrobacterales;Patulibacteraceae;Patulibacter;Patulibacter medicamentivorans	2	8	7	22	1	0	2	1	43
Bacteria;Bacteria_none;Firmicutes;Clostridia;Eubacteriales;Lachnospiraceae;Wujia;Wujia chipingensis	9	11	7	9	2	4	0	1	43
Bacteria;Bacteria_none;Proteobacteria;Betaproteobacteria;Burkholderiales;Comamonadaceae;Hydrogenophaga;Hydrogenophaga electricum	36	4	0	1	1	0	0	1	43
Bacteria;Bacteria_none;Proteobacteria;Alphaproteobacteria;Sphingomonadales;Sphingomonadaceae;Novosphingobium;Novosphingobium taihuense	15	12	4	7	3	2	0	0	43
Bacteria;Bacteria_none;Firmicutes;Bacilli;Bacillales;Planococcaceae;Rummeliibacillus;Rummeliibacillus pycnus	1	0	1	2	0	0	6	33	43
Bacteria;Bacteria_none;Verrucomicrobia;Verrucomicrobiae;Verrucomicrobiales;Verrucomicrobiaceae;Prosthecobacter;Prosthecobacter fluviatilis	13	28	0	2	0	0	0	0	43
Bacteria;Bacteria_none;Firmicutes;Negativicutes;Selenomonadales;Selenomonadaceae;Propionispira;Propionispira arboris	8	10	6	14	1	0	1	2	42
Bacteria;Bacteria_none;Actinobacteria;Actinomycetia;Propionibacteriales;Nocardioidaceae;Marmoricola;Marmoricola terrae	11	14	5	11	1	0	0	0	42
Bacteria;Bacteria_none;Proteobacteria;Alphaproteobacteria;Hyphomicrobiales;Nitrobacteraceae;Bradyrhizobium;Bradyrhizobium japonicum	19	0	8	8	0	0	7	0	42
Bacteria;Bacteria_none;Actinobacteria;Actinomycetia;Actinomycetales;Actinomycetaceae;Ancrocorticia;Ancrocorticia populi	15	12	5	8	0	0	1	1	42
Bacteria;Bacteria_none;Proteobacteria;Betaproteobacteria;Burkholderiales;Comamonadaceae;Simplicispira;Simplicispira psychrophila	21	8	8	0	0	4	1	0	42
Bacteria;Bacteria_none;Proteobacteria;Gammaproteobacteria;Pseudomonadales;Pseudomonadaceae;Pseudomonas;Pseudomonas flavescens	4	15	5	18	0	0	0	0	42
Bacteria;Bacteria_none;Firmicutes;Bacilli;Lactobacillales;Streptococcaceae;Streptococcus;Streptococcus pantholopis	30	4	1	6	0	0	0	1	42
Bacteria;Bacteria_none;Firmicutes;Clostridia;Eubacteriales;Eubacteriales Family XIII. Incertae Sedis;Eubacteriales Family XIII. Incertae Sedis_Incertae_sedis;[Eubacterium] minutum	0	4	21	3	4	9	0	1	42
Bacteria;Bacteria_none;Proteobacteria;Gammaproteobacteria;Thiotrichales;Piscirickettsiaceae;Methylophaga;Methylophaga marina	4	17	5	13	0	0	1	2	42
Bacteria;Bacteria_none;Proteobacteria;Betaproteobacteria;Burkholderiales;Comamonadaceae;Pseudorhodoferax;Pseudorhodoferax caeni	23	11	4	2	2	0	0	0	42
Bacteria;Bacteria_none;Firmicutes;Clostridia;Eubacteriales;Oscillospiraceae;Faecalibacterium;Faecalibacterium hattorii	14	1	7	1	0	18	0	1	42
Bacteria;Bacteria_none;Firmicutes;Bacilli;Lactobacillales;Enterococcaceae;Enterococcus;Enterococcus canis	34	4	1	0	1	0	2	0	42
Bacteria;Bacteria_none;Proteobacteria;Gammaproteobacteria;Acidiferrobacterales;Acidiferrobacteraceae;Acidiferrobacter;Acidiferrobacter thiooxydans	4	20	6	8	1	3	0	0	42
Bacteria;Bacteria_none;Firmicutes;Negativicutes;Veillonellales;Veillonellaceae;Megasphaera;Megasphaera hexanoica	2	3	3	29	0	1	4	0	42
Bacteria;Bacteria_none;Proteobacteria;Alphaproteobacteria;Rhodospirillales;Rhodospirillaceae;Pararhodospirillum;Pararhodospirillum photometricum	24	6	6	1	0	2	2	1	42
Bacteria;Bacteria_none;Firmicutes;Clostridia;Eubacteriales;Lachnospiraceae;Hominisplanchenecus;Hominisplanchenecus faecis	35	0	1	2	0	1	2	1	42
Bacteria;Bacteria_none;Firmicutes;Clostridia;Eubacteriales;Eubacteriaceae;Rhabdanaerobium;Rhabdanaerobium thermarum	2	10	20	2	3	3	0	2	42
Bacteria;Bacteria_none;Firmicutes;Clostridia;Eubacteriales;Lachnospiraceae;Fusimonas;Fusimonas intestini	10	12	7	3	1	5	1	2	41
Bacteria;Bacteria_none;Actinobacteria;Thermoleophilia;Miltoncostaeales;Miltoncostaeaceae;Miltoncostaea;Miltoncostaea oceani	11	17	5	8	0	0	0	0	41
Bacteria;Bacteria_none;Proteobacteria;Gammaproteobacteria;Enterobacterales;Erwiniaceae;Erwinia;Erwinia pyrifoliae	30	0	1	6	0	1	0	3	41
Bacteria;Bacteria_none;Proteobacteria;Hydrogenophilalia;Hydrogenophilales;Hydrogenophilaceae;Tepidiphilus;Tepidiphilus margaritifer	1	0	0	25	1	12	2	0	41
Bacteria;Bacteria_none;Proteobacteria;Gammaproteobacteria;Legionellales;Legionellaceae;Legionella;Legionella moravica	8	9	7	9	1	5	1	1	41
Bacteria;Bacteria_none;Proteobacteria;Alphaproteobacteria;Hyphomicrobiales;Boseaceae;Bosea;Bosea massiliensis	18	5	5	13	0	0	0	0	41
Bacteria;Bacteria_none;Firmicutes;Clostridia;Eubacteriales;Clostridiaceae;Caloramator;Caloramator quimbayensis	0	1	20	4	6	4	0	6	41
Bacteria;Bacteria_none;Bacteroidota;Sphingobacteriia;Sphingobacteriales;Sphingobacteriaceae;Mucilaginibacter;Mucilaginibacter roseus	5	8	6	14	0	3	3	2	41
Bacteria;Bacteria_none;Proteobacteria;Alphaproteobacteria;Rhodobacterales;Rhodobacteraceae;Rhodovulum;Rhodovulum lacipunicei	4	12	13	7	2	2	0	1	41
Bacteria;Bacteria_none;Firmicutes;Clostridia;Eubacteriales;Oscillospiraceae;Ruminiclostridium;Ruminiclostridium josui	0	0	9	4	21	7	0	0	41
Bacteria;Bacteria_none;Proteobacteria;Gammaproteobacteria;Xanthomonadales;Xanthomonadaceae;Pseudoxanthomonas;Pseudoxanthomonas arseniciresistens	22	8	5	6	0	0	0	0	41
Bacteria;Bacteria_none;Proteobacteria;Betaproteobacteria;Burkholderiales;Oxalobacteraceae;Undibacterium;Undibacterium amnicola	21	11	2	4	0	1	1	1	41
Bacteria;Bacteria_none;Firmicutes;Clostridia;Eubacteriales;Syntrophomonadaceae;Thermohydrogenium;Thermohydrogenium kirishiense	0	31	9	0	0	0	1	0	41
Bacteria;Bacteria_none;Bacteroidota;Chitinophagia;Chitinophagales;Chitinophagaceae;Flavihumibacter;Flavihumibacter sediminis	29	3	4	3	0	0	2	0	41
Bacteria;Bacteria_none;Proteobacteria;Alphaproteobacteria;Caulobacterales;Caulobacteraceae;Terricaulis;Terricaulis silvestris	15	16	5	4	0	0	1	0	41
Bacteria;Bacteria_none;Actinobacteria;Actinomycetia;Propionibacteriales;Propionibacteriaceae;Tessaracoccus;Tessaracoccus massiliensis	6	7	12	10	0	5	1	0	41
Bacteria;Bacteria_none;Firmicutes;Bacilli;Bacillales;Bacillaceae;Lentibacillus;Lentibacillus halodurans	0	2	20	8	3	7	0	1	41
Bacteria;Bacteria_none;Proteobacteria;Betaproteobacteria;Burkholderiales;Burkholderiaceae;Cupriavidus;Cupriavidus oxalaticus	26	9	3	1	0	1	1	0	41
Bacteria;Bacteria_none;Firmicutes;Clostridia;Eubacteriales;Clostridiaceae;Alkaliphilus;Alkaliphilus peptidifermentans	0	2	39	0	0	0	0	0	41
Bacteria;Bacteria_none;Proteobacteria;Gammaproteobacteria;Xanthomonadales;Xanthomonadaceae;Arenimonas;Arenimonas terrae	38	2	1	0	0	0	0	0	41
Bacteria;Bacteria_none;Bacteroidota;Bacteroidia;Bacteroidales;Porphyromonadaceae;Porphyromonas;Porphyromonas crevioricanis	0	15	9	10	2	4	1	0	41
Bacteria;Bacteria_none;Proteobacteria;Alphaproteobacteria;Hyphomicrobiales;Methylocystaceae;Methylocystis;Methylocystis silviterrae	6	18	5	6	0	6	0	0	41
Bacteria;Bacteria_none;Proteobacteria;Gammaproteobacteria;Moraxellales;Moraxellaceae;Moraxella;Moraxella boevrei	11	0	5	19	1	0	5	0	41
Bacteria;Bacteria_none;Proteobacteria;Betaproteobacteria;Burkholderiales;Comamonadaceae;Polaromonas;Polaromonas ginsengisoli	27	5	4	0	0	3	0	2	41
Bacteria;Bacteria_none;Proteobacteria;Betaproteobacteria;Burkholderiales;Comamonadaceae;Variovorax;Variovorax robiniae	32	6	2	0	0	0	0	0	40
Bacteria;Bacteria_none;Proteobacteria;Betaproteobacteria;Neisseriales;Neisseriaceae;Crenobacter;Crenobacter luteus	14	12	5	5	2	0	1	1	40
Bacteria;Bacteria_none;Proteobacteria;Gammaproteobacteria;Enterobacterales;Erwiniaceae;Tatumella;Tatumella terrea	36	0	0	4	0	0	0	0	40
Bacteria;Bacteria_none;Proteobacteria;Betaproteobacteria;Burkholderiales;Sphaerotilaceae;Rubrivivax;Rubrivivax gelatinosus	38	1	0	1	0	0	0	0	40
Bacteria;Bacteria_none;Firmicutes;Clostridia;Eubacteriales;Clostridiaceae;Beduini;Beduini massiliensis	0	3	12	10	4	7	3	1	40
Bacteria;Bacteria_none;Verrucomicrobia;Verrucomicrobiae;Verrucomicrobiales;Verrucomicrobiaceae;Prosthecobacter;Prosthecobacter vanneervenii	40	0	0	0	0	0	0	0	40
Bacteria;Bacteria_none;Proteobacteria;Gammaproteobacteria;Moraxellales;Moraxellaceae;Acinetobacter;Acinetobacter baumannii	23	0	8	7	1	1	0	0	40
Bacteria;Bacteria_none;Actinobacteria;Coriobacteriia;Coriobacteriales;Coriobacteriaceae;Parvibacter;Parvibacter caecicola	0	2	17	7	2	10	1	1	40
Bacteria;Bacteria_none;Proteobacteria;Alphaproteobacteria;Hyphomicrobiales;Rhizobiaceae;Shinella;Shinella daejeonensis	12	19	1	7	0	0	1	0	40
Bacteria;Bacteria_none;Firmicutes;Bacilli;Lactobacillales;Lactobacillaceae;Ligilactobacillus;Ligilactobacillus ruminis	28	0	2	4	1	3	1	1	40
Bacteria;Bacteria_none;Proteobacteria;Gammaproteobacteria;Enterobacterales;Enterobacteriaceae;Kluyvera;Kluyvera cryocrescens	24	6	7	3	0	0	0	0	40
Bacteria;Bacteria_none;Bacteroidota;Bacteroidia;Bacteroidales;Odoribacteraceae;Butyricimonas;Butyricimonas synergistica	0	0	0	21	0	0	8	11	40
Bacteria;Bacteria_none;Firmicutes;Clostridia;Eubacteriales;Peptostreptococcaceae;Peptoclostridium;Peptoclostridium litorale	1	7	10	4	2	8	2	6	40
Bacteria;Bacteria_none;Bacteroidota;Bacteroidia;Bacteroidales;Barnesiellaceae;Coprobacter;Coprobacter secundus	0	12	0	0	1	0	27	0	40
Bacteria;Bacteria_none;Proteobacteria;Deltaproteobacteria;Desulfovibrionales;Desulfohalobiaceae;Desulfonatronovibrio;Desulfonatronovibrio halophilus	1	8	22	0	9	0	0	0	40
Bacteria;Bacteria_none;Firmicutes;Clostridia;Eubacteriales;Clostridiaceae;Clostridium;Clostridium culturomicium	9	18	2	10	1	0	0	0	40
Bacteria;Bacteria_none;Actinobacteria;Actinomycetia;Propionibacteriales;Propionibacteriaceae;Arachnia;Arachnia propionica	0	4	6	22	0	6	1	1	40
Bacteria;Bacteria_none;Ignavibacteriae;Ignavibacteria;Ignavibacteriales;Melioribacteraceae;Melioribacter;Melioribacter roseus	12	4	18	4	1	1	0	0	40
Bacteria;Bacteria_none;Bacteroidota;Chitinophagia;Chitinophagales;Chitinophagaceae;Flavipsychrobacter;Flavipsychrobacter stenotrophus	8	30	0	1	0	0	1	0	40
Bacteria;Bacteria_none;Proteobacteria;Gammaproteobacteria;Enterobacterales;Morganellaceae;Photorhabdus;Photorhabdus akhurstii	9	27	1	2	0	1	0	0	40
Bacteria;Bacteria_none;Proteobacteria;Gammaproteobacteria;Xanthomonadales;Rhodanobacteraceae;Dyella;Dyella telluris	10	27	1	0	2	0	0	0	40
Bacteria;Bacteria_none;Actinobacteria;Coriobacteriia;Coriobacteriales;Atopobiaceae;Olsenella;Olsenella profusa	13	10	6	6	1	2	0	2	40
Bacteria;Bacteria_none;Firmicutes;Clostridia;Eubacteriales;Lachnospiraceae;Roseburia;Roseburia lenta	19	1	3	7	4	2	1	3	40
Bacteria;Bacteria_none;Verrucomicrobia;Opitutae;Opitutales;Opitutaceae;Cephaloticoccus;Cephaloticoccus capnophilus	0	36	0	4	0	0	0	0	40
Bacteria;Bacteria_none;Firmicutes;Bacilli;Bacillales;Bacillaceae;Fictibacillus;Fictibacillus arsenicus	3	6	20	3	1	4	3	0	40
Bacteria;Bacteria_none;Cyanobacteria;Gloeobacteria;Gloeobacterales;Gloeobacteraceae;Gloeobacter;Gloeobacter kilaueensis	0	0	39	0	0	0	0	0	39
Bacteria;Bacteria_none;Aquificae;Aquificae;Aquificales;Aquificaceae;Hydrogenobaculum;Hydrogenobaculum acidophilum	0	0	7	30	0	0	1	1	39
Bacteria;Bacteria_none;Proteobacteria;Betaproteobacteria;Burkholderiales;Comamonadaceae;Acidovorax;Acidovorax cavernicola	34	4	0	0	0	0	1	0	39
Bacteria;Bacteria_none;Firmicutes;Bacilli;Bacillales;Bacillaceae;Ectobacillus;Ectobacillus antri	2	1	26	7	1	1	1	0	39
Bacteria;Bacteria_none;Proteobacteria;Gammaproteobacteria;Xanthomonadales;Rhodanobacteraceae;Frateuria;Frateuria aurantia	2	13	7	9	0	2	1	5	39
Bacteria;Bacteria_none;Proteobacteria;Betaproteobacteria;Burkholderiales;Burkholderiales_Incertae_sedis;Aquabacterium;Aquabacterium citratiphilum	13	12	1	3	7	2	0	1	39
Bacteria;Bacteria_none;Proteobacteria;Alphaproteobacteria;Hyphomicrobiales;Brucellaceae;Paenochrobactrum;Paenochrobactrum pullorum	9	12	6	9	0	2	0	1	39
Bacteria;Bacteria_none;Firmicutes;Bacilli;Bacillales;Bacillaceae;Priestia;Priestia qingshengii	2	4	16	9	1	6	1	0	39
Bacteria;Bacteria_none;Firmicutes;Clostridia;Eubacteriales;Desulfallaceae;Sporotomaculum;Sporotomaculum syntrophicum	0	1	28	2	4	4	0	0	39
Bacteria;Bacteria_none;Firmicutes;Bacilli;Lactobacillales;Streptococcaceae;Streptococcus;Streptococcus ovis	26	1	6	3	0	1	2	0	39
Bacteria;Bacteria_none;Actinobacteria;Actinomycetia;Micrococcales;Microbacteriaceae;Microbacterium;Microbacterium natoriense	1	7	6	14	0	4	0	7	39
Bacteria;Bacteria_none;Chloroflexi;Anaerolineae;Aggregatilineales;Aggregatilineaceae;Aggregatilinea;Aggregatilinea lenta	3	4	25	2	1	1	1	2	39
Bacteria;Bacteria_none;Proteobacteria;Deltaproteobacteria;Desulfovibrionales;Desulfovibrionaceae;Desulfovibrio;Desulfovibrio simplex	5	31	3	0	0	0	0	0	39
Bacteria;Bacteria_none;Proteobacteria;Oligoflexia;Bdellovibrionales;Bdellovibrionaceae;Bdellovibrio;Bdellovibrio bacteriovorus	6	8	7	14	3	0	1	0	39
Bacteria;Bacteria_none;Firmicutes;Firmicutes_Incertae_sedis;Firmicutes_Incertae_sedis;Firmicutes_Incertae_sedis;Capillibacterium;Capillibacterium thermochitinicola	1	6	14	3	2	13	0	0	39
Bacteria;Bacteria_none;Proteobacteria;Gammaproteobacteria;Moraxellales;Moraxellaceae;Acinetobacter;Acinetobacter plantarum	28	1	4	4	0	0	0	2	39
Bacteria;Bacteria_none;Proteobacteria;Alphaproteobacteria;Hyphomicrobiales;Boseaceae;Bosea;Bosea robiniae	0	0	25	14	0	0	0	0	39
Bacteria;Bacteria_none;Actinobacteria;Actinomycetia;Micrococcales;Intrasporangiaceae;Humibacillus;Humibacillus xanthopallidus	3	5	12	6	3	8	2	0	39
Bacteria;Bacteria_none;Proteobacteria;Gammaproteobacteria;Xanthomonadales;Xanthomonadaceae;Vulcaniibacterium;Vulcaniibacterium thermophilum	31	5	0	1	0	1	0	1	39
Bacteria;Bacteria_none;Bacteroidota;Cytophagia;Cytophagales;Spirosomaceae;Arcicella;Arcicella rigui	37	1	0	0	0	0	0	0	38
Bacteria;Bacteria_none;Proteobacteria;Betaproteobacteria;Rhodocyclales;Rhodocyclaceae;Niveibacterium;Niveibacterium microcysteis	24	7	2	1	2	1	0	1	38
Bacteria;Bacteria_none;Proteobacteria;Betaproteobacteria;Burkholderiales;Burkholderiales_Incertae_sedis;Piscinibacterium;Piscinibacterium candidicorallinum	31	2	1	1	1	0	1	1	38
Bacteria;Bacteria_none;Proteobacteria;Betaproteobacteria;Rhodocyclales;Rhodocyclaceae;Azovibrio;Azovibrio restrictus	0	0	0	22	2	3	6	5	38
Bacteria;Bacteria_none;Firmicutes;Clostridia;Eubacteriales;Oscillospiraceae;Pseudoflavonifractor;Pseudoflavonifractor gallinarum	16	6	5	1	2	5	2	1	38
Bacteria;Bacteria_none;Gemmatimonadetes;Gemmatimonadetes;Gemmatimonadales;Gemmatimonadaceae;Gemmatimonas;Gemmatimonas phototrophica	27	7	1	3	0	0	0	0	38
Bacteria;Bacteria_none;Firmicutes;Negativicutes;Selenomonadales;Sporomusaceae;Thermosinus;Thermosinus carboxydivorans	2	1	8	12	1	9	5	0	38
Bacteria;Bacteria_none;Firmicutes;Clostridia;Eubacteriales;Lachnospiraceae;Anaerocolumna;Anaerocolumna cellulosilytica	20	6	2	5	2	0	1	2	38
Bacteria;Bacteria_none;Firmicutes;Bacilli;Bacillales;Alicyclobacillaceae;Alicyclobacillus;Alicyclobacillus tolerans	0	1	16	12	3	3	2	1	38
Bacteria;Bacteria_none;Firmicutes;Clostridia;Eubacteriales;Clostridiaceae;Clostridium;Clostridium magnum	2	7	3	20	1	1	2	2	38
Bacteria;Bacteria_none;Planctomycetota;Planctomycetia;Pirellulales;Pirellulaceae;Rhodopirellula;Rhodopirellula rosea	11	5	4	6	2	3	2	5	38
Bacteria;Bacteria_none;Proteobacteria;Alphaproteobacteria;Hyphomicrobiales;Lichenihabitantaceae;Lichenihabitans;Lichenihabitans psoromatis	11	13	3	8	2	1	0	0	38
Bacteria;Bacteria_none;Firmicutes;Bacilli;Bacillales;Bacillaceae;Amphibacillus;Amphibacillus haojiensis	0	2	20	4	6	4	0	2	38
Bacteria;Bacteria_none;Firmicutes;Clostridia;Eubacteriales;Clostridiaceae;Clostridium;Clostridium chartatabidum	8	2	7	14	2	2	1	2	38
Bacteria;Bacteria_none;Proteobacteria;Alphaproteobacteria;Rhodobacterales;Rhodobacteraceae;Roseinatronobacter;Roseinatronobacter thiooxidans	9	7	8	8	1	3	1	1	38
Bacteria;Bacteria_none;Proteobacteria;Gammaproteobacteria;Pseudomonadales;Marinobacteraceae;Marinobacter;Marinobacter nauticus	1	12	7	14	0	1	3	0	38
Bacteria;Bacteria_none;Actinobacteria;Actinomycetia;Sporichthyales;Sporichthyaceae;Longivirga;Longivirga aurantiaca	7	7	9	9	3	1	0	2	38
Bacteria;Bacteria_none;Verrucomicrobia;Verrucomicrobiae;Verrucomicrobiales;Verrucomicrobiaceae;Roseibacillus;Roseibacillus persicicus	0	38	0	0	0	0	0	0	38
Bacteria;Bacteria_none;Proteobacteria;Betaproteobacteria;Rhodocyclales;Zoogloeaceae;Zoogloea;Zoogloea oryzae	25	9	0	0	0	4	0	0	38
Bacteria;Bacteria_none;Proteobacteria;Deltaproteobacteria;Desulfovibrionales;Desulfovibrionaceae;Oceanidesulfovibrio;Oceanidesulfovibrio indonesiensis	3	33	2	0	0	0	0	0	38
Bacteria;Bacteria_none;Proteobacteria;Betaproteobacteria;Burkholderiales;Oxalobacteraceae;Duganella;Duganella margarita	16	10	4	5	0	3	0	0	38
Bacteria;Bacteria_none;Firmicutes;Clostridia;Eubacteriales;Clostridiaceae;Clostridium;Clostridium massiliamazoniense	3	2	5	7	5	12	2	2	38
Bacteria;Bacteria_none;Proteobacteria;Gammaproteobacteria;Moraxellales;Moraxellaceae;Acinetobacter;Acinetobacter chinensis	20	2	4	8	0	2	2	0	38
Bacteria;Bacteria_none;Proteobacteria;Gammaproteobacteria;Enterobacterales;Enterobacteriaceae;Lelliottia;Lelliottia nimipressuralis	25	1	1	10	0	0	1	0	38
Bacteria;Bacteria_none;Fusobacteria;Fusobacteriia;Fusobacteriales;Leptotrichiaceae;Streptobacillus;Streptobacillus canis	35	0	0	2	0	0	1	0	38
Bacteria;Bacteria_none;Firmicutes;Clostridia;Eubacteriales;Peptococcaceae;Desulfovectis;Desulfovectis peckii	0	3	8	5	1	17	2	2	38
Bacteria;Bacteria_none;Proteobacteria;Gammaproteobacteria;Enterobacterales;Pectobacteriaceae;Pectobacterium;Pectobacterium odoriferum	27	0	0	8	1	1	0	0	37
Bacteria;Bacteria_none;Proteobacteria;Alphaproteobacteria;Rhodospirillales;Rhodospirillaceae;Ferrovibrio;Ferrovibrio xuzhouensis	14	10	9	0	2	2	0	0	37
Bacteria;Bacteria_none;Proteobacteria;Betaproteobacteria;Burkholderiales;Comamonadaceae;Hydrogenophaga;Hydrogenophaga pseudoflava	32	2	1	0	1	0	0	1	37
Bacteria;Bacteria_none;Proteobacteria;Gammaproteobacteria;Enterobacterales;Enterobacteriaceae;Kosakonia;Kosakonia arachidis	17	9	3	5	0	0	2	1	37
Bacteria;Bacteria_none;Proteobacteria;Gammaproteobacteria;Xanthomonadales;Xanthomonadaceae;Pseudoxanthomonas;Pseudoxanthomonas humi	21	9	1	2	1	1	2	0	37
Bacteria;Bacteria_none;Proteobacteria;Betaproteobacteria;Nitrosomonadales;Sterolibacteriaceae;Methyloversatilis;Methyloversatilis discipulorum	35	0	0	0	0	2	0	0	37
Bacteria;Bacteria_none;Bacteroidota;Chitinophagia;Chitinophagales;Chitinophagaceae;Rurimicrobium;Rurimicrobium arvi	6	7	12	4	1	0	1	6	37
Bacteria;Bacteria_none;Actinobacteria;Actinomycetia;Propionibacteriales;Propionibacteriaceae;Acidipropionibacterium;Acidipropionibacterium thoenii	4	2	13	18	0	0	0	0	37
Bacteria;Bacteria_none;Proteobacteria;Gammaproteobacteria;Moraxellales;Moraxellaceae;Acinetobacter;Acinetobacter tjernbergiae	26	0	2	5	1	1	1	1	37
Bacteria;Bacteria_none;Proteobacteria;Betaproteobacteria;Burkholderiales;Alcaligenaceae;Pusillimonas;Pusillimonas minor	22	5	2	5	0	2	1	0	37
Bacteria;Bacteria_none;Proteobacteria;Betaproteobacteria;Rhodocyclales;Zoogloeaceae;Thauera;Thauera propionica	23	4	1	4	4	0	1	0	37
Bacteria;Bacteria_none;Firmicutes;Bacilli;Bacillales;Bacillaceae;Caldibacillus;Caldibacillus pasinlerensis	0	0	28	0	3	3	2	1	37
Bacteria;Bacteria_none;Proteobacteria;Betaproteobacteria;Rhodocyclales;Zoogloeaceae;Thauera;Thauera chlorobenzoica	16	12	6	1	0	1	1	0	37
Bacteria;Bacteria_none;Proteobacteria;Deltaproteobacteria;Desulfuromonadales;Geobacteraceae;Geothermobacter;Geothermobacter hydrogeniphilus	10	18	8	1	0	0	0	0	37
Bacteria;Bacteria_none;Proteobacteria;Deltaproteobacteria;Desulfovibrionales;Desulfovibrionaceae;Solidesulfovibrio;Solidesulfovibrio aerotolerans	5	24	2	3	0	3	0	0	37
Bacteria;Bacteria_none;Proteobacteria;Alphaproteobacteria;Hyphomicrobiales;Phyllobacteriaceae;Mesorhizobium;Mesorhizobium amorphae	4	10	11	12	0	0	0	0	37
Bacteria;Bacteria_none;Proteobacteria;Gammaproteobacteria;Xanthomonadales;Xanthomonadaceae;Stenotrophomonas;Stenotrophomonas maltophilia	32	0	2	0	0	3	0	0	37
Bacteria;Bacteria_none;Proteobacteria;Gammaproteobacteria;Legionellales;Legionellaceae;Legionella;Legionella fallonii	7	5	10	12	1	2	0	0	37
Bacteria;Bacteria_none;Firmicutes;Clostridia;Eubacteriales;Clostridiaceae;Clostridium;Clostridium cagae	5	5	2	16	3	3	0	3	37
Bacteria;Bacteria_none;Firmicutes;Clostridia;Eubacteriales;Lachnospiraceae;Simiaoa;Simiaoa hominis	2	33	0	1	0	1	0	0	37
Bacteria;Bacteria_none;Proteobacteria;Alphaproteobacteria;Rhodobacterales;Rhodobacteraceae;Paracoccus;Paracoccus ravus	12	8	3	12	1	0	1	0	37
Bacteria;Bacteria_none;Actinobacteria;Actinomycetia;Propionibacteriales;Propionibacteriaceae;Propioniciclava;Propioniciclava sinopodophylli	16	6	4	8	2	0	1	0	37
Bacteria;Bacteria_none;Actinobacteria;Actinomycetia;Corynebacteriales;Nocardiaceae;Nocardia;Nocardia testacea	2	5	8	17	0	3	2	0	37
Bacteria;Bacteria_none;Proteobacteria;Gammaproteobacteria;Enterobacterales;Enterobacteriaceae;Pluralibacter;Pluralibacter pyrinus	27	0	2	4	2	1	1	0	37
Bacteria;Bacteria_none;Proteobacteria;Alphaproteobacteria;Rhodobacterales;Rhodobacteraceae;Frigidibacter;Frigidibacter mobilis	12	7	4	10	3	0	0	0	36
Bacteria;Bacteria_none;Proteobacteria;Betaproteobacteria;Burkholderiales;Burkholderiaceae;Cupriavidus;Cupriavidus numazuensis	25	5	3	0	0	0	3	0	36
Bacteria;Bacteria_none;Firmicutes;Bacilli;Bacillales;Paenibacillaceae;Paenibacillus;Paenibacillus turpanensis	0	1	29	3	0	0	3	0	36
Bacteria;Bacteria_none;Proteobacteria;Betaproteobacteria;Burkholderiales;Burkholderiaceae;Burkholderia;Burkholderia pyrrocinia	16	8	6	1	0	3	1	1	36
Bacteria;Bacteria_none;Proteobacteria;Gammaproteobacteria;Xanthomonadales;Xanthomonadaceae;Lysobacter;Lysobacter panacihumi	33	2	0	1	0	0	0	0	36
Bacteria;Bacteria_none;Firmicutes;Clostridia;Eubacteriales;Desulfitobacteriaceae;Desulfosporosinus;Desulfosporosinus auripigmenti	5	0	10	5	3	13	0	0	36
Bacteria;Bacteria_none;Firmicutes;Bacilli;Bacillales;Paenibacillaceae;Cohnella;Cohnella plantaginis	0	0	27	1	3	5	0	0	36
Bacteria;Bacteria_none;Firmicutes;Clostridia;Eubacteriales;Clostridiaceae;Proteiniclasticum;Proteiniclasticum aestuarii	19	0	4	4	6	0	0	3	36
Bacteria;Bacteria_none;Proteobacteria;Alphaproteobacteria;Rhodospirillales;Stellaceae;Stella;Stella humosa	6	20	7	2	1	0	0	0	36
Bacteria;Bacteria_none;Firmicutes;Bacilli;Bacillales;Paenibacillaceae;Brevibacillus;Brevibacillus laterosporus	0	7	15	8	3	0	3	0	36
Bacteria;Bacteria_none;Firmicutes;Negativicutes;Selenomonadales;Sporomusaceae;Propionispora;Propionispora vibrioides	3	1	0	17	0	12	1	2	36
Bacteria;Bacteria_none;Proteobacteria;Alphaproteobacteria;Sphingomonadales;Erythrobacteraceae;Croceibacterium;Croceibacterium soli	1	7	8	9	4	0	2	5	36
Bacteria;Bacteria_none;Proteobacteria;Alphaproteobacteria;Rhodobacterales;Rhodobacteraceae;Paracoccus;Paracoccus fistulariae	9	10	4	12	0	0	0	1	36
Bacteria;Bacteria_none;Proteobacteria;Epsilonproteobacteria;Campylobacterales;Campylobacteraceae;Campylobacter;Campylobacter fetus	0	36	0	0	0	0	0	0	36
Bacteria;Bacteria_none;Firmicutes;Bacilli;Lactobacillales;Enterococcaceae;Enterococcus;Enterococcus casseliflavus	20	2	3	3	1	5	0	2	36
Bacteria;Bacteria_none;Firmicutes;Bacilli;Bacillales;Thermoactinomycetaceae;Staphylospora;Staphylospora marina	0	4	16	7	5	2	2	0	36
Bacteria;Bacteria_none;Proteobacteria;Deltaproteobacteria;Desulfovibrionales;Desulfovibrionaceae;Solidesulfovibrio;Solidesulfovibrio burkinensis	0	16	12	0	5	1	2	0	36
Bacteria;Bacteria_none;Proteobacteria;Betaproteobacteria;Nitrosomonadales;Nitrosomonadaceae;Nitrosomonas;Nitrosomonas mobilis	27	6	1	1	0	0	1	0	36
Bacteria;Bacteria_none;Proteobacteria;Alphaproteobacteria;Rhodobacterales;Rhodobacteraceae;Pseudooceanicola;Pseudooceanicola batsensis	5	13	8	7	1	1	0	1	36
Bacteria;Bacteria_none;Firmicutes;Bacilli;Lactobacillales;Streptococcaceae;Streptococcus;Streptococcus parasanguinis	34	0	0	0	1	0	0	0	35
Bacteria;Bacteria_none;Chloroflexi;Chloroflexia;Chloroflexales;Chloroflexaceae;Chloroflexus;Chloroflexus islandicus	0	0	35	0	0	0	0	0	35
Bacteria;Bacteria_none;Bacteroidota;Chitinophagia;Chitinophagales;Chitinophagaceae;Ferruginibacter;Ferruginibacter paludis	20	11	2	2	0	0	0	0	35
Bacteria;Bacteria_none;Proteobacteria;Alphaproteobacteria;Hyphomicrobiales;Hyphomicrobiaceae;Methyloligella;Methyloligella halotolerans	5	6	7	15	0	2	0	0	35
Bacteria;Bacteria_none;Actinobacteria;Actinomycetia;Actinomycetales;Actinomycetaceae;Schaalia;Schaalia suimastitidis	2	8	5	16	1	1	2	0	35
Bacteria;Bacteria_none;Firmicutes;Tissierellia;Tissierellales;Peptoniphilaceae;Peptoniphilus;Peptoniphilus methioninivorax	13	3	5	3	1	1	7	2	35
Bacteria;Bacteria_none;Proteobacteria;Alphaproteobacteria;Hyphomicrobiales;Nitrobacteraceae;Bradyrhizobium;Bradyrhizobium jicamae	11	13	2	6	0	2	0	1	35
Bacteria;Bacteria_none;Proteobacteria;Deltaproteobacteria;Desulfuromonadales;Geobacteraceae;Pelovirga;Pelovirga terrestris	0	3	22	1	9	0	0	0	35
Bacteria;Bacteria_none;Proteobacteria;Gammaproteobacteria;Enterobacterales;Yersiniaceae;Serratia;Serratia fonticola	31	0	0	4	0	0	0	0	35
Bacteria;Bacteria_none;Firmicutes;Bacilli;Bacillales;Thermoactinomycetaceae;Kroppenstedtia;Kroppenstedtia guangzhouensis	0	6	24	5	0	0	0	0	35
Bacteria;Bacteria_none;Proteobacteria;Deltaproteobacteria;Desulfuromonadales;Geobacteraceae;Geopsychrobacter;Geopsychrobacter electrodiphilus	8	8	6	3	0	2	2	6	35
Bacteria;Bacteria_none;Proteobacteria;Deltaproteobacteria;Desulfovibrionales;Desulfovibrionaceae;Desulfovibrio;Desulfovibrio cuneatus	3	20	8	3	0	1	0	0	35
Bacteria;Bacteria_none;Proteobacteria;Alphaproteobacteria;Hyphomicrobiales;Nitrobacteraceae;Afipia;Afipia birgiae	8	4	14	9	0	0	0	0	35
Bacteria;Bacteria_none;Proteobacteria;Deltaproteobacteria;Desulfuromonadales;Geobacteraceae;Geomonas;Geomonas agri	0	0	33	0	2	0	0	0	35
Bacteria;Bacteria_none;Firmicutes;Bacilli;Lactobacillales;Enterococcaceae;Enterococcus;Enterococcus mundtii	7	7	13	4	1	2	0	1	35
Bacteria;Bacteria_none;Firmicutes;Negativicutes;Selenomonadales;Selenomonadaceae;Selenomonas;Selenomonas flueggei	0	32	0	2	0	0	0	1	35
Bacteria;Bacteria_none;Actinobacteria;Actinomycetia;Micrococcales;Dermatophilaceae;Agilicoccus;Agilicoccus flavus	11	15	0	4	0	2	1	2	35
Bacteria;Bacteria_none;Proteobacteria;Alphaproteobacteria;Rhodobacterales;Rhodobacteraceae;Gemmobacter;Gemmobacter caeruleus	11	9	3	5	0	6	1	0	35
Bacteria;Bacteria_none;Actinobacteria;Actinomycetia;Micrococcales;Microbacteriaceae;Agrococcus;Agrococcus carbonis	1	10	8	11	0	1	1	3	35
Bacteria;Bacteria_none;Firmicutes;Clostridia;Eubacteriales;Peptostreptococcaceae;Peptacetobacter;Peptacetobacter hominis	4	5	6	9	2	4	3	2	35
Bacteria;Bacteria_none;Proteobacteria;Alphaproteobacteria;Rhodobacterales;Rhodobacteraceae;Gemmobacter;Gemmobacter aquarius	11	7	5	10	1	1	0	0	35
Bacteria;Bacteria_none;Bacteroidota;Bacteroidia;Marinilabiliales;Prolixibacteraceae;Maribellus;Maribellus comscasis	0	35	0	0	0	0	0	0	35
Bacteria;Bacteria_none;Proteobacteria;Alphaproteobacteria;Rhodospirillales;Acetobacteraceae;Roseomonas;Roseomonas rosea	11	3	5	13	0	1	1	1	35
Bacteria;Bacteria_none;Firmicutes;Clostridia;Eubacteriales;Lachnospiraceae;Lachnoclostridium;[Clostridium] aminophilum	3	4	9	4	6	6	1	1	34
Bacteria;Bacteria_none;Firmicutes;Bacilli;Bacillales;Bacillaceae;Salisediminibacterium;Salisediminibacterium selenitireducens	0	6	12	8	3	3	2	0	34
Bacteria;Bacteria_none;Proteobacteria;Gammaproteobacteria;Chromatiales;Ectothiorhodospiraceae;Ectothiorhodospira;Ectothiorhodospira mobilis	4	14	2	11	1	2	0	0	34
Bacteria;Bacteria_none;Firmicutes;Clostridia;Eubacteriales;Lachnospiraceae;Novisyntrophococcus;Novisyntrophococcus fermenticellae	6	7	9	4	4	3	0	1	34
Bacteria;Bacteria_none;Firmicutes;Clostridia;Eubacteriales;Oscillospiraceae;Agathobaculum;Agathobaculum butyriciproducens	29	1	1	3	0	0	0	0	34
Bacteria;Bacteria_none;Proteobacteria;Epsilonproteobacteria;Campylobacterales;Helicobacteraceae;Helicobacter;Helicobacter cinaedi	0	34	0	0	0	0	0	0	34
Bacteria;Bacteria_none;Proteobacteria;Betaproteobacteria;Burkholderiales;Comamonadaceae;Comamonas;Comamonas koreensis	24	5	3	0	0	2	0	0	34
Bacteria;Bacteria_none;Proteobacteria;Gammaproteobacteria;Moraxellales;Moraxellaceae;Acinetobacter;Acinetobacter kyonggiensis	21	0	0	13	0	0	0	0	34
Bacteria;Bacteria_none;Proteobacteria;Betaproteobacteria;Burkholderiales;Comamonadaceae;Xenophilus;Xenophilus azovorans	28	2	3	0	0	1	0	0	34
Bacteria;Bacteria_none;Actinobacteria;Thermoleophilia;Solirubrobacterales;Parviterribacteraceae;Parviterribacter;Parviterribacter multiflagellatus	2	3	5	18	0	0	5	1	34
Bacteria;Bacteria_none;Lentisphaerae;Oligosphaeria;Oligosphaerales;Oligosphaeraceae;Oligosphaera;Oligosphaera ethanolica	1	21	1	10	0	0	0	1	34
Bacteria;Bacteria_none;Firmicutes;Clostridia;Eubacteriales;Clostridiaceae;Clostridium;Clostridium puniceum	5	0	8	15	0	2	1	3	34
Bacteria;Bacteria_none;Actinobacteria;Actinomycetia;Propionibacteriales;Nocardioidaceae;Nocardioides;Nocardioides flavus Wang et al. 2016	7	5	8	5	3	4	1	1	34
Bacteria;Bacteria_none;Firmicutes;Clostridia;Eubacteriales;Clostridiaceae;Clostridium;Clostridium thermarum	0	3	0	12	6	2	4	7	34
Bacteria;Bacteria_none;Firmicutes;Clostridia;Eubacteriales;Peptostreptococcaceae;Peptostreptococcus;Candidatus Peptostreptococcus massiliensis	1	7	9	6	1	4	3	3	34
Bacteria;Bacteria_none;Proteobacteria;Alphaproteobacteria;Hyphomicrobiales;Hyphomicrobiaceae;Rhodoplanes;Rhodoplanes tepidamans	0	27	7	0	0	0	0	0	34
Bacteria;Bacteria_none;Firmicutes;Clostridia;Eubacteriales;Feifaniaceae;Feifania;Feifania hominis	2	4	12	5	3	5	1	2	34
Bacteria;Bacteria_none;Proteobacteria;Betaproteobacteria;Burkholderiales;Burkholderiales_Incertae_sedis;Aquabacterium;Aquabacterium commune	16	11	4	0	1	1	0	1	34
Bacteria;Bacteria_none;Actinobacteria;Acidimicrobiia;Acidimicrobiales;Acidimicrobiaceae;Ferrimicrobium;Ferrimicrobium acidiphilum	12	19	0	1	0	2	0	0	34
Bacteria;Bacteria_none;Firmicutes;Clostridia;Eubacteriales;Lachnospiraceae;Mediterraneibacter;[Ruminococcus] lactaris	10	2	15	2	3	2	0	0	34
Bacteria;Bacteria_none;Proteobacteria;Deltaproteobacteria;Desulfuromonadales;Desulfuromonadaceae;Desulfuromusa;Desulfuromusa ferrireducens	0	32	0	1	0	0	1	0	34
Bacteria;Bacteria_none;Firmicutes;Clostridia;Eubacteriales;Clostridiaceae;Clostridium;Clostridium cadaveris	7	3	5	7	5	4	3	0	34
Bacteria;Bacteria_none;Proteobacteria;Gammaproteobacteria;Legionellales;Legionellaceae;Legionella;Legionella norrlandica	5	4	5	13	1	4	1	1	34
Bacteria;Bacteria_none;Actinobacteria;Actinomycetia;Micrococcales;Bogoriellaceae;Georgenia;Georgenia yuyongxinii	5	5	10	11	0	2	0	1	34
Bacteria;Bacteria_none;Chloroflexi;Anaerolineae;Anaerolineales;Anaerolineaceae;Thermomarinilinea;Thermomarinilinea lacunifontana	2	14	10	4	4	0	0	0	34
Bacteria;Bacteria_none;Verrucomicrobia;Verrucomicrobiae;Verrucomicrobiales;Verrucomicrobiaceae;Luteolibacter;Luteolibacter pohnpeiensis	11	15	8	0	0	0	0	0	34
Bacteria;Bacteria_none;Proteobacteria;Gammaproteobacteria;Chromatiales;Chromatiaceae;Thiocystis;Thiocystis cadagnonensis	26	8	0	0	0	0	0	0	34
Bacteria;Bacteria_none;Proteobacteria;Alphaproteobacteria;Rhodobacterales;Rhodobacteraceae;Fuscovulum;Fuscovulum blasticum	12	8	6	5	2	0	1	0	34
Bacteria;Bacteria_none;Bacteroidota;Bacteroidia;Bacteroidales;Rikenellaceae;Alistipes;Alistipes okayasuensis	5	29	0	0	0	0	0	0	34
Bacteria;Bacteria_none;Firmicutes;Bacilli;Lactobacillales;Lactobacillaceae;Lactobacillus;Lactobacillus gallinarum	6	6	16	1	2	2	0	1	34
Bacteria;Bacteria_none;Firmicutes;Clostridia;Eubacteriales;Lachnospiraceae;Blautia;Blautia caecimuris	21	6	1	4	1	0	0	1	34
Bacteria;Bacteria_none;Firmicutes;Bacilli;Lactobacillales;Lactobacillaceae;Leuconostoc;Leuconostoc falkenbergense	24	5	2	1	0	1	0	0	33
Bacteria;Bacteria_none;Actinobacteria;Actinomycetia;Actinomycetales;Actinomycetaceae;Flaviflexus;Flaviflexus huanghaiensis	8	6	6	10	0	0	2	1	33
Bacteria;Bacteria_none;Firmicutes;Tissierellia;Tissierellales;Thermohalobacteraceae;Thermohalobacter;Thermohalobacter berrensis	2	1	17	11	1	0	0	1	33
Bacteria;Bacteria_none;Proteobacteria;Alphaproteobacteria;Hyphomicrobiales;Pleomorphomonadaceae;Methylobrevis;Methylobrevis albus	13	11	4	4	0	1	0	0	33
Bacteria;Bacteria_none;Actinobacteria;Actinomycetia;Propionibacteriales;Propionibacteriaceae;Tessaracoccus;Tessaracoccus bendigoensis	9	6	4	7	2	1	2	2	33
Bacteria;Bacteria_none;Proteobacteria;Alphaproteobacteria;Rhodobacterales;Rhodobacteraceae;Paracoccus;Paracoccus versutus	6	5	13	0	5	4	0	0	33
Bacteria;Bacteria_none;Cyanobacteria;Cyanobacteria_Incertae_sedis;Pseudanabaenales;Prochlorotrichaceae;Halomicronema;Halomicronema metazoicum	0	4	15	11	0	0	0	3	33
Bacteria;Bacteria_none;Firmicutes;Bacilli;Bacillales;Paenibacillaceae;Saccharibacillus;Saccharibacillus deserti	5	5	13	3	0	0	0	7	33
Bacteria;Bacteria_none;Proteobacteria;Alphaproteobacteria;Hyphomicrobiales;Hyphomicrobiaceae;Methylorhabdus;Methylorhabdus multivorans	14	7	4	5	1	1	0	1	33
Bacteria;Bacteria_none;Actinobacteria;Actinomycetia;Micromonosporales;Micromonosporaceae;Couchioplanes;Couchioplanes caeruleus	0	0	26	0	3	0	0	4	33
Bacteria;Bacteria_none;Firmicutes;Bacilli;Bacillales;Bacillaceae;Fictibacillus;Fictibacillus barbaricus	0	5	22	1	3	0	1	1	33
Bacteria;Bacteria_none;Firmicutes;Bacilli;Bacillales;Bacillaceae;Mesobacillus;Mesobacillus thioparans	0	0	0	0	0	25	8	0	33
Bacteria;Bacteria_none;Proteobacteria;Gammaproteobacteria;Enterobacterales;Erwiniaceae;Pantoea;Pantoea cypripedii	25	0	1	6	0	0	0	1	33
Bacteria;Bacteria_none;Firmicutes;Bacilli;Bacillales;Bacillaceae;Cytobacillus;Cytobacillus solani	0	3	19	3	0	5	3	0	33
Bacteria;Bacteria_none;Proteobacteria;Alphaproteobacteria;Rhodobacterales;Rhodobacteraceae;Plastorhodobacter;Plastorhodobacter daqingensis	5	7	8	7	1	3	0	2	33
Bacteria;Bacteria_none;Proteobacteria;Alphaproteobacteria;Hyphomicrobiales;Phyllobacteriaceae;Mesorhizobium;Mesorhizobium tamadayense	5	9	5	3	2	8	1	0	33
Bacteria;Bacteria_none;Proteobacteria;Deltaproteobacteria;Desulfovibrionales;Desulfovibrionaceae;Desulfobaculum;Desulfobaculum xiamenense	7	16	5	4	0	1	0	0	33
Bacteria;Bacteria_none;Actinobacteria;Actinomycetia;Propionibacteriales;Nocardioidaceae;Thermasporomyces;Thermasporomyces composti	1	5	5	18	2	1	0	1	33
Bacteria;Bacteria_none;Proteobacteria;Alphaproteobacteria;Rhodobacterales;Rhodobacteraceae;Rhodobacter;Rhodobacter azollae	12	7	3	8	0	1	1	1	33
Bacteria;Bacteria_none;Firmicutes;Clostridia;Eubacteriales;Peptococcaceae;Desulfofundulus;Desulfofundulus australicus	0	2	27	0	4	0	0	0	33
Bacteria;Bacteria_none;Verrucomicrobia;Verrucomicrobiae;Verrucomicrobiales;Verrucomicrobiaceae;Luteolibacter;Luteolibacter flavescens	33	0	0	0	0	0	0	0	33
Bacteria;Bacteria_none;Firmicutes;Bacilli;Lactobacillales;Enterococcaceae;Enterococcus;Enterococcus cecorum	27	3	2	1	0	0	0	0	33
Bacteria;Bacteria_none;Bacteroidota;Flavobacteriia;Flavobacteriales;Flavobacteriaceae;Flavobacterium;Flavobacterium columnare	0	0	0	7	0	26	0	0	33
Bacteria;Bacteria_none;Verrucomicrobia;Opitutae;Puniceicoccales;Puniceicoccaceae;Oceanipulchritudo;Oceanipulchritudo coccoides	1	29	2	1	0	0	0	0	33
Bacteria;Bacteria_none;Firmicutes;Clostridia;Eubacteriales;Eubacteriales_Incertae_sedis;Intestinimonas;Intestinimonas butyriciproducens	10	1	10	8	1	1	2	0	33
Bacteria;Bacteria_none;Proteobacteria;Alphaproteobacteria;Hyphomicrobiales;Aurantimonadaceae;Aureimonas;Aureimonas galii	8	13	9	2	1	0	0	0	33
Bacteria;Bacteria_none;Proteobacteria;Gammaproteobacteria;Chromatiales;Thioalkalispiraceae;Thioalkalispira;Thioalkalispira microaerophila	29	1	1	1	0	0	1	0	33
Bacteria;Bacteria_none;Firmicutes;Clostridia;Eubacteriales;Lachnospiraceae;Hespellia;Hespellia porcina	10	17	1	4	0	1	0	0	33
Bacteria;Bacteria_none;Firmicutes;Clostridia;Eubacteriales;Lachnospiraceae;Robinsoniella;Robinsoniella peoriensis	12	5	8	6	2	0	0	0	33
Bacteria;Bacteria_none;Proteobacteria;Betaproteobacteria;Neisseriales;Chromobacteriaceae;Chromobacterium;Chromobacterium aquaticum	33	0	0	0	0	0	0	0	33
Bacteria;Bacteria_none;Proteobacteria;Alphaproteobacteria;Hyphomicrobiales;Boseaceae;Bosea;Bosea thiooxidans	14	6	0	8	0	4	0	0	32
Bacteria;Bacteria_none;Actinobacteria;Coriobacteriia;Eggerthellales;Eggerthellaceae;Raoultibacter;Raoultibacter timonensis	0	12	10	6	0	4	0	0	32
Bacteria;Bacteria_none;Firmicutes;Clostridia;Eubacteriales;Lachnospiraceae;Anaerostipes;Anaerostipes butyraticus	8	1	14	6	2	0	1	0	32
Bacteria;Bacteria_none;Proteobacteria;Gammaproteobacteria;Xanthomonadales;Xanthomonadaceae;Stenotrophomonas;Stenotrophomonas rhizophila	7	21	0	2	0	1	0	1	32
Bacteria;Bacteria_none;Proteobacteria;Betaproteobacteria;Burkholderiales;Comamonadaceae;Curvibacter;Curvibacter delicatus	21	8	1	0	1	1	0	0	32
Bacteria;Bacteria_none;Firmicutes;Clostridia;Eubacteriales;Eubacteriales Family XII. Incertae Sedis;Fusibacter;Fusibacter ferrireducens	0	2	13	0	0	16	1	0	32
Bacteria;Bacteria_none;Firmicutes;Negativicutes;Selenomonadales;Selenomonadaceae;Megamonas;Megamonas funiformis	27	0	3	0	2	0	0	0	32
Bacteria;Bacteria_none;Actinobacteria;Actinomycetia;Propionibacteriales;Propionibacteriaceae;Propioniciclava;Propioniciclava tarda	5	13	2	9	1	0	1	1	32
Bacteria;Bacteria_none;Proteobacteria;Alphaproteobacteria;Hyphomicrobiales;Methylocystaceae;Methylocystis;Methylocystis echinoides	0	2	13	11	0	0	2	4	32
Bacteria;Bacteria_none;Proteobacteria;Alphaproteobacteria;Hyphomicrobiales;Phyllobacteriaceae;Aminobacter;Aminobacter anthyllidis	11	6	0	11	4	0	0	0	32
Bacteria;Bacteria_none;Proteobacteria;Alphaproteobacteria;Hyphomicrobiales;Beijerinckiaceae;Methylocapsa;Methylocapsa aurea	11	7	3	9	0	2	0	0	32
Bacteria;Bacteria_none;Firmicutes;Bacilli;Bacillales;Paenibacillaceae;Paenibacillus;Paenibacillus ginsengiterrae	0	2	17	2	8	2	1	0	32
Bacteria;Bacteria_none;Proteobacteria;Alphaproteobacteria;Hyphomicrobiales;Nitrobacteraceae;Bradyrhizobium;Bradyrhizobium yuanmingense	1	10	4	10	0	3	2	2	32
Bacteria;Bacteria_none;Actinobacteria;Actinomycetia;Propionibacteriales;Nocardioidaceae;Propionicicella;Propionicicella superfundia	6	6	9	1	1	3	1	5	32
Bacteria;Bacteria_none;Bacteroidota;Cytophagia;Cytophagales;Cyclobacteriaceae;Cyclobacterium;Cyclobacterium qasimii	2	7	2	15	0	2	2	2	32
Bacteria;Bacteria_none;Firmicutes;Bacilli;Lactobacillales;Streptococcaceae;Streptococcus;Streptococcus porcorum	25	4	0	1	1	0	0	1	32
Bacteria;Bacteria_none;Proteobacteria;Alphaproteobacteria;Sphingomonadales;Sphingomonadaceae;Sphingopyxis;Sphingopyxis granuli	4	11	1	1	11	4	0	0	32
Bacteria;Bacteria_none;Firmicutes;Bacilli;Bacillales;Paenibacillaceae;Paenibacillus;Paenibacillus siamensis	1	6	12	3	2	8	0	0	32
Bacteria;Bacteria_none;Actinobacteria;Actinomycetia;Micromonosporales;Micromonosporaceae;Micromonospora;Micromonospora nigra	2	28	1	1	0	0	0	0	32
Bacteria;Bacteria_none;Planctomycetota;Planctomycetia;Planctomycetales;Planctomycetaceae;Thalassoglobus;Thalassoglobus polymorphus	5	13	3	6	2	2	0	1	32
Bacteria;Bacteria_none;Firmicutes;Clostridia;Eubacteriales;Lachnospiraceae;Lachnoclostridium;[Clostridium] herbivorans	3	12	4	7	0	3	0	3	32
Bacteria;Bacteria_none;Firmicutes;Negativicutes;Selenomonadales;Selenomonadaceae;Pectinatus;Pectinatus cerevisiiphilus	21	4	0	1	3	2	0	1	32
Bacteria;Bacteria_none;Proteobacteria;Alphaproteobacteria;Sphingomonadales;Sphingomonadaceae;Sphingobium;Sphingobium jiangsuense	0	0	15	14	0	0	3	0	32
Bacteria;Bacteria_none;Proteobacteria;Deltaproteobacteria;Syntrophobacterales;Syntrophobacteraceae;Desulforhabdus;Desulforhabdus amnigena	4	15	4	6	2	0	0	1	32
Bacteria;Bacteria_none;Firmicutes;Negativicutes;Veillonellales;Veillonellaceae;Megasphaera;Megasphaera vaginalis	1	0	5	15	0	4	7	0	32
Bacteria;Bacteria_none;Bacteroidota;Bacteroidia;Bacteroidales;Bacteroidaceae;Bacteroides;Bacteroides eggerthii	3	2	1	17	1	1	2	5	32
Bacteria;Bacteria_none;Actinobacteria;Actinomycetia;Corynebacteriales;Gordoniaceae;Gordonia;Gordonia jacobaea	0	0	2	27	0	0	2	1	32
Bacteria;Bacteria_none;Firmicutes;Clostridia;Eubacteriales;Peptococcaceae;Phosphitispora;Phosphitispora fastidiosa	3	4	6	2	3	13	1	0	32
Bacteria;Bacteria_none;Firmicutes;Clostridia;Eubacteriales;Peptostreptococcaceae;Tepidibacter;Tepidibacter mesophilus	1	4	16	0	6	5	0	0	32
Bacteria;Bacteria_none;Firmicutes;Clostridia;Thermoanaerobacterales;Thermoanaerobacteraceae;Thermacetogenium;Thermacetogenium phaeum	0	2	9	5	2	14	0	0	32
Bacteria;Bacteria_none;Actinobacteria;Actinomycetia;Micrococcales;Micrococcaceae;Arthrobacter;Arthrobacter stackebrandtii	6	13	4	7	0	1	1	0	32
Bacteria;Bacteria_none;Proteobacteria;Gammaproteobacteria;Chromatiales;Thioalkalibacteraceae;Thioalkalibacter;Thioalkalibacter halophilus	0	14	7	6	2	0	2	0	31
Bacteria;Bacteria_none;Fusobacteria;Fusobacteriia;Fusobacteriales;Leptotrichiaceae;Leptotrichia;Leptotrichia wadei	21	2	0	4	0	0	0	4	31
Bacteria;Bacteria_none;Spirochaetes;Spirochaetia;Spirochaetales;Breznakiellaceae;Gracilinema;Gracilinema caldarium	0	3	7	7	1	8	1	4	31
Bacteria;Bacteria_none;Planctomycetota;Planctomycetia;Isosphaerales;Isosphaeraceae;Tautonia;Tautonia marina	19	12	0	0	0	0	0	0	31
Bacteria;Bacteria_none;Actinobacteria;Actinomycetia;Corynebacteriales;Mycobacteriaceae;Mycobacterium;Mycobacterium simulans	2	4	7	14	0	3	1	0	31
Bacteria;Bacteria_none;Proteobacteria;Alphaproteobacteria;Rhodobacterales;Rhodobacteraceae;Thalassorhabdomicrobium;Thalassorhabdomicrobium marinisediminis	8	6	5	10	0	2	0	0	31
Bacteria;Bacteria_none;Bacteroidota;Bacteroidia;Bacteroidales;Prevotellaceae;Marseilla;Marseilla massiliensis	3	18	3	1	2	3	0	1	31
Bacteria;Bacteria_none;Proteobacteria;Alphaproteobacteria;Hyphomicrobiales;Brucellaceae;Brucella;Brucella tritici	0	0	31	0	0	0	0	0	31
Bacteria;Bacteria_none;Proteobacteria;Alphaproteobacteria;Rhodospirillales;Acetobacteraceae;Acidicaldus;Acidicaldus organivorans	11	9	3	6	0	2	0	0	31
Bacteria;Bacteria_none;Proteobacteria;Betaproteobacteria;Rhodocyclales;Azonexaceae;Dechloromonas;Dechloromonas hortensis	9	0	0	10	12	0	0	0	31
Bacteria;Bacteria_none;Actinobacteria;Actinomycetia;Nakamurellales;Nakamurellaceae;Nakamurella;Nakamurella multipartita	3	12	6	8	1	0	1	0	31
Bacteria;Bacteria_none;Spirochaetes;Spirochaetia;Spirochaetales;Treponemataceae;Treponema;Treponema succinifaciens	3	27	0	0	0	0	1	0	31
Bacteria;Bacteria_none;Proteobacteria;Alphaproteobacteria;Rhodobacterales;Rhodobacteraceae;Gemmobacter;Gemmobacter intermedius	8	3	6	7	1	3	2	1	31
Bacteria;Bacteria_none;Proteobacteria;Gammaproteobacteria;Cellvibrionales;Spongiibacteraceae;Zhongshania;Zhongshania marina	17	3	3	8	0	0	0	0	31
Bacteria;Bacteria_none;Bacteroidota;Cytophagia;Cytophagales;Cytophagaceae;Chryseotalea;Chryseotalea sanaruensis	17	9	0	3	0	0	0	2	31
Bacteria;Bacteria_none;Proteobacteria;Betaproteobacteria;Burkholderiales;Burkholderiales_Incertae_sedis;Leptothrix;Leptothrix mobilis	28	0	1	0	0	2	0	0	31
Bacteria;Bacteria_none;Proteobacteria;Deltaproteobacteria;Syntrophales;Syntrophaceae;Desulfomonile;Desulfomonile limimaris	5	11	0	1	12	2	0	0	31
Bacteria;Bacteria_none;Proteobacteria;Alphaproteobacteria;Sphingomonadales;Sphingomonadaceae;Sphingopyxis;Sphingopyxis microcysteis	0	0	13	18	0	0	0	0	31
Bacteria;Bacteria_none;Firmicutes;Bacilli;Lactobacillales;Streptococcaceae;Streptococcus;Streptococcus marmotae	29	1	0	1	0	0	0	0	31
Bacteria;Bacteria_none;Firmicutes;Bacilli;Bacillales;Bacillaceae;Virgibacillus;Virgibacillus salexigens	1	3	11	11	2	1	1	1	31
Bacteria;Bacteria_none;Proteobacteria;Gammaproteobacteria;Moraxellales;Moraxellaceae;Acinetobacter;Acinetobacter piscicola	17	1	4	8	0	0	0	1	31
Bacteria;Bacteria_none;Planctomycetota;Planctomycetia;Gemmatales;Gemmataceae;Gemmata;Gemmata massiliana	21	5	2	0	1	2	0	0	31
Bacteria;Bacteria_none;Actinobacteria;Actinomycetia;Streptomycetales;Streptomycetaceae;Streptomyces;Streptomyces griseiniger	0	2	7	9	3	5	5	0	31
Bacteria;Bacteria_none;Bacteroidota;Chitinophagia;Chitinophagales;Chitinophagaceae;Chitinophaga;Chitinophaga hostae	2	6	12	1	6	0	0	4	31
Bacteria;Bacteria_none;Firmicutes;Clostridia;Eubacteriales;Lachnospiraceae;Anaerostipes;Anaerostipes rhamnosivorans	3	6	13	1	3	3	1	1	31
Bacteria;Bacteria_none;Proteobacteria;Alphaproteobacteria;Hyphomicrobiales;Methylobacteriaceae;Methylobacterium;Methylobacterium tardum	12	3	4	12	0	0	0	0	31
Bacteria;Bacteria_none;Actinobacteria;Actinomycetia;Corynebacteriales;Dietziaceae;Dietzia;Dietzia psychralcaliphila	2	10	3	11	2	1	2	0	31
Bacteria;Bacteria_none;Actinobacteria;Actinomycetia;Micrococcales;Microbacteriaceae;Leucobacter;Leucobacter weissii	4	6	4	12	1	1	1	2	31
Bacteria;Bacteria_none;Firmicutes;Clostridia;Eubacteriales;Lachnospiraceae;Kineothrix;Kineothrix alysoides	6	2	13	3	2	3	1	1	31
Bacteria;Bacteria_none;Bacteroidota;Bacteroidia;Marinilabiliales;Marinilabiliaceae;Geofilum;Geofilum rhodophaeum	10	11	1	6	0	0	0	3	31
Bacteria;Bacteria_none;Firmicutes;Clostridia;Eubacteriales;Peptostreptococcaceae;Clostridioides;Clostridioides difficile	0	4	12	9	1	3	1	1	31
Bacteria;Bacteria_none;Proteobacteria;Gammaproteobacteria;Xanthomonadales;Xanthomonadaceae;Denitratimonas;Denitratimonas tolerans	28	2	1	0	0	0	0	0	31
Bacteria;Bacteria_none;Firmicutes;Bacilli;Lactobacillales;Streptococcaceae;Streptococcus;Streptococcus plurextorum	26	2	0	1	0	0	0	1	30
Bacteria;Bacteria_none;Cyanobacteria;Cyanobacteria_Incertae_sedis;Pseudanabaenales;Pseudanabaenaceae;Komvophoron;Komvophoron kgarii	1	5	10	9	1	1	0	3	30
Bacteria;Bacteria_none;Proteobacteria;Alphaproteobacteria;Rhodobacterales;Rhodobacteraceae;Paracoccus;Paracoccus panacisoli	11	4	6	7	0	2	0	0	30
Bacteria;Bacteria_none;Spirochaetes;Spirochaetia;Spirochaetales;Spirochaetaceae;Sediminispirochaeta;Sediminispirochaeta bajacaliforniensis	0	16	12	0	0	0	0	2	30
Bacteria;Bacteria_none;Firmicutes;Clostridia;Eubacteriales;Lachnospiraceae;Schaedlerella;Schaedlerella arabinosiphila	6	3	7	10	2	0	2	0	30
Bacteria;Bacteria_none;Proteobacteria;Gammaproteobacteria;Nevskiales;Sinobacteraceae;Polycyclovorans;Polycyclovorans algicola	9	4	6	6	1	3	1	0	30
Bacteria;Bacteria_none;Thermotogae;Thermotogae;Kosmotogales;Kosmotogaceae;Mesotoga;Mesotoga infera	0	10	18	0	2	0	0	0	30
Bacteria;Bacteria_none;Proteobacteria;Gammaproteobacteria;Vibrionales;Vibrionaceae;Vibrio;Vibrio campbellii	2	24	1	3	0	0	0	0	30
Bacteria;Bacteria_none;Firmicutes;Clostridia;Eubacteriales;Eubacteriales Family XIII. Incertae Sedis;Mogibacterium;Mogibacterium neglectum	3	5	14	2	2	0	2	2	30
Bacteria;Bacteria_none;Actinobacteria;Actinomycetia;Corynebacteriales;Corynebacteriaceae;Corynebacterium;Corynebacterium freneyi	0	3	4	17	2	0	1	3	30
Bacteria;Bacteria_none;Proteobacteria;Alphaproteobacteria;Rhodospirillales;Rhodospirillaceae;Elstera;Elstera litoralis	5	8	6	5	0	5	0	1	30
Bacteria;Bacteria_none;Proteobacteria;Betaproteobacteria;Burkholderiales;Comamonadaceae;Pelomonas;Pelomonas puraquae	10	17	1	0	0	2	0	0	30
Bacteria;Bacteria_none;Proteobacteria;Alphaproteobacteria;Hyphomicrobiales;Beijerinckiaceae;Pseudochelatococcus;Pseudochelatococcus contaminans	5	9	8	5	2	0	1	0	30
Bacteria;Bacteria_none;Firmicutes;Bacilli;Bacillales;Paenibacillaceae;Cohnella;Cohnella terrae	1	1	10	6	1	11	0	0	30
Bacteria;Bacteria_none;Proteobacteria;Gammaproteobacteria;Legionellales;Legionellaceae;Legionella;Legionella spiritensis	11	2	3	12	1	1	0	0	30
Bacteria;Bacteria_none;Proteobacteria;Gammaproteobacteria;Pasteurellales;Pasteurellaceae;Spirabiliibacterium;Spirabiliibacterium pneumoniae	22	3	3	2	0	0	0	0	30
Bacteria;Bacteria_none;Firmicutes;Clostridia;Eubacteriales;Eubacteriales_Incertae_sedis;Colidextribacter;Colidextribacter massiliensis	5	1	6	9	3	4	1	1	30
Bacteria;Bacteria_none;Firmicutes;Bacilli;Lactobacillales;Streptococcaceae;Streptococcus;Streptococcus sobrinus	23	2	4	0	0	0	1	0	30
Bacteria;Bacteria_none;Firmicutes;Negativicutes;Selenomonadales;Selenomonadaceae;Megamonas;Megamonas hypermegale	4	0	4	7	0	9	3	3	30
Bacteria;Bacteria_none;Firmicutes;Clostridia;Eubacteriales;Caldicoprobacteraceae;Caldicoprobacter;Caldicoprobacter algeriensis	5	17	1	7	0	0	0	0	30
Bacteria;Bacteria_none;Proteobacteria;Alphaproteobacteria;Hyphomicrobiales;Rhizobiaceae;Rhizobium;Rhizobium phaseoli	4	7	8	7	0	4	0	0	30
Bacteria;Bacteria_none;Firmicutes;Clostridia;Eubacteriales;Eubacteriales Family XIII. Incertae Sedis;Congobacterium;Congobacterium massiliense	8	2	8	0	6	0	6	0	30
Bacteria;Bacteria_none;Proteobacteria;Betaproteobacteria;Burkholderiales;Sphaerotilaceae;Azohydromonas;Azohydromonas aeria	22	3	0	5	0	0	0	0	30
Bacteria;Bacteria_none;Actinobacteria;Actinomycetia;Micrococcales;Ornithinimicrobiaceae;Ornithinimicrobium;Ornithinimicrobium tianjinense	1	7	8	10	0	1	1	2	30
Bacteria;Bacteria_none;Firmicutes;Clostridia;Eubacteriales;Eubacteriaceae;Eubacterium;Eubacterium ruminantium	6	6	5	3	2	4	3	1	30
Bacteria;Bacteria_none;Proteobacteria;Gammaproteobacteria;Xanthomonadales;Xanthomonadaceae;Lysobacter;Lysobacter ruipuensis	12	3	5	5	5	0	0	0	30
Bacteria;Bacteria_none;Firmicutes;Bacilli;Bacillales;Paenibacillaceae;Paenibacillus;Paenibacillus mesophilus	0	1	14	3	6	6	0	0	30
Bacteria;Bacteria_none;Firmicutes;Bacilli;Bacillales;Bacillales_Incertae_sedis;Exiguobacterium;Exiguobacterium undae	1	1	16	7	0	5	0	0	30
Bacteria;Bacteria_none;Proteobacteria;Gammaproteobacteria;Enterobacterales;Yersiniaceae;Serratia;Serratia plymuthica	15	4	3	7	0	0	1	0	30
Bacteria;Bacteria_none;Proteobacteria;Alphaproteobacteria;Hyphomicrobiales;Phreatobacteraceae;Phreatobacter;Phreatobacter oligotrophus	6	13	6	0	3	2	0	0	30
Bacteria;Bacteria_none;Proteobacteria;Betaproteobacteria;Rhodocyclales;Rhodocyclaceae;Dechlorobacter;Dechlorobacter hydrogenophilus	4	1	0	15	0	6	1	3	30
Bacteria;Bacteria_none;Bacteroidota;Flavobacteriia;Flavobacteriales;Flavobacteriaceae;Flavobacterium;Flavobacterium panacis	0	7	18	0	5	0	0	0	30
Bacteria;Bacteria_none;Proteobacteria;Betaproteobacteria;Burkholderiales;Burkholderiaceae;Paraburkholderia;Paraburkholderia kururiensis	25	5	0	0	0	0	0	0	30
Bacteria;Bacteria_none;Proteobacteria;Betaproteobacteria;Neisseriales;Neisseriaceae;Neisseria;Neisseria lactamica	4	9	2	11	0	2	1	1	30
Bacteria;Bacteria_none;Proteobacteria;Alphaproteobacteria;Hyphomicrobiales;Nitrobacteraceae;Bradyrhizobium;Bradyrhizobium ferriligni	2	15	1	10	1	1	0	0	30
Bacteria;Bacteria_none;Firmicutes;Bacilli;Lactobacillales;Enterococcaceae;Enterococcus;Enterococcus faecium	8	9	5	5	0	3	0	0	30
Bacteria;Bacteria_none;Proteobacteria;Gammaproteobacteria;Moraxellales;Moraxellaceae;Acinetobacter;Acinetobacter guillouiae	24	0	0	4	0	0	2	0	30
Bacteria;Bacteria_none;Firmicutes;Clostridia;Eubacteriales;Lachnospiraceae;Roseburia;Roseburia hominis	5	2	9	7	2	1	1	3	30
Bacteria;Bacteria_none;Firmicutes;Clostridia;Eubacteriales;Clostridiaceae;Wukongibacter;Wukongibacter baidiensis	4	9	2	6	0	3	4	2	30
Bacteria;Bacteria_none;Actinobacteria;Actinomycetia;Corynebacteriales;Mycobacteriaceae;Mycobacterium;Mycobacterium crocinum	11	7	2	6	0	2	1	1	30
Bacteria;Bacteria_none;Proteobacteria;Gammaproteobacteria;Chromatiales;Chromatiaceae;Caldichromatium;Caldichromatium japonicum	7	12	3	3	0	1	2	1	29
Bacteria;Bacteria_none;Bacteroidota;Chitinophagia;Chitinophagales;Chitinophagaceae;Chitinophaga;Chitinophaga eiseniae	16	6	1	5	0	0	0	1	29
Bacteria;Bacteria_none;Proteobacteria;Gammaproteobacteria;Legionellales;Legionellaceae;Legionella;Legionella taurinensis	9	3	12	4	0	1	0	0	29
Bacteria;Bacteria_none;Planctomycetota;Planctomycetia;Planctomycetales;Planctomycetaceae;Symmachiella;Symmachiella dynata	6	7	2	9	0	5	0	0	29
Bacteria;Bacteria_none;Proteobacteria;Epsilonproteobacteria;Campylobacterales;Sulfurospirillaceae;Sulfurospirillum;Sulfurospirillum cavolei	3	0	2	5	0	16	2	1	29
Bacteria;Bacteria_none;Proteobacteria;Betaproteobacteria;Burkholderiales;Burkholderiaceae;Caballeronia;Caballeronia jiangsuensis	17	7	4	0	0	0	1	0	29
Bacteria;Bacteria_none;Proteobacteria;Alphaproteobacteria;Hyphomicrobiales;Devosiaceae;Devosia;Devosia oryziradicis	11	3	2	13	0	0	0	0	29
Bacteria;Bacteria_none;Actinobacteria;Actinomycetia;Streptomycetales;Streptomycetaceae;Streptomyces;Streptomyces longisporoflavus	4	15	2	7	1	0	0	0	29
Bacteria;Bacteria_none;Planctomycetota;Planctomycetia;Pirellulales;Lacipirellulaceae;Posidoniimonas;Posidoniimonas polymericola	0	4	0	25	0	0	0	0	29
Bacteria;Bacteria_none;Proteobacteria;Alphaproteobacteria;Hyphomicrobiales;Xanthobacteraceae;Xanthobacter;Xanthobacter flavus	4	13	4	4	0	0	0	4	29
Bacteria;Bacteria_none;Proteobacteria;Betaproteobacteria;Burkholderiales;Comamonadaceae;Rhodoferax;Rhodoferax koreense	25	1	1	0	0	0	0	2	29
Bacteria;Bacteria_none;Firmicutes;Clostridia;Eubacteriales;Lachnospiraceae;Murimonas;Murimonas intestini	0	2	13	8	1	1	2	2	29
Bacteria;Bacteria_none;Firmicutes;Clostridia;Eubacteriales;Eubacteriales Family XII. Incertae Sedis;Acidaminobacter;Acidaminobacter hydrogenoformans	2	11	6	3	2	5	0	0	29
Bacteria;Bacteria_none;Bacteroidota;Flavobacteriia;Flavobacteriales;Flavobacteriaceae;Nonlabens;Nonlabens tegetincola	0	1	25	3	0	0	0	0	29
Bacteria;Bacteria_none;Firmicutes;Bacilli;Lactobacillales;Enterococcaceae;Vagococcus;Vagococcus fluvialis	29	0	0	0	0	0	0	0	29
Bacteria;Bacteria_none;Proteobacteria;Alphaproteobacteria;Rhodobacterales;Rhodobacteraceae;Marimonas;Marimonas arenosa	3	9	6	4	1	4	2	0	29
Bacteria;Bacteria_none;Firmicutes;Bacilli;Lactobacillales;Streptococcaceae;Streptococcus;Streptococcus orisasini	23	2	1	2	1	0	0	0	29
Bacteria;Bacteria_none;Firmicutes;Bacilli;Bacillales;Paenibacillaceae;Paenibacillus;Paenibacillus faecalis	0	0	10	2	3	11	3	0	29
Bacteria;Bacteria_none;Firmicutes;Clostridia;Thermoanaerobacterales;Thermoanaerobacteraceae;Moorella;Moorella stamsii	7	2	5	10	0	0	1	4	29
Bacteria;Bacteria_none;Firmicutes;Clostridia;Eubacteriales;Lachnospiraceae;Faecalicatena;Faecalicatena faecalis	3	4	19	0	2	1	0	0	29
Bacteria;Bacteria_none;Proteobacteria;Gammaproteobacteria;Enterobacterales;Enterobacteriaceae;Shimwellia;Shimwellia blattae	18	0	0	5	2	1	1	2	29
Bacteria;Bacteria_none;Firmicutes;Clostridia;Eubacteriales;Clostridiaceae;Clostridium;Clostridium vulturis	1	2	3	22	0	0	1	0	29
Bacteria;Bacteria_none;Bacteroidota;Bacteroidia;Bacteroidales;Tannerellaceae;Parabacteroides;Parabacteroides goldsteinii	0	6	0	15	0	6	2	0	29
Bacteria;Bacteria_none;Proteobacteria;Deltaproteobacteria;Desulfobacterales;Desulfobulbaceae;Desulfobulbus;Desulfobulbus propionicus	8	13	8	0	0	0	0	0	29
Bacteria;Bacteria_none;Proteobacteria;Gammaproteobacteria;Enterobacterales;Morganellaceae;Providencia;Providencia stuartii	23	0	1	0	0	1	4	0	29
Bacteria;Bacteria_none;Firmicutes;Bacilli;Bacillales;Bacillaceae;Gottfriedia;Gottfriedia acidiceleris	3	9	0	9	3	4	0	1	29
Bacteria;Bacteria_none;Proteobacteria;Betaproteobacteria;Burkholderiales;Burkholderiales_Incertae_sedis;Tepidimonas;Tepidimonas thermarum	13	6	7	0	1	1	0	1	29
Bacteria;Bacteria_none;Tenericutes;Mollicutes;Acholeplasmatales;Acholeplasmataceae;Haploplasma;Haploplasma modicum	0	16	12	0	1	0	0	0	29
Bacteria;Bacteria_none;Firmicutes;Clostridia;Eubacteriales;Lachnospiraceae;Anaerocolumna;Anaerocolumna chitinilytica	15	3	8	2	0	0	1	0	29
Bacteria;Bacteria_none;Proteobacteria;Alphaproteobacteria;Rhodospirillales;Acetobacteraceae;Roseomonas;Roseomonas mucosa	8	1	9	5	1	2	3	0	29
Bacteria;Bacteria_none;Actinobacteria;Actinomycetia;Propionibacteriales;Propionibacteriaceae;Naumannella;Naumannella cuiyingiana	0	0	17	5	0	6	1	0	29
Bacteria;Bacteria_none;Proteobacteria;Gammaproteobacteria;Enterobacterales;Enterobacteriaceae;Citrobacter;Citrobacter rodentium	26	0	0	0	0	1	2	0	29
Bacteria;Bacteria_none;Bacteroidota;Bacteroidia;Bacteroidales;Porphyromonadaceae;Porphyromonas;Porphyromonas endodontalis	0	3	1	22	0	1	2	0	29
Bacteria;Bacteria_none;Firmicutes;Bacilli;Lactobacillales;Streptococcaceae;Lactococcus;Lactococcus cremoris	24	2	1	0	2	0	0	0	29
Bacteria;Bacteria_none;Spirochaetes;Spirochaetia;Spirochaetales;Treponemataceae;Treponema;Treponema socranskii	0	1	16	1	5	2	3	1	29
Bacteria;Bacteria_none;Firmicutes;Clostridia;Eubacteriales;Clostridiaceae;Clostridium;Clostridium saccharoperbutylacetonicum	2	2	8	4	6	4	2	0	28
Bacteria;Bacteria_none;Proteobacteria;Gammaproteobacteria;Enterobacterales;Enterobacteriaceae;Kluyvera;Kluyvera georgiana	24	0	0	2	0	2	0	0	28
Bacteria;Bacteria_none;Firmicutes;Clostridia;Eubacteriales;Lachnospiraceae;Mobilisporobacter;Mobilisporobacter senegalensis	9	4	6	3	0	0	2	4	28
Bacteria;Bacteria_none;Firmicutes;Bacilli;Lactobacillales;Streptococcaceae;Streptococcus;Streptococcus lactarius	23	0	1	1	0	2	1	0	28
Bacteria;Bacteria_none;Cyanobacteria;Cyanobacteria_Incertae_sedis;Nostocales;Rivulariaceae;Kyrtuthrix;Kyrtuthrix totonaca	12	6	9	0	0	1	0	0	28
Bacteria;Bacteria_none;Firmicutes;Clostridia;Eubacteriales;Eubacteriaceae;Alkalibaculum;Alkalibaculum sporogenes	0	14	11	2	0	1	0	0	28
Bacteria;Bacteria_none;Firmicutes;Clostridia;Halanaerobiales;Halobacteroidaceae;Orenia;Orenia sivashensis	0	6	17	1	0	1	1	2	28
Bacteria;Bacteria_none;Firmicutes;Clostridia;Eubacteriales;Clostridiaceae;Clostridium;Clostridium quinii	1	7	8	7	1	1	2	1	28
Bacteria;Bacteria_none;Firmicutes;Bacilli;Bacillales;Bacillaceae;Bacillus;Bacillus capparidis	2	1	15	4	0	6	0	0	28
Bacteria;Bacteria_none;Firmicutes;Clostridia;Eubacteriales;Peptostreptococcaceae;Filifactor;Filifactor villosus	5	5	12	1	2	0	3	0	28
Bacteria;Bacteria_none;Planctomycetota;Planctomycetia;Pirellulales;Thermoguttaceae;Thermostilla;Thermostilla marina	14	7	1	3	1	1	1	0	28
Bacteria;Bacteria_none;Proteobacteria;Betaproteobacteria;Burkholderiales;Comamonadaceae;Ramlibacter;Ramlibacter aquaticus	21	4	2	0	0	0	0	1	28
Bacteria;Bacteria_none;Firmicutes;Clostridia;Eubacteriales;Desulfitobacteriaceae;Desulfosporosinus;Desulfosporosinus orientis	0	2	6	3	1	11	4	1	28
Bacteria;Bacteria_none;Firmicutes;Clostridia;Eubacteriales;Lachnospiraceae;Frisingicoccus;Frisingicoccus caecimuris	6	4	6	1	2	0	9	0	28
Bacteria;Bacteria_none;Proteobacteria;Alphaproteobacteria;Caulobacterales;Caulobacteraceae;Phenylobacterium;Phenylobacterium panacis	17	6	2	1	0	0	0	2	28
Bacteria;Bacteria_none;Firmicutes;Negativicutes;Veillonellales;Veillonellaceae;Megasphaera;Megasphaera lornae	0	0	3	13	0	3	3	6	28
Bacteria;Bacteria_none;Firmicutes;Bacilli;Lactobacillales;Streptococcaceae;Streptococcus;Streptococcus loxodontisalivarius	24	2	0	2	0	0	0	0	28
Bacteria;Bacteria_none;Firmicutes;Bacilli;Bacillales;Bacillaceae;Bacillus;Bacillus pseudomycoides	5	5	5	4	0	5	3	1	28
Bacteria;Bacteria_none;Proteobacteria;Alphaproteobacteria;Sphingomonadales;Erythrobacteraceae;Pelagerythrobacter;Pelagerythrobacter rhizovicinus	3	7	10	4	1	0	1	2	28
Bacteria;Bacteria_none;Actinobacteria;Actinomycetia;Micrococcales;Microbacteriaceae;Leucobacter;Leucobacter komagatae	2	7	4	12	0	1	2	0	28
Bacteria;Bacteria_none;Planctomycetota;Planctomycetia;Isosphaerales;Isosphaeraceae;Tundrisphaera;Tundrisphaera lichenicola	24	2	0	1	0	1	0	0	28
Bacteria;Bacteria_none;Firmicutes;Clostridia;Eubacteriales;Eubacteriales Family XIII. Incertae Sedis;Casaltella;Casaltella massiliensis	0	10	9	0	3	6	0	0	28
Bacteria;Bacteria_none;Firmicutes;Clostridia;Eubacteriales;Syntrophomonadaceae;Thermosyntropha;Thermosyntropha lipolytica	4	1	16	2	2	3	0	0	28
Bacteria;Bacteria_none;Actinobacteria;Actinomycetia;Streptomycetales;Streptomycetaceae;Streptomyces;Streptomyces pharetrae	2	10	7	8	0	0	0	1	28
Bacteria;Bacteria_none;Proteobacteria;Gammaproteobacteria;Vibrionales;Vibrionaceae;Vibrio;Vibrio vulnificus	0	17	5	0	0	6	0	0	28
Bacteria;Bacteria_none;Firmicutes;Clostridia;Eubacteriales;Clostridiales Family XVII. Incertae Sedis;Thermaerobacter;Thermaerobacter composti	0	0	6	9	0	10	3	0	28
Bacteria;Bacteria_none;Firmicutes;Clostridia;Eubacteriales;Clostridiaceae;Abyssisolibacter;Abyssisolibacter fermentans	17	7	3	0	1	0	0	0	28
Bacteria;Bacteria_none;Bacteroidota;Bacteroidia;Marinilabiliales;Marinilabiliaceae;Labilibacter;Labilibacter marinus	0	2	8	9	2	1	6	0	28
Bacteria;Bacteria_none;Proteobacteria;Alphaproteobacteria;Hyphomicrobiales;Devosiaceae;Devosia;Devosia lucknowensis	0	0	9	11	3	1	4	0	28
Bacteria;Bacteria_none;Firmicutes;Bacilli;Lactobacillales;Streptococcaceae;Streptococcus;Streptococcus dentapri	24	1	1	2	0	0	0	0	28
Bacteria;Bacteria_none;Proteobacteria;Alphaproteobacteria;Hyphomicrobiales;Pleomorphomonadaceae;Chthonobacter;Chthonobacter rhizosphaerae	6	10	2	5	3	2	0	0	28
Bacteria;Bacteria_none;Planctomycetota;Phycisphaerae;Sedimentisphaerales;Sedimentisphaeraceae;Limihaloglobus;Limihaloglobus sulfuriphilus	2	3	6	6	2	8	0	1	28
Bacteria;Bacteria_none;Firmicutes;Bacilli;Bacillales;Paenibacillaceae;Brevibacillus;Brevibacillus levickii	0	0	18	3	1	2	4	0	28
Bacteria;Bacteria_none;Actinobacteria;Actinomycetia;Corynebacteriales;Mycobacteriaceae;Hoyosella;Hoyosella subflava	3	12	8	5	0	0	0	0	28
Bacteria;Bacteria_none;Proteobacteria;Betaproteobacteria;Burkholderiales;Comamonadaceae;Delftia;Delftia deserti	21	6	1	0	0	0	0	0	28
Bacteria;Bacteria_none;Actinobacteria;Actinomycetia;Pseudonocardiales;Pseudonocardiaceae;Pseudonocardia;Pseudonocardia petroleophila	0	3	5	18	0	2	0	0	28
Bacteria;Bacteria_none;Proteobacteria;Alphaproteobacteria;Hyphomicrobiales;Phyllobacteriaceae;Mesorhizobium;Mesorhizobium tianshanense	13	5	4	5	0	0	0	0	27
Bacteria;Bacteria_none;Proteobacteria;Alphaproteobacteria;Caulobacterales;Caulobacteraceae;Brevundimonas;Brevundimonas subvibrioides	12	5	4	3	0	0	0	3	27
Bacteria;Bacteria_none;Actinobacteria;Actinomycetia;Micrococcales;Dermabacteraceae;Brachybacterium;Brachybacterium horti	3	8	11	3	0	0	1	1	27
Bacteria;Bacteria_none;Firmicutes;Bacilli;Lactobacillales;Streptococcaceae;Streptococcus;Streptococcus caledonicus	19	3	2	1	1	1	0	0	27
Bacteria;Bacteria_none;Proteobacteria;Alphaproteobacteria;Hyphomicrobiales;Kaistiaceae;Kaistia;Kaistia hirudinis	5	8	8	2	2	2	0	0	27
Bacteria;Bacteria_none;Proteobacteria;Gammaproteobacteria;Nevskiales;Sinobacteraceae;Nevskia;Nevskia soli	12	1	2	5	5	2	0	0	27
Bacteria;Bacteria_none;Proteobacteria;Gammaproteobacteria;Aeromonadales;Aeromonadaceae;Aeromonas;Aeromonas rivipollensis	10	2	9	0	0	0	3	3	27
Bacteria;Bacteria_none;Proteobacteria;Gammaproteobacteria;Thiotrichales;Francisellaceae;Pseudofrancisella;Pseudofrancisella aestuarii	9	6	4	6	1	1	0	0	27
Bacteria;Bacteria_none;Actinobacteria;Actinomycetia;Corynebacteriales;Mycobacteriaceae;Mycolicibacterium;Mycolicibacterium gilvum	2	7	2	12	0	2	2	0	27
Bacteria;Bacteria_none;Proteobacteria;Gammaproteobacteria;Xanthomonadales;Xanthomonadaceae;Lysobacter;Lysobacter aestuarii	17	6	1	1	1	0	0	1	27
Bacteria;Bacteria_none;Proteobacteria;Alphaproteobacteria;Hyphomicrobiales;Hyphomicrobiaceae;Rhodoplanes;Rhodoplanes piscinae	7	5	10	0	0	5	0	0	27
Bacteria;Bacteria_none;Firmicutes;Clostridia;Eubacteriales;Lachnospiraceae;Blautia;Blautia liquoris	3	1	12	0	2	7	1	1	27
Bacteria;Bacteria_none;Proteobacteria;Gammaproteobacteria;Nevskiales;Steroidobacteraceae;Steroidobacter;Steroidobacter flavus	22	5	0	0	0	0	0	0	27
Bacteria;Bacteria_none;Lentisphaerae;Lentisphaeria;Victivallales;Victivallaceae;Victivallis;Victivallis vadensis	0	18	2	0	0	0	1	6	27
Bacteria;Bacteria_none;Bacteroidota;Cytophagia;Cytophagales;Hymenobacteraceae;Hymenobacter;Hymenobacter baengnokdamensis	0	5	5	13	0	0	2	2	27
Bacteria;Bacteria_none;Firmicutes;Bacilli;Bacillales;Bacillaceae;Natribacillus;Natribacillus halophilus	0	3	19	0	4	1	0	0	27
Bacteria;Bacteria_none;Actinobacteria;Actinomycetia;Corynebacteriales;Nocardiaceae;Nocardia;Nocardia zapadnayensis	1	3	8	12	0	1	1	1	27
Bacteria;Bacteria_none;Proteobacteria;Gammaproteobacteria;Xanthomonadales;Xanthomonadaceae;Chujaibacter;Chujaibacter soli	12	8	1	2	1	0	1	2	27
Bacteria;Bacteria_none;Proteobacteria;Gammaproteobacteria;Methylococcales;Methylococcaceae;Methyloparacoccus;Methyloparacoccus murrellii	4	12	3	5	0	3	0	0	27
Bacteria;Bacteria_none;Proteobacteria;Gammaproteobacteria;Moraxellales;Moraxellaceae;Acinetobacter;Acinetobacter refrigeratoris	10	2	3	11	1	0	0	0	27
Bacteria;Bacteria_none;Proteobacteria;Alphaproteobacteria;Caulobacterales;Caulobacteraceae;Brevundimonas;Brevundimonas diminuta	12	7	3	2	2	0	1	0	27
Bacteria;Bacteria_none;Actinobacteria;Actinomycetia;Pseudonocardiales;Pseudonocardiaceae;Herbihabitans;Herbihabitans rhizosphaerae	1	1	0	24	0	1	0	0	27
Bacteria;Bacteria_none;Proteobacteria;Alphaproteobacteria;Rhodobacterales;Rhodobacteraceae;Rhodosalinus;Rhodosalinus sediminis	7	9	2	3	2	4	0	0	27
Bacteria;Bacteria_none;Proteobacteria;Gammaproteobacteria;Moraxellales;Moraxellaceae;Acinetobacter;Acinetobacter puyangensis	1	0	21	5	0	0	0	0	27
Bacteria;Bacteria_none;Firmicutes;Tissierellia;Tissierellales;Tissierellaceae;Soehngenia;Soehngenia longivitae	0	0	1	14	2	6	3	1	27
Bacteria;Bacteria_none;Proteobacteria;Betaproteobacteria;Burkholderiales;Burkholderiaceae;Chitinimonas;Chitinimonas naiadis	19	5	1	0	1	1	0	0	27
Bacteria;Bacteria_none;Proteobacteria;Alphaproteobacteria;Hyphomicrobiales;Brucellaceae;Brucella;Brucella thiophenivorans	20	0	0	0	0	7	0	0	27
Bacteria;Bacteria_none;Proteobacteria;Betaproteobacteria;Neisseriales;Neisseriaceae;Eikenella;Eikenella longinqua	21	3	1	0	0	2	0	0	27
Bacteria;Bacteria_none;Proteobacteria;Alphaproteobacteria;Hyphomicrobiales;Brucellaceae;Brucella;Brucella haematophila	0	7	4	16	0	0	0	0	27
Bacteria;Bacteria_none;Proteobacteria;Alphaproteobacteria;Hyphomicrobiales;Brucellaceae;Brucella;Brucella ciceri	11	9	1	6	0	0	0	0	27
Bacteria;Bacteria_none;Firmicutes;Erysipelotrichia;Erysipelotrichales;Erysipelotrichaceae;Erysipelothrix;Erysipelothrix inopinata	0	1	15	5	1	0	0	5	27
Bacteria;Bacteria_none;Proteobacteria;Gammaproteobacteria;Xanthomonadales;Rhodanobacteraceae;Tahibacter;Tahibacter aquaticus	12	11	2	0	0	0	0	2	27
Bacteria;Bacteria_none;Proteobacteria;Betaproteobacteria;Burkholderiales;Comamonadaceae;Comamonas;Comamonas phosphati	18	0	7	0	0	2	0	0	27
Bacteria;Bacteria_none;Firmicutes;Clostridia;Eubacteriales;Desulfotomaculaceae;Desulfotomaculum;Desulfotomaculum nigrificans	1	5	13	3	3	1	0	1	27
Bacteria;Bacteria_none;Firmicutes;Bacilli;Bacillales;Bacillaceae;Bacillus;Bacillus aquiflavi	1	1	8	3	1	11	2	0	27
Bacteria;Bacteria_none;Proteobacteria;Alphaproteobacteria;Rhodospirillales;Rhodospirillaceae;Caenispirillum;Caenispirillum bisanense	9	14	2	2	0	0	0	0	27
Bacteria;Bacteria_none;Proteobacteria;Betaproteobacteria;Burkholderiales;Comamonadaceae;Macromonas;Macromonas bipunctata	17	8	0	0	0	2	0	0	27
Bacteria;Bacteria_none;Proteobacteria;Gammaproteobacteria;Enterobacterales;Enterobacteriaceae;Cronobacter;Cronobacter muytjensii	20	1	2	4	0	0	0	0	27
Bacteria;Bacteria_none;Proteobacteria;Gammaproteobacteria;Enterobacterales;Morganellaceae;Morganella;Morganella morganii	23	0	0	2	0	0	0	2	27
Bacteria;Bacteria_none;Bacteroidota;Bacteroidia;Bacteroidales;Tannerellaceae;Parabacteroides;Parabacteroides gordonii	1	5	7	9	0	0	4	1	27
Bacteria;Bacteria_none;Bacteroidota;Bacteroidia;Marinilabiliales;Prolixibacteraceae;Aquipluma;Aquipluma nitroreducens	14	8	3	0	0	1	0	0	26
Bacteria;Bacteria_none;Firmicutes;Tissierellia;Tissierellales;Tissierellaceae;Tepidimicrobium;Tepidimicrobium ferriphilum	0	0	1	0	0	25	0	0	26
Bacteria;Bacteria_none;Proteobacteria;Gammaproteobacteria;Legionellales;Legionellaceae;Legionella;Legionella drancourtii	4	1	9	7	1	3	0	1	26
Bacteria;Bacteria_none;Proteobacteria;Alphaproteobacteria;Rhodospirillales;Acetobacteraceae;Falsiroseomonas;Falsiroseomonas stagni	7	11	4	3	0	0	1	0	26
Bacteria;Bacteria_none;Chlamydiae;Chlamydiia;Parachlamydiales;Simkaniaceae;Simkania;Simkania negevensis	2	23	1	0	0	0	0	0	26
Bacteria;Bacteria_none;Proteobacteria;Gammaproteobacteria;Enterobacterales;Enterobacteriaceae;Citrobacter;Citrobacter arsenatis	20	0	0	6	0	0	0	0	26
Bacteria;Bacteria_none;Actinobacteria;Actinomycetia;Streptomycetales;Streptomycetaceae;Streptomyces;Streptomyces subrutilus	4	5	9	6	0	1	0	1	26
Bacteria;Bacteria_none;Proteobacteria;Gammaproteobacteria;Chromatiales;Chromatiaceae;Thioflavicoccus;Thioflavicoccus mobilis	12	11	0	0	0	3	0	0	26
Bacteria;Bacteria_none;Proteobacteria;Deltaproteobacteria;Desulfuromonadales;Geobacteraceae;Geotalea;Geotalea uraniireducens	0	0	20	6	0	0	0	0	26
Bacteria;Bacteria_none;Actinobacteria;Actinomycetia;Micrococcales;Microbacteriaceae;Salinibacterium;Salinibacterium amurskyense	7	0	0	12	0	0	0	7	26
Bacteria;Bacteria_none;Proteobacteria;Epsilonproteobacteria;Campylobacterales;Campylobacteraceae;Campylobacter;Campylobacter lanienae	1	0	16	8	0	0	1	0	26
Bacteria;Bacteria_none;Proteobacteria;Gammaproteobacteria;Alteromonadales;Idiomarinaceae;Pseudidiomarina;Pseudidiomarina piscicola	1	9	7	7	0	2	0	0	26
Bacteria;Bacteria_none;Proteobacteria;Alphaproteobacteria;Rhodobacterales;Rhodobacteraceae;Fuscibacter;Fuscibacter oryzae	8	5	2	7	1	2	1	0	26
Bacteria;Bacteria_none;Actinobacteria;Actinomycetia;Micrococcales;Ornithinimicrobiaceae;Ornithinimicrobium;Ornithinimicrobium cavernae	1	3	3	15	0	3	0	1	26
Bacteria;Bacteria_none;Proteobacteria;Gammaproteobacteria;Enterobacterales;Enterobacteriaceae;Klebsiella;Klebsiella quasivariicola	19	0	1	3	1	0	2	0	26
Bacteria;Bacteria_none;Proteobacteria;Alphaproteobacteria;Hyphomicrobiales;Pleomorphomonadaceae;Chthonobacter;Chthonobacter albigriseus	5	4	7	7	0	1	2	0	26
Bacteria;Bacteria_none;Firmicutes;Clostridia;Eubacteriales;Lachnospiraceae;Tyzzerella;Tyzzerella nexilis	3	9	6	4	1	3	0	0	26
Bacteria;Bacteria_none;Actinobacteria;Actinomycetia;Propionibacteriales;Nocardioidaceae;Nocardioides;Nocardioides flavescens	0	6	5	10	0	4	0	1	26
Bacteria;Bacteria_none;Firmicutes;Negativicutes;Selenomonadales;Sporomusaceae;Pelorhabdus;Pelorhabdus rhamnosifermentans	16	3	4	1	0	1	1	0	26
Bacteria;Bacteria_none;Proteobacteria;Alphaproteobacteria;Hyphomicrobiales;Ancalomicrobiaceae;Pinisolibacter;Pinisolibacter ravus	10	2	9	3	1	1	0	0	26
Bacteria;Bacteria_none;Bacteroidota;Bacteroidia;Bacteroidales;Rikenellaceae;Alistipes;Alistipes megaguti	9	13	1	0	0	3	0	0	26
Bacteria;Bacteria_none;Firmicutes;Bacilli;Lactobacillales;Enterococcaceae;Enterococcus;Enterococcus eurekensis	19	2	0	3	0	0	0	2	26
Bacteria;Bacteria_none;Proteobacteria;Gammaproteobacteria;Enterobacterales;Enterobacteriaceae;Enterobacter;Enterobacter kobei	16	1	0	4	0	0	1	3	25
Bacteria;Bacteria_none;Actinobacteria;Actinomycetia;Propionibacteriales;Propionibacteriaceae;Cutibacterium;Cutibacterium acnes	1	2	4	13	1	2	2	0	25
Bacteria;Bacteria_none;Proteobacteria;Gammaproteobacteria;Gammaproteobacteria_Incertae_sedis;Gammaproteobacteria_Incertae_sedis;Wohlfahrtiimonas;Wohlfahrtiimonas chitiniclastica	9	2	10	2	0	2	0	0	25
Bacteria;Bacteria_none;Lentisphaerae;Lentisphaeria;Victivallales;Victivallaceae;Victivallis;Victivallis lenta	11	6	2	3	0	3	0	0	25
Bacteria;Bacteria_none;Firmicutes;Bacilli;Bacillales;Bacillaceae;Alteribacillus;Alteribacillus alkaliphilus	0	0	0	17	0	8	0	0	25
Bacteria;Bacteria_none;Firmicutes;Negativicutes;Selenomonadales;Sporomusaceae;Pelosinus;Pelosinus propionicus	13	0	2	1	0	3	4	2	25
Bacteria;Bacteria_none;Deinococcus-Thermus;Deinococci;Thermales;Thermaceae;Meiothermus;Meiothermus granaticius	0	3	9	12	0	0	0	1	25
Bacteria;Bacteria_none;Actinobacteria;Actinomycetia;Propionibacteriales;Propionibacteriaceae;Tessaracoccus;Tessaracoccus lubricantis	2	7	6	4	2	1	2	1	25
Bacteria;Bacteria_none;Firmicutes;Clostridia;Halanaerobiales;Halanaerobiaceae;Halanaerobium;Halanaerobium congolense	1	0	11	6	0	4	3	0	25
Bacteria;Bacteria_none;Firmicutes;Bacilli;Bacillales;Bacillaceae;Aquisalibacillus;Aquisalibacillus elongatus	0	2	15	6	1	1	0	0	25
Bacteria;Bacteria_none;Proteobacteria;Gammaproteobacteria;Legionellales;Coxiellaceae;Aquicella;Aquicella siphonis	6	7	10	2	0	0	0	0	25
Bacteria;Bacteria_none;Actinobacteria;Actinomycetia;Pseudonocardiales;Pseudonocardiaceae;Lentzea;Lentzea cavernae	0	0	0	25	0	0	0	0	25
Bacteria;Bacteria_none;Proteobacteria;Gammaproteobacteria;Enterobacterales;Yersiniaceae;Serratia;Serratia ureilytica	19	0	0	3	0	2	0	1	25
Bacteria;Bacteria_none;Proteobacteria;Alphaproteobacteria;Hyphomicrobiales;Methylocystaceae;Methylopila;Methylopila henanensis	5	10	4	2	1	2	1	0	25
Bacteria;Bacteria_none;Firmicutes;Clostridia;Eubacteriales;Lachnospiraceae;Lachnoclostridium;[Clostridium] methoxybenzovorans	1	0	14	3	0	4	2	1	25
Bacteria;Bacteria_none;Firmicutes;Clostridia;Eubacteriales;Clostridiaceae;Butyricicoccus;Butyricicoccus intestinisimiae	17	3	2	0	0	0	1	2	25
Bacteria;Bacteria_none;Proteobacteria;Betaproteobacteria;Burkholderiales;Comamonadaceae;Oryzisolibacter;Oryzisolibacter propanilivorax	15	5	0	2	1	2	0	0	25
Bacteria;Bacteria_none;Proteobacteria;Alphaproteobacteria;Hyphomicrobiales;Hyphomicrobiaceae;Rhodoplanes;Rhodoplanes pokkaliisoli	4	7	2	2	5	5	0	0	25
Bacteria;Bacteria_none;Chloroflexi;Ktedonobacteria;Thermogemmatisporales;Thermogemmatisporaceae;Thermogemmatispora;Thermogemmatispora foliorum	0	0	25	0	0	0	0	0	25
Bacteria;Bacteria_none;Bacteroidota;Flavobacteriia;Flavobacteriales;Flavobacteriaceae;Muriicola;Muriicola jejuensis	0	23	2	0	0	0	0	0	25
Bacteria;Bacteria_none;Firmicutes;Clostridia;Eubacteriales;Lachnospiraceae;Moryella;Moryella indoligenes	3	4	7	4	1	3	0	3	25
Bacteria;Bacteria_none;Proteobacteria;Alphaproteobacteria;Hyphomicrobiales;Methylobacteriaceae;Methylobacterium;Methylobacterium platani	3	17	5	0	0	0	0	0	25
Bacteria;Bacteria_none;Firmicutes;Clostridia;Eubacteriales;Clostridiaceae;Clostridium;Clostridium intestinale	1	4	11	7	1	0	0	1	25
Bacteria;Bacteria_none;Firmicutes;Clostridia;Eubacteriales;Lachnospiraceae;Eisenbergiella;Eisenbergiella tayi	11	5	2	3	1	1	1	1	25
Bacteria;Bacteria_none;Bacteroidota;Cytophagia;Cytophagales;Fulvivirgaceae;Fulvivirga;Fulvivirga imtechensis	1	3	8	5	1	7	0	0	25
Bacteria;Bacteria_none;Firmicutes;Clostridia;Eubacteriales;Lachnospiraceae;Eisenbergiella;Eisenbergiella massiliensis	2	2	4	8	0	4	1	4	25
Bacteria;Bacteria_none;Proteobacteria;Gammaproteobacteria;Xanthomonadales;Xanthomonadaceae;Stenotrophomonas;Stenotrophomonas ginsengisoli	8	0	3	4	0	1	9	0	25
Bacteria;Bacteria_none;Actinobacteria;Actinomycetia;Micrococcales;Micrococcaceae;Arthrobacter;Arthrobacter sulfonylureivorans	3	5	6	5	1	2	1	2	25
Bacteria;Bacteria_none;Actinobacteria;Actinomycetia;Micromonosporales;Micromonosporaceae;Micromonospora;Micromonospora lupini	2	3	9	5	0	2	1	3	25
Bacteria;Bacteria_none;Proteobacteria;Betaproteobacteria;Nitrosomonadales;Spirillaceae;Spirillum;Spirillum volutans	13	6	2	0	2	1	1	0	25
Bacteria;Bacteria_none;Proteobacteria;Betaproteobacteria;Burkholderiales;Alcaligenaceae;Pigmentiphaga;Pigmentiphaga soli	11	9	4	0	0	1	0	0	25
Bacteria;Bacteria_none;Firmicutes;Bacilli;Lactobacillales;Lactobacillaceae;Pediococcus;Pediococcus acidilactici	3	7	3	6	0	2	1	3	25
Bacteria;Bacteria_none;Actinobacteria;Actinomycetia;Micrococcales;Microbacteriaceae;Microbacterium;Microbacterium radiodurans	0	4	7	7	1	1	3	2	25
Bacteria;Bacteria_none;Proteobacteria;Alphaproteobacteria;Sphingomonadales;Sphingomonadaceae;Novosphingobium;Novosphingobium decolorationis	7	9	4	2	1	1	1	0	25
Bacteria;Bacteria_none;Proteobacteria;Alphaproteobacteria;Rhodobacterales;Rhodobacteraceae;Rhodobaculum;Rhodobaculum claviforme	5	5	8	4	1	1	1	0	25
Bacteria;Bacteria_none;Firmicutes;Clostridia;Eubacteriales;Eubacteriaceae;Eubacterium;Eubacterium xylanophilum	9	2	6	2	1	4	1	0	25
Bacteria;Bacteria_none;Proteobacteria;Betaproteobacteria;Rhodocyclales;Rhodocyclaceae;Azospira;Azospira inquinata	1	2	9	5	2	6	0	0	25
Bacteria;Bacteria_none;Proteobacteria;Betaproteobacteria;Burkholderiales;Comamonadaceae;Malikia;Malikia spinosa	17	0	3	1	0	2	0	2	25
Bacteria;Bacteria_none;Proteobacteria;Alphaproteobacteria;Hyphomicrobiales;Phyllobacteriaceae;Mesorhizobium;Mesorhizobium waimense	0	25	0	0	0	0	0	0	25
Bacteria;Bacteria_none;Proteobacteria;Epsilonproteobacteria;Campylobacterales;Sulfurospirillaceae;Sulfurospirillum;Sulfurospirillum barnesii	1	8	5	2	0	4	3	2	25
Bacteria;Bacteria_none;Bacteroidota;Bacteroidia;Marinilabiliales;Prolixibacteraceae;Mariniphaga;Mariniphaga anaerophila	0	20	0	0	1	4	0	0	25
Bacteria;Bacteria_none;Proteobacteria;Alphaproteobacteria;Rhodospirillales;Rhodospirillaceae;Denitrobaculum;Denitrobaculum tricleocarpae	6	6	3	7	2	1	0	0	25
Bacteria;Bacteria_none;Firmicutes;Bacilli;Bacillales;Thermoactinomycetaceae;Planifilum;Planifilum fimeticola	2	2	11	3	3	2	1	1	25
Bacteria;Bacteria_none;Firmicutes;Clostridia;Eubacteriales;Clostridiaceae;Serpentinicella;Serpentinicella alkaliphila	1	10	8	2	2	1	1	0	25
Bacteria;Bacteria_none;Proteobacteria;Alphaproteobacteria;Rhodobacterales;Rhodobacteraceae;Chachezhania;Chachezhania antarctica	10	8	2	2	0	3	0	0	25
Bacteria;Bacteria_none;Bacteroidota;Bacteroidia;Bacteroidales;Tannerellaceae;Tannerella;Tannerella forsythia	0	8	2	5	1	2	1	6	25
Bacteria;Bacteria_none;Firmicutes;Clostridia;Eubacteriales;Lachnospiraceae;Lacrimispora;Lacrimispora saccharolytica	25	0	0	0	0	0	0	0	25
Bacteria;Bacteria_none;Bacteroidota;Bacteroidia;Bacteroidales;Rikenellaceae;Alistipes;Alistipes dispar	0	25	0	0	0	0	0	0	25
Bacteria;Bacteria_none;Actinobacteria;Actinomycetia;Micrococcales;Microbacteriaceae;Microbacterium;Microbacterium hatanonis	1	3	9	7	0	1	2	2	25
Bacteria;Bacteria_none;Tenericutes;Mollicutes;Acholeplasmatales;Acholeplasmataceae;Haploplasma;Haploplasma axanthum	0	0	6	8	1	10	0	0	25
Bacteria;Bacteria_none;Proteobacteria;Gammaproteobacteria;Methylococcales;Methylococcaceae;Methylocaldum;Methylocaldum gracile	2	2	3	11	3	4	0	0	25
Bacteria;Bacteria_none;Actinobacteria;Actinomycetia;Corynebacteriales;Mycobacteriaceae;Mycolicibacterium;Mycolicibacterium malmesburyense	0	5	11	2	1	4	1	1	25
Bacteria;Bacteria_none;Actinobacteria;Actinomycetia;Corynebacteriales;Nocardiaceae;Nocardia;Nocardia puris	0	1	10	6	0	8	0	0	25
Bacteria;Bacteria_none;Proteobacteria;Alphaproteobacteria;Maricaulales;Maricaulaceae;Woodsholea;Woodsholea maritima	5	10	2	4	0	1	0	3	25
Bacteria;Bacteria_none;Firmicutes;Negativicutes;Selenomonadales;Selenomonadaceae;Megamonas;Megamonas rupellensis	7	7	5	1	1	1	2	0	24
Bacteria;Bacteria_none;Proteobacteria;Alphaproteobacteria;Sphingomonadales;Sphingomonadaceae;Sphingopyxis;Sphingopyxis bauzanensis	19	0	0	0	0	0	5	0	24
Bacteria;Bacteria_none;Firmicutes;Clostridia;Eubacteriales;Clostridiaceae;Clostridium;Clostridium lundense	0	0	4	11	2	1	4	2	24
Bacteria;Bacteria_none;Proteobacteria;Alphaproteobacteria;Rhodobacterales;Rhodobacteraceae;Pseudogemmobacter;Pseudogemmobacter hezensis	7	1	16	0	0	0	0	0	24
Bacteria;Bacteria_none;Bacteroidota;Cytophagia;Cytophagales;Spirosomaceae;Flectobacillus;Flectobacillus lacus	22	2	0	0	0	0	0	0	24
Bacteria;Bacteria_none;Firmicutes;Thermolithobacteria;Thermolithobacterales;Thermolithobacteraceae;Thermolithobacter;Thermolithobacter carboxydivorans	0	5	13	2	2	2	0	0	24
Bacteria;Bacteria_none;Thermotogae;Thermotogae;Thermotogales;Fervidobacteriaceae;Fervidobacterium;Fervidobacterium riparium	0	0	4	4	3	11	1	1	24
Bacteria;Bacteria_none;Proteobacteria;Gammaproteobacteria;Xanthomonadales;Xanthomonadaceae;Thermomonas;Thermomonas hydrothermalis	18	0	1	5	0	0	0	0	24
Bacteria;Bacteria_none;Proteobacteria;Betaproteobacteria;Nitrosomonadales;Usitatibacteraceae;Usitatibacter;Usitatibacter palustris	15	4	0	3	1	0	1	0	24
Bacteria;Bacteria_none;Firmicutes;Clostridia;Thermoanaerobacterales;Thermoanaerobacteraceae;Calderihabitans;Calderihabitans maritimus	1	4	14	2	2	0	1	0	24
Bacteria;Bacteria_none;Actinobacteria;Actinomycetia;Pseudonocardiales;Pseudonocardiaceae;Amycolatopsis;Amycolatopsis granulosa	2	0	4	18	0	0	0	0	24
Bacteria;Bacteria_none;Actinobacteria;Actinomycetia;Micrococcales;Cellulomonadaceae;Cellulomonas;Cellulomonas bogoriensis	0	10	2	9	0	1	1	1	24
Bacteria;Bacteria_none;Firmicutes;Bacilli;Bacillales;Paenibacillaceae;Paenibacillus;Paenibacillus solisilvae	4	1	7	0	3	9	0	0	24
Bacteria;Bacteria_none;Firmicutes;Bacilli;Lactobacillales;Enterococcaceae;Enterococcus;Enterococcus faecalis	15	3	1	2	0	3	0	0	24
Bacteria;Bacteria_none;Actinobacteria;Actinomycetia;Micrococcales;Micrococcaceae;Kocuria;Kocuria himachalensis	0	12	2	6	2	1	0	1	24
Bacteria;Bacteria_none;Proteobacteria;Betaproteobacteria;Burkholderiales;Alcaligenaceae;Advenella;Advenella kashmirensis	9	7	3	1	2	1	1	0	24
Bacteria;Bacteria_none;Actinobacteria;Actinomycetia;Micrococcales;Microbacteriaceae;Microbacterium;Microbacterium lushaniae	6	0	6	6	1	5	0	0	24
Bacteria;Bacteria_none;Proteobacteria;Alphaproteobacteria;Sphingomonadales;Sphingomonadaceae;Sphingobium;Sphingobium xenophagum	11	7	1	3	0	0	2	0	24
Bacteria;Bacteria_none;Proteobacteria;Gammaproteobacteria;Enterobacterales;Enterobacteriaceae;Kosakonia;Kosakonia sacchari	13	0	0	11	0	0	0	0	24
Bacteria;Bacteria_none;Firmicutes;Clostridia;Eubacteriales;Eubacteriales Family XII. Incertae Sedis;Fusibacter;Fusibacter tunisiensis	1	3	13	0	6	1	0	0	24
Bacteria;Bacteria_none;Firmicutes;Bacilli;Lactobacillales;Streptococcaceae;Streptococcus;Streptococcus dentiloxodontae	15	4	1	2	1	0	1	0	24
Bacteria;Bacteria_none;Actinobacteria;Coriobacteriia;Eggerthellales;Eggerthellaceae;Eggerthella;Eggerthella guodeyinii	0	7	8	8	0	0	0	1	24
Bacteria;Bacteria_none;Firmicutes;Bacilli;Lactobacillales;Lactobacillaceae;Ligilactobacillus;Ligilactobacillus salivarius	17	6	0	1	0	0	0	0	24
Bacteria;Bacteria_none;Proteobacteria;Alphaproteobacteria;Iodidimonadales;Iodidimonadaceae;Iodidimonas;Iodidimonas gelatinilytica	0	3	11	7	3	0	0	0	24
Bacteria;Bacteria_none;Firmicutes;Clostridia;Eubacteriales;Clostridiaceae;Clostridium;Clostridium saccharobutylicum	4	2	3	6	3	3	1	2	24
Bacteria;Bacteria_none;Bacteroidota;Sphingobacteriia;Sphingobacteriales;Sphingobacteriaceae;Pedobacter;Pedobacter jeongneungensis	5	5	3	8	1	1	1	0	24
Bacteria;Bacteria_none;Firmicutes;Clostridia;Eubacteriales;Clostridiaceae;Paramaledivibacter;Paramaledivibacter caminithermalis	0	2	14	0	2	3	1	2	24
Bacteria;Bacteria_none;Firmicutes;Bacilli;Bacillales;Alicyclobacillaceae;Tumebacillus;Tumebacillus algifaecis	0	0	4	4	7	9	0	0	24
Bacteria;Bacteria_none;Proteobacteria;Gammaproteobacteria;Methylococcales;Methylococcaceae;Methylocaldum;Methylocaldum tepidum	0	10	0	10	0	4	0	0	24
Bacteria;Bacteria_none;Firmicutes;Bacilli;Bacillales;Bacillaceae;Paraliobacillus;Paraliobacillus sediminis	1	2	12	1	3	5	0	0	24
Bacteria;Bacteria_none;Proteobacteria;Deltaproteobacteria;Syntrophales;Syntrophaceae;Desulfobacca;Desulfobacca acetoxidans	0	12	3	0	9	0	0	0	24
Bacteria;Bacteria_none;Proteobacteria;Alphaproteobacteria;Hyphomicrobiales;Devosiaceae;Devosia;Devosia confluentis	15	6	0	3	0	0	0	0	24
Bacteria;Bacteria_none;Chloroflexi;Tepidiformia;Tepidiformales;Tepidiformaceae;Tepidiforma;Tepidiforma bonchosmolovskayae	3	6	13	0	0	1	1	0	24
Bacteria;Bacteria_none;Proteobacteria;Alphaproteobacteria;Rhodospirillales;Azospirillaceae;Azospirillum;Azospirillum tabaci	11	7	4	0	0	1	1	0	24
Bacteria;Bacteria_none;Proteobacteria;Epsilonproteobacteria;Campylobacterales;Helicobacteraceae;Helicobacter;Helicobacter canicola	0	9	15	0	0	0	0	0	24
Bacteria;Bacteria_none;Firmicutes;Bacilli;Bacillales;Bacillaceae;Weizmannia;Weizmannia coagulans	10	5	0	3	0	1	1	4	24
Bacteria;Bacteria_none;Proteobacteria;Betaproteobacteria;Burkholderiales;Burkholderiaceae;Pandoraea;Pandoraea thiooxydans	23	0	1	0	0	0	0	0	24
Bacteria;Bacteria_none;Proteobacteria;Betaproteobacteria;Burkholderiales;Alcaligenaceae;Pusillimonas;Pusillimonas thiosulfatoxidans	6	3	8	0	5	2	0	0	24
Bacteria;Bacteria_none;Proteobacteria;Alphaproteobacteria;Sphingomonadales;Erythrobacteraceae;Croceicoccus;Croceicoccus ponticola	12	2	2	8	0	0	0	0	24
Bacteria;Bacteria_none;Proteobacteria;Alphaproteobacteria;Rhodospirillales;Acetobacteraceae;Roseicella;Roseicella frigidaeris	4	11	5	0	3	1	0	0	24
Bacteria;Bacteria_none;Proteobacteria;Deltaproteobacteria;Desulfovibrionales;Desulfovibrionaceae;Desulfovibrio;Desulfovibrio biadhensis	1	21	0	0	1	0	1	0	24
Bacteria;Bacteria_none;Firmicutes;Clostridia;Eubacteriales;Clostridiaceae;Clostridium;Clostridium nitritogenes	4	6	1	6	0	3	2	2	24
Bacteria;Bacteria_none;Actinobacteria;Actinomycetia;Corynebacteriales;Mycobacteriaceae;Mycobacterium;Mycobacterium diernhoferi	3	12	1	6	0	1	0	1	24
Bacteria;Bacteria_none;Bacteroidota;Saprospiria;Saprospirales;Lewinellaceae;Neolewinella;Neolewinella persica	21	1	0	2	0	0	0	0	24
Bacteria;Bacteria_none;Planctomycetota;Planctomycetia;Pirellulales;Pirellulaceae;Rubripirellula;Rubripirellula lacrimiformis	14	4	0	5	0	1	0	0	24
Bacteria;Bacteria_none;Actinobacteria;Actinomycetia;Pseudonocardiales;Pseudonocardiaceae;Pseudonocardia;Pseudonocardia tetrahydrofuranoxydans	0	0	0	17	0	0	0	7	24
Bacteria;Bacteria_none;Proteobacteria;Alphaproteobacteria;Sphingomonadales;Sphingomonadaceae;Novosphingopyxis;Novosphingopyxis baekryungensis	4	3	3	11	2	0	0	1	24
Bacteria;Bacteria_none;Firmicutes;Clostridia;Eubacteriales;Oscillospiraceae;Acetivibrio;Acetivibrio ethanolgignens	0	0	12	1	1	9	0	1	24
Bacteria;Bacteria_none;Firmicutes;Clostridia;Eubacteriales;Lachnospiraceae;Anaerostipes;Anaerostipes faecis	16	0	3	5	0	0	0	0	24
Bacteria;Bacteria_none;Proteobacteria;Gammaproteobacteria;Oceanospirillales;Halomonadaceae;Kushneria;Kushneria phyllosphaerae	4	4	6	5	0	1	1	3	24
Bacteria;Bacteria_none;Proteobacteria;Alphaproteobacteria;Hyphomicrobiales;Nitrobacteraceae;Bradyrhizobium;Bradyrhizobium iriomotense	3	15	0	6	0	0	0	0	24
Bacteria;Bacteria_none;Proteobacteria;Gammaproteobacteria;Chromatiales;Ectothiorhodospiraceae;Ectothiorhodospira;Ectothiorhodospira salini	14	6	2	1	1	0	0	0	24
Bacteria;Bacteria_none;Bacteroidota;Bacteroidia;Marinilabiliales;Prolixibacteraceae;Prolixibacter;Prolixibacter denitrificans	2	19	0	0	2	0	0	1	24
Bacteria;Bacteria_none;Bacteroidota;Bacteroidia;Bacteroidales;Dysgonomonadaceae;Dysgonomonas;Dysgonomonas alginatilytica	6	15	0	2	0	0	0	1	24
Bacteria;Bacteria_none;Proteobacteria;Betaproteobacteria;Burkholderiales;Comamonadaceae;Acidovorax;Acidovorax antarcticus	16	0	6	1	1	0	0	0	24
Bacteria;Bacteria_none;Firmicutes;Bacilli;Lactobacillales;Lactobacillaceae;Limosilactobacillus;Limosilactobacillus fermentum	16	7	0	0	0	0	0	0	23
Bacteria;Bacteria_none;Firmicutes;Clostridia;Eubacteriales;Clostridiaceae;Clostridium;Clostridium porci	3	0	7	10	0	3	0	0	23
Bacteria;Bacteria_none;Firmicutes;Erysipelotrichia;Erysipelotrichales;Erysipelotrichaceae;Faecalibaculum;Faecalibaculum rodentium	4	17	0	2	0	0	0	0	23
Bacteria;Bacteria_none;Firmicutes;Clostridia;Eubacteriales;Desulfitobacteriaceae;Desulfosporosinus;Desulfosporosinus acidiphilus	0	14	8	0	0	1	0	0	23
Bacteria;Bacteria_none;Firmicutes;Clostridia;Eubacteriales;Clostridiaceae;Clostridium;Clostridium mobile	3	15	1	0	0	1	1	2	23
Bacteria;Bacteria_none;Actinobacteria;Actinomycetia;Propionibacteriales;Propionibacteriaceae;Microlunatus;Microlunatus aurantiacus	2	6	7	4	0	0	3	1	23
Bacteria;Bacteria_none;Firmicutes;Clostridia;Eubacteriales;Desulfitobacteriaceae;Desulfosporosinus;Desulfosporosinus hippei	2	5	13	0	1	0	1	1	23
Bacteria;Bacteria_none;Proteobacteria;Alphaproteobacteria;Rhodobacterales;Rhodobacteraceae;Paracoccus;Paracoccus oceanense	13	4	2	3	0	1	0	0	23
Bacteria;Bacteria_none;Spirochaetes;Spirochaetia;Spirochaetales;Treponemataceae;Treponema;Treponema primitia	0	21	1	0	0	0	0	1	23
Bacteria;Bacteria_none;Firmicutes;Bacilli;Lactobacillales;Lactobacillaceae;Lactobacillus;Lactobacillus amylovorus	19	1	2	0	0	1	0	0	23
Bacteria;Bacteria_none;Firmicutes;Clostridia;Eubacteriales;Lachnospiraceae;Cuneatibacter;Cuneatibacter caecimuris	0	2	9	4	4	3	0	1	23
Bacteria;Bacteria_none;Firmicutes;Bacilli;Lactobacillales;Enterococcaceae;Enterococcus;Enterococcus durans	7	10	5	1	0	0	0	0	23
Bacteria;Bacteria_none;Bacteroidota;Bacteroidia;Bacteroidales;Bacteroidaceae;Phocaeicola;Phocaeicola vulgatus	0	0	2	20	0	1	0	0	23
Bacteria;Bacteria_none;Firmicutes;Clostridia;Eubacteriales;Lachnospiraceae;Catonella;Catonella morbi	0	0	23	0	0	0	0	0	23
Bacteria;Bacteria_none;Planctomycetota;Planctomycetia;Pirellulales;Pirellulaceae;Blastopirellula;Blastopirellula marina	0	5	0	16	0	0	0	2	23
Bacteria;Bacteria_none;Proteobacteria;Gammaproteobacteria;Enterobacterales;Erwiniaceae;Pantoea;Pantoea pleuroti	15	4	2	1	0	0	0	1	23
Bacteria;Bacteria_none;Verrucomicrobia;Opitutae;Puniceicoccales;Puniceicoccaceae;Pelagicoccus;Pelagicoccus croceus	0	23	0	0	0	0	0	0	23
Bacteria;Bacteria_none;Bacteroidota;Bacteroidia;Bacteroidales;Prevotellaceae;Prevotella;Prevotella lacticifex	2	0	0	10	0	2	2	7	23
Bacteria;Bacteria_none;Proteobacteria;Gammaproteobacteria;Thiotrichales;Thiotrichaceae;Thiothrix;Thiothrix subterranea	9	14	0	0	0	0	0	0	23
Bacteria;Bacteria_none;Actinobacteria;Actinomycetia;Streptosporangiales;Thermomonosporaceae;Actinocorallia;Actinocorallia glomerata	0	0	1	20	1	0	1	0	23
Bacteria;Bacteria_none;Actinobacteria;Actinomycetia;Streptosporangiales;Streptosporangiaceae;Thermobispora;Thermobispora bispora	3	7	4	4	0	5	0	0	23
Bacteria;Bacteria_none;Actinobacteria;Rubrobacteria;Rubrobacterales;Rubrobacteraceae;Rubrobacter;Rubrobacter tropicus	0	5	13	2	0	0	0	3	23
Bacteria;Bacteria_none;Firmicutes;Clostridia;Eubacteriales;Clostridiales Family XVII. Incertae Sedis;Thermaerobacter;Thermaerobacter marianensis	0	0	8	2	5	5	3	0	23
Bacteria;Bacteria_none;Proteobacteria;Betaproteobacteria;Burkholderiales;Comamonadaceae;Corticibacter;Corticibacter populi	20	2	0	0	0	0	0	1	23
Bacteria;Bacteria_none;Firmicutes;Clostridia;Eubacteriales;Clostridiaceae;Hathewaya;Hathewaya histolytica	2	1	8	5	2	3	2	0	23
Bacteria;Bacteria_none;Actinobacteria;Actinomycetia;Pseudonocardiales;Pseudonocardiaceae;Saccharomonospora;Saccharomonospora iraqiensis	1	2	4	13	3	0	0	0	23
Bacteria;Bacteria_none;Kiritimatiellaeota;Kiritimatiellae;Kiritimatiellales;Kiritimatiellaceae;Kiritimatiella;Kiritimatiella glycovorans	2	19	1	1	0	0	0	0	23
Bacteria;Bacteria_none;Firmicutes;Bacilli;Bacillales;Bacillaceae;Salicibibacter;Salicibibacter halophilus	0	0	23	0	0	0	0	0	23
Bacteria;Bacteria_none;Proteobacteria;Deltaproteobacteria;Desulfovibrionales;Desulfovibrionaceae;Desulfohalovibrio;Desulfohalovibrio alkalitolerans	0	2	14	0	7	0	0	0	23
Bacteria;Bacteria_none;Proteobacteria;Gammaproteobacteria;Nevskiales;Sinobacteraceae;Solimonas;Solimonas flava	8	11	4	0	0	0	0	0	23
Bacteria;Bacteria_none;Firmicutes;Bacilli;Bacillales;Planococcaceae;Planococcus;Planococcus columbae	0	3	9	6	1	1	2	1	23
Bacteria;Bacteria_none;Firmicutes;Clostridia;Eubacteriales;Clostridiaceae;Clostridium;Clostridium massiliodielmoense	2	8	3	5	1	1	2	1	23
Bacteria;Bacteria_none;Proteobacteria;Alphaproteobacteria;Hyphomicrobiales;Hyphomicrobiaceae;Rhodoplanes;Rhodoplanes tepidicaeni	0	0	0	23	0	0	0	0	23
Bacteria;Bacteria_none;Proteobacteria;Deltaproteobacteria;Desulfovibrionales;Desulfovibrionaceae;Maridesulfovibrio;Maridesulfovibrio salinus	3	13	5	1	1	0	0	0	23
Bacteria;Bacteria_none;Proteobacteria;Gammaproteobacteria;Enterobacterales;Enterobacteriaceae;Escherichia;Escherichia marmotae	20	0	1	1	0	0	1	0	23
Bacteria;Bacteria_none;Firmicutes;Bacilli;Bacillales;Bacillales_Incertae_sedis;Gemella;Gemella cuniculi	0	0	21	0	1	1	0	0	23
Bacteria;Bacteria_none;Proteobacteria;Alphaproteobacteria;Hyphomicrobiales;Reyranellaceae;Reyranella;Reyranella graminifolii	7	5	5	5	1	0	0	0	23
Bacteria;Bacteria_none;Firmicutes;Clostridia;Eubacteriales;Lachnospiraceae;Sporobacterium;Sporobacterium olearium	6	5	4	3	2	1	1	1	23
Bacteria;Bacteria_none;Firmicutes;Clostridia;Eubacteriales;Clostridiaceae;Caloramator;Caloramator fervidus	11	1	1	4	0	6	0	0	23
Bacteria;Bacteria_none;Actinobacteria;Actinomycetia;Streptomycetales;Streptomycetaceae;Streptomyces;Streptomyces albicerus	1	1	5	8	2	6	0	0	23
Bacteria;Bacteria_none;Proteobacteria;Betaproteobacteria;Burkholderiales;Comamonadaceae;Giesbergeria;Giesbergeria kuznetsovii	21	2	0	0	0	0	0	0	23
Bacteria;Bacteria_none;Proteobacteria;Betaproteobacteria;Neisseriales;Neisseriaceae;Neisseria;Neisseria flavescens	11	1	4	5	0	1	0	1	23
Bacteria;Bacteria_none;Proteobacteria;Gammaproteobacteria;Alteromonadales;Idiomarinaceae;Aliidiomarina;Aliidiomarina soli	0	1	2	19	0	0	0	1	23
Bacteria;Bacteria_none;Proteobacteria;Betaproteobacteria;Nitrosomonadales;Nitrosomonadaceae;Nitrosomonas;Nitrosomonas aestuarii	10	7	2	1	0	1	2	0	23
Bacteria;Bacteria_none;Proteobacteria;Deltaproteobacteria;Desulfuromonadales;Geobacteraceae;Geobacter;Geobacter psychrophilus	13	10	0	0	0	0	0	0	23
Bacteria;Bacteria_none;Actinobacteria;Coriobacteriia;Coriobacteriales;Atopobiaceae;Olsenella;Olsenella urininfantis	5	6	5	1	2	3	0	1	23
Bacteria;Bacteria_none;Firmicutes;Negativicutes;Veillonellales;Veillonellaceae;Megasphaera;Megasphaera hutchinsoni	0	0	1	14	0	1	6	1	23
Bacteria;Bacteria_none;Firmicutes;Clostridia;Eubacteriales;Clostridiaceae;Clostridium;Clostridium hydrogeniformans	2	2	6	6	2	1	2	2	23
Bacteria;Bacteria_none;Proteobacteria;Alphaproteobacteria;Hyphomicrobiales;Rhizobiaceae;Rhizobium;Rhizobium daejeonense	10	0	2	6	5	0	0	0	23
Bacteria;Bacteria_none;Firmicutes;Bacilli;Bacillales;Planococcaceae;Jeotgalibacillus;Jeotgalibacillus campisalis	0	0	8	10	0	4	0	1	23
Bacteria;Bacteria_none;Actinobacteria;Actinomycetia;Pseudonocardiales;Pseudonocardiaceae;Saccharopolyspora;Saccharopolyspora thermophila	0	5	2	12	1	3	0	0	23
Bacteria;Bacteria_none;Firmicutes;Bacilli;Lactobacillales;Lactobacillaceae;Lentilactobacillus;Lentilactobacillus curieae	2	14	3	0	1	3	0	0	23
Bacteria;Bacteria_none;Proteobacteria;Gammaproteobacteria;Legionellales;Legionellaceae;Legionella;Legionella drozanskii	7	3	2	6	0	1	1	2	22
Bacteria;Bacteria_none;Actinobacteria;Actinomycetia;Micrococcales;Microbacteriaceae;Microbacterium;Microbacterium enclense	1	11	4	4	1	0	1	0	22
Bacteria;Bacteria_none;Firmicutes;Bacilli;Bacillales;Paenibacillaceae;Paenibacillus;Paenibacillus lupini	0	0	20	0	0	2	0	0	22
Bacteria;Bacteria_none;Firmicutes;Bacilli;Lactobacillales;Streptococcaceae;Lactococcus;Lactococcus hodotermopsidis	18	2	0	0	0	1	1	0	22
Bacteria;Bacteria_none;Firmicutes;Clostridia;Thermoanaerobacterales;Thermoanaerobacterales Family IV. Incertae Sedis;Mahella;Mahella australiensis	1	2	9	3	3	1	2	1	22
Bacteria;Bacteria_none;Proteobacteria;Gammaproteobacteria;Moraxellales;Moraxellaceae;Moraxella;Moraxella lincolnii	8	0	2	9	0	1	2	0	22
Bacteria;Bacteria_none;Proteobacteria;Gammaproteobacteria;Xanthomonadales;Rhodanobacteraceae;Chiayiivirga;Chiayiivirga flava	20	1	0	0	0	0	0	1	22
Bacteria;Bacteria_none;Firmicutes;Clostridia;Halanaerobiales;Halanaerobiaceae;Halanaerobium;Halanaerobium lacusrosei	0	2	15	1	0	1	1	2	22
Bacteria;Bacteria_none;Proteobacteria;Gammaproteobacteria;Enterobacterales;Pectobacteriaceae;Dickeya;Dickeya lacustris	18	0	0	3	1	0	0	0	22
Bacteria;Bacteria_none;Firmicutes;Clostridia;Eubacteriales;Lachnospiraceae;Enterocloster;Enterocloster lavalensis	20	2	0	0	0	0	0	0	22
Bacteria;Bacteria_none;Proteobacteria;Gammaproteobacteria;Enterobacterales;Pectobacteriaceae;Pectobacterium;Pectobacterium carotovorum	15	2	0	4	0	0	0	1	22
Bacteria;Bacteria_none;Firmicutes;Clostridia;Eubacteriales;Lachnospiraceae;Luxibacter;Luxibacter massiliensis	15	0	4	0	0	1	1	1	22
Bacteria;Bacteria_none;Firmicutes;Bacilli;Bacillales;Paenibacillaceae;Brevibacillus;Brevibacillus migulae	0	1	8	1	0	11	1	0	22
Bacteria;Bacteria_none;Proteobacteria;Alphaproteobacteria;Hyphomicrobiales;Ancalomicrobiaceae;Pinisolibacter;Pinisolibacter aquiterrae	5	6	7	3	0	0	1	0	22
Bacteria;Bacteria_none;Firmicutes;Clostridia;Eubacteriales;Desulfitobacteriaceae;Desulfosporosinus;Desulfosporosinus metallidurans	0	0	8	1	7	6	0	0	22
Bacteria;Bacteria_none;Gemmatimonadetes;Gemmatimonadetes;Gemmatimonadales;Gemmatimonadaceae;Roseisolibacter;Roseisolibacter agri	16	2	0	4	0	0	0	0	22
Bacteria;Bacteria_none;Proteobacteria;Alphaproteobacteria;Hyphomicrobiales;Rhizobiaceae;Rhizobium;Rhizobium albus	5	2	3	4	3	5	0	0	22
Bacteria;Bacteria_none;Firmicutes;Clostridia;Eubacteriales;Clostridiaceae;Anoxynatronum;Anoxynatronum sibiricum	1	13	5	0	0	2	1	0	22
Bacteria;Bacteria_none;Proteobacteria;Betaproteobacteria;Nitrosomonadales;Thiobacillaceae;Thiobacillus;Thiobacillus thioparus	15	3	2	0	0	1	1	0	22
Bacteria;Bacteria_none;Bacteroidota;Flavobacteriia;Flavobacteriales;Weeksellaceae;Chryseobacterium;Chryseobacterium panacis	0	1	4	11	0	6	0	0	22
Bacteria;Bacteria_none;Proteobacteria;Betaproteobacteria;Rhodocyclales;Azonexaceae;Azonexus;Azonexus caeni	11	3	3	0	0	1	2	2	22
Bacteria;Bacteria_none;Proteobacteria;Deltaproteobacteria;Desulfobacterales;Desulfobacteraceae;Desulfoluna;Desulfoluna butyratoxydans	0	13	5	3	0	0	0	1	22
Bacteria;Bacteria_none;Chlorobi;Chlorobia;Chlorobiales;Chlorobiaceae;Chlorobaculum;Chlorobaculum parvum	0	0	22	0	0	0	0	0	22
Bacteria;Bacteria_none;Proteobacteria;Alphaproteobacteria;Hyphomicrobiales;Methylocystaceae;Hansschlegelia;Hansschlegelia plantiphila	8	6	4	3	0	0	1	0	22
Bacteria;Bacteria_none;Proteobacteria;Deltaproteobacteria;Desulfuromonadales;Geobacteraceae;Geobacter;Geobacter pickeringii	0	11	11	0	0	0	0	0	22
Bacteria;Bacteria_none;Proteobacteria;Alphaproteobacteria;Hyphomicrobiales;Methylobacteriaceae;Methylorubrum;Methylorubrum rhodesianum	1	5	7	2	1	2	3	1	22
Bacteria;Bacteria_none;Cyanobacteria;Cyanobacteria_Incertae_sedis;Chroococcidiopsidales;Sinocapsaceae;Sinocapsa;Sinocapsa zengkensis	1	5	13	1	0	2	0	0	22
Bacteria;Bacteria_none;Proteobacteria;Epsilonproteobacteria;Campylobacterales;Arcobacteraceae;Aliarcobacter;Aliarcobacter cibarius	0	19	0	1	0	1	0	1	22
Bacteria;Bacteria_none;Cyanobacteria;Cyanobacteria_Incertae_sedis;Nostocales;Nostocaceae;Komarekiella;Komarekiella gloeocapsoidea	1	5	4	6	0	0	2	4	22
Bacteria;Bacteria_none;Firmicutes;Bacilli;Lactobacillales;Streptococcaceae;Streptococcus;Streptococcus troglodytidis	18	1	2	0	1	0	0	0	22
Bacteria;Bacteria_none;Proteobacteria;Epsilonproteobacteria;Campylobacterales;Helicobacteraceae;Helicobacter;Helicobacter valdiviensis	0	0	0	7	0	0	15	0	22
Bacteria;Bacteria_none;Proteobacteria;Alphaproteobacteria;Caulobacterales;Caulobacteraceae;Brevundimonas;Brevundimonas faecalis	0	0	0	22	0	0	0	0	22
Bacteria;Bacteria_none;Proteobacteria;Gammaproteobacteria;Chromatiales;Chromatiaceae;Arsukibacterium;Arsukibacterium ikkense	4	6	2	7	0	0	0	3	22
Bacteria;Bacteria_none;Actinobacteria;Coriobacteriia;Coriobacteriales;Atopobiaceae;Lancefieldella;Lancefieldella parvula	2	18	2	0	0	0	0	0	22
Bacteria;Bacteria_none;Bacteroidota;Flavobacteriia;Flavobacteriales;Weeksellaceae;Chryseobacterium;Chryseobacterium aquifrigidense	0	4	1	12	0	5	0	0	22
Bacteria;Bacteria_none;Bacteroidota;Flavobacteriia;Flavobacteriales;Flavobacteriaceae;Hyunsoonleella;Hyunsoonleella jejuensis	0	1	7	4	0	10	0	0	22
Bacteria;Bacteria_none;Bacteroidota;Cytophagia;Cytophagales;Bernardetiaceae;Garritya;Garritya polymorpha	0	0	7	11	0	2	1	1	22
Bacteria;Bacteria_none;Firmicutes;Clostridia;Eubacteriales;Clostridiaceae;Clostridium;Clostridium collagenovorans	1	0	4	11	0	0	3	3	22
Bacteria;Bacteria_none;Proteobacteria;Betaproteobacteria;Burkholderiales;Burkholderiaceae;Lautropia;Lautropia mirabilis	12	7	1	0	0	1	0	1	22
Bacteria;Bacteria_none;Firmicutes;Clostridia;Eubacteriales;Clostridiaceae;Clostridium;Clostridium fallax	2	0	2	11	0	3	3	1	22
Bacteria;Bacteria_none;Actinobacteria;Actinomycetia;Actinomycetales;Actinomycetaceae;Neoactinobaculum;Neoactinobaculum massilliense	2	1	9	3	0	3	2	2	22
Bacteria;Bacteria_none;Bacteroidota;Chitinophagia;Chitinophagales;Chitinophagaceae;Filimonas;Filimonas zeae	17	2	2	0	1	0	0	0	22
Bacteria;Bacteria_none;Proteobacteria;Betaproteobacteria;Burkholderiales;Alcaligenaceae;Achromobacter;Achromobacter aloeverae	14	6	1	0	0	1	0	0	22
Bacteria;Bacteria_none;Bacteroidota;Chitinophagia;Chitinophagales;Chitinophagaceae;Terrimonas;Terrimonas lutea	15	4	2	1	0	0	0	0	22
Bacteria;Bacteria_none;Proteobacteria;Betaproteobacteria;Burkholderiales;Comamonadaceae;Limnohabitans;Limnohabitans planktonicus	4	6	4	1	0	5	1	1	22
Bacteria;Bacteria_none;Proteobacteria;Alphaproteobacteria;Rhodobacterales;Rhodobacteraceae;Alexandriicola;Alexandriicola marinus	7	9	0	3	2	1	0	0	22
Bacteria;Bacteria_none;Bacteroidota;Bacteroidia;Bacteroidales;Dysgonomonadaceae;Dysgonomonas;Dysgonomonas massiliensis	2	3	6	3	6	2	0	0	22
Bacteria;Bacteria_none;Firmicutes;Clostridia;Eubacteriales;Clostridiaceae;Clostridium;Clostridium algoriphilum	1	2	5	8	1	3	1	1	22
Bacteria;Bacteria_none;Firmicutes;Clostridia;Eubacteriales;Clostridiaceae;Clostridium;Clostridium aciditolerans	22	0	0	0	0	0	0	0	22
Bacteria;Bacteria_none;Bacteroidota;Flavobacteriia;Flavobacteriales;Flavobacteriaceae;Dokdonia;Dokdonia pacifica	0	2	8	8	0	4	0	0	22
Bacteria;Bacteria_none;Proteobacteria;Alphaproteobacteria;Rhodobacterales;Rhodobacteraceae;Marinosulfonomonas;Marinosulfonomonas methylotropha	6	7	4	3	0	1	1	0	22
Bacteria;Bacteria_none;Actinobacteria;Rubrobacteria;Rubrobacterales;Rubrobacteraceae;Rubrobacter;Rubrobacter bracarensis	0	0	1	10	0	9	2	0	22
Bacteria;Bacteria_none;Proteobacteria;Betaproteobacteria;Neisseriales;Chromobacteriaceae;Chromobacterium;Chromobacterium paludis	12	5	1	1	1	1	0	1	22
Bacteria;Bacteria_none;Proteobacteria;Gammaproteobacteria;Chromatiales;Ectothiorhodospiraceae;Natronospira;Natronospira proteinivora	11	6	1	3	0	0	0	1	22
Bacteria;Bacteria_none;Firmicutes;Bacilli;Lactobacillales;Carnobacteriaceae;Alkalibacterium;Alkalibacterium olivapovliticus	0	22	0	0	0	0	0	0	22
Bacteria;Bacteria_none;Firmicutes;Bacilli;Lactobacillales;Streptococcaceae;Streptococcus;Streptococcus mutans	5	8	4	2	0	2	0	1	22
Bacteria;Bacteria_none;Firmicutes;Tissierellia;Tissierellales;Gottschalkiaceae;Gottschalkia;Gottschalkia acidurici	4	1	5	4	1	4	1	2	22
Bacteria;Bacteria_none;Proteobacteria;Gammaproteobacteria;Enterobacterales;Enterobacteriaceae;Kosakonia;Kosakonia pseudosacchari	15	3	0	3	0	0	0	1	22
Bacteria;Bacteria_none;Coprothermobacterota;Coprothermobacteria;Coprothermobacterales;Coprothermobacteraceae;Coprothermobacter;Coprothermobacter proteolyticus	0	0	3	0	0	17	1	0	21
Bacteria;Bacteria_none;Proteobacteria;Gammaproteobacteria;Moraxellales;Moraxellaceae;Acinetobacter;Acinetobacter junii	12	0	3	6	0	0	0	0	21
Bacteria;Bacteria_none;Firmicutes;Clostridia;Eubacteriales;Lachnospiraceae;Pseudobutyrivibrio;Pseudobutyrivibrio ruminis	8	6	3	1	1	0	1	1	21
Bacteria;Bacteria_none;Acidobacteria;Blastocatellia;Blastocatellales;Blastocatellaceae;Tellurimicrobium;Tellurimicrobium multivorans	3	0	6	8	0	0	0	4	21
Bacteria;Bacteria_none;Firmicutes;Clostridia;Eubacteriales;Clostridiaceae;Clostridium;Clostridium thiosulfatireducens	2	2	1	11	1	3	0	1	21
Bacteria;Bacteria_none;Proteobacteria;Alphaproteobacteria;Hyphomicrobiales;Rhizobiaceae;Ensifer;Ensifer sesbaniae	10	0	6	5	0	0	0	0	21
Bacteria;Bacteria_none;Proteobacteria;Alphaproteobacteria;Hyphomicrobiales;Rhizobiaceae;Ciceribacter;Ciceribacter naphthalenivorans	0	10	1	5	1	1	3	0	21
Bacteria;Bacteria_none;Firmicutes;Clostridia;Eubacteriales;Lachnospiraceae;Sellimonas;Sellimonas monacensis	2	10	2	1	1	5	0	0	21
Bacteria;Bacteria_none;Firmicutes;Negativicutes;Selenomonadales;Sporomusaceae;Sporomusa;Sporomusa ovata	6	3	7	0	0	2	1	2	21
Bacteria;Bacteria_none;Firmicutes;Bacilli;Lactobacillales;Aerococcaceae;Ruoffia;Ruoffia tabacinasalis	7	2	1	5	0	0	0	6	21
Bacteria;Bacteria_none;Firmicutes;Bacilli;Lactobacillales;Aerococcaceae;Fundicoccus;Fundicoccus fermenti	21	0	0	0	0	0	0	0	21
Bacteria;Bacteria_none;Actinobacteria;Actinomycetia;Streptosporangiales;Streptosporangiaceae;Streptosporangium;Streptosporangium yunnanense	2	3	2	13	0	0	1	0	21
Bacteria;Bacteria_none;Proteobacteria;Gammaproteobacteria;Xanthomonadales;Xanthomonadaceae;Arenimonas;Arenimonas oryziterrae	14	3	0	2	0	1	0	1	21
Bacteria;Bacteria_none;Actinobacteria;Actinomycetia;Streptomycetales;Streptomycetaceae;Streptomyces;Streptomyces luteosporeus	2	5	2	12	0	0	0	0	21
Bacteria;Bacteria_none;Proteobacteria;Gammaproteobacteria;Pasteurellales;Psittacicellaceae;Psittacicella;Psittacicella hinzii	2	1	4	9	2	0	3	0	21
Bacteria;Bacteria_none;Proteobacteria;Deltaproteobacteria;Desulfobacterales;Desulfobacteraceae;Desulfonema;Desulfonema ishimotonii	0	12	7	0	1	1	0	0	21
Bacteria;Bacteria_none;Firmicutes;Clostridia;Eubacteriales;Oscillospiraceae;Anaerotruncus;Anaerotruncus rubiinfantis	6	7	1	4	2	1	0	0	21
Bacteria;Bacteria_none;Proteobacteria;Gammaproteobacteria;Moraxellales;Moraxellaceae;Acinetobacter;Acinetobacter silvestris	0	0	4	16	0	0	0	1	21
Bacteria;Bacteria_none;Firmicutes;Bacilli;Bacillales;Bacillaceae;Anoxybacillus;Anoxybacillus sediminis	2	6	7	2	1	3	0	0	21
Bacteria;Bacteria_none;Proteobacteria;Alphaproteobacteria;Hyphomicrobiales;Rhodovibrionaceae;Tistlia;Tistlia consotensis	7	5	2	5	2	0	0	0	21
Bacteria;Bacteria_none;Firmicutes;Clostridia;Eubacteriales;Desulfallaceae;Desulfallas;Desulfallas sapomandens	0	1	17	0	3	0	0	0	21
Bacteria;Bacteria_none;Proteobacteria;Alphaproteobacteria;Hyphomicrobiales;Boseaceae;Bosea;Bosea eneae	0	0	14	0	0	7	0	0	21
Bacteria;Bacteria_none;Proteobacteria;Alphaproteobacteria;Rhodobacterales;Rhodobacteraceae;Psychromarinibacter;Psychromarinibacter halotolerans	7	5	3	3	1	1	0	1	21
Bacteria;Bacteria_none;Proteobacteria;Betaproteobacteria;Burkholderiales;Burkholderiaceae;Paraburkholderia;Paraburkholderia lycopersici	1	18	0	0	0	1	1	0	21
Bacteria;Bacteria_none;Firmicutes;Clostridia;Eubacteriales;Eubacteriales Family XIII. Incertae Sedis;Eubacteriales Family XIII. Incertae Sedis_Incertae_sedis;[Eubacterium] nodatum	0	2	10	2	2	4	1	0	21
Bacteria;Bacteria_none;Firmicutes;Bacilli;Lactobacillales;Lactobacillaceae;Lactiplantibacillus;Lactiplantibacillus plantarum	21	0	0	0	0	0	0	0	21
Bacteria;Bacteria_none;Proteobacteria;Betaproteobacteria;Burkholderiales;Comamonadaceae;Diaphorobacter;Diaphorobacter ruginosibacter	19	0	2	0	0	0	0	0	21
Bacteria;Bacteria_none;Firmicutes;Bacilli;Bacillales;Paenibacillaceae;Paenibacillus;Paenibacillus tengchongensis	0	4	15	0	0	2	0	0	21
Bacteria;Bacteria_none;Bacteroidota;Cytophagia;Cytophagales;Flammeovirgaceae;Flexithrix;Flexithrix dorotheae	0	1	0	16	0	1	3	0	21
Bacteria;Bacteria_none;Firmicutes;Clostridia;Eubacteriales;Lachnospiraceae;Blautia;Blautia pseudococcoides	8	0	3	5	0	0	0	5	21
Bacteria;Bacteria_none;Proteobacteria;Alphaproteobacteria;Rhodobacterales;Rhodobacteraceae;Rhodobacter;Rhodobacter viridis	7	8	3	3	0	0	0	0	21
Bacteria;Bacteria_none;Proteobacteria;Alphaproteobacteria;Rhodobacterales;Rhodobacteraceae;Pseudooceanicola;Pseudooceanicola antarcticus	8	3	0	8	1	0	1	0	21
Bacteria;Bacteria_none;Proteobacteria;Gammaproteobacteria;Enterobacterales;Enterobacteriaceae;Trabulsiella;Trabulsiella odontotermitis	16	0	0	0	0	0	0	5	21
Bacteria;Bacteria_none;Proteobacteria;Betaproteobacteria;Burkholderiales;Oxalobacteraceae;Glaciimonas;Glaciimonas frigoris	17	3	1	0	0	0	0	0	21
Bacteria;Bacteria_none;Bacteroidota;Bacteroidia;Bacteroidales;Bacteroidaceae;Bacteroides;Bacteroides coprosuis	0	2	5	13	0	0	0	1	21
Bacteria;Bacteria_none;Firmicutes;Clostridia;Eubacteriales;Clostridiaceae;Clostridium;Clostridium botulinum	2	2	7	9	1	0	0	0	21
Bacteria;Bacteria_none;Proteobacteria;Alphaproteobacteria;Rhodobacterales;Rhodobacteraceae;Paracoccus;Paracoccus suum	4	2	6	8	0	0	1	0	21
Bacteria;Bacteria_none;Actinobacteria;Actinomycetia;Micrococcales;Microbacteriaceae;Leucobacter;Leucobacter ruminantium	2	2	11	5	0	1	0	0	21
Bacteria;Bacteria_none;Acidobacteria;Blastocatellia;Blastocatellales;Blastocatellaceae;Blastocatella;Blastocatella fastidiosa	11	4	1	4	0	1	0	0	21
Bacteria;Bacteria_none;Firmicutes;Bacilli;Bacillales;Bacillaceae;Geobacillus;Geobacillus lituanicus	0	1	13	6	0	1	0	0	21
Bacteria;Bacteria_none;Actinobacteria;Actinomycetia;Micrococcales;Micrococcaceae;Pseudarthrobacter;Pseudarthrobacter scleromae	2	4	7	6	0	2	0	0	21
Bacteria;Bacteria_none;Firmicutes;Clostridia;Halanaerobiales;Halanaerobiaceae;Halanaerobium;Halanaerobium saccharolyticum	2	3	0	7	2	7	0	0	21
Bacteria;Bacteria_none;Proteobacteria;Alphaproteobacteria;Rhodospirillales;Stellaceae;Stella;Stella vacuolata	6	13	1	1	0	0	0	0	21
Bacteria;Bacteria_none;Gemmatimonadetes;Gemmatimonadetes;Gemmatimonadales;Gemmatimonadaceae;Gemmatimonas;Gemmatimonas aurantiaca	21	0	0	0	0	0	0	0	21
Bacteria;Bacteria_none;Firmicutes;Tissierellia;Tissierellales;Tissierellaceae;Tissierella;Tissierella creatinini	2	7	5	4	1	1	0	1	21
Bacteria;Bacteria_none;Proteobacteria;Gammaproteobacteria;Enterobacterales;Enterobacteriaceae;Citrobacter;Citrobacter telavivensis	7	7	0	7	0	0	0	0	21
Bacteria;Bacteria_none;Proteobacteria;Acidithiobacillia;Acidithiobacillales;Acidithiobacillaceae;Acidithiobacillus;Acidithiobacillus thiooxidans	1	6	5	6	0	0	0	3	21
Bacteria;Bacteria_none;Actinobacteria;Actinomycetia;Pseudonocardiales;Pseudonocardiaceae;Pseudonocardia;Pseudonocardia chloroethenivorans	1	1	0	18	0	1	0	0	21
Bacteria;Bacteria_none;Firmicutes;Clostridia;Eubacteriales;Symbiobacteriaceae;Symbiobacterium;Symbiobacterium ostreiconchae	0	0	1	19	0	1	0	0	21
Bacteria;Bacteria_none;Proteobacteria;Alphaproteobacteria;Rhodospirillales;Acetobacteraceae;Roseomonas;Roseomonas coralli	9	7	3	1	0	0	0	0	20
Bacteria;Bacteria_none;Actinobacteria;Actinomycetia;Propionibacteriales;Propionibacteriaceae;Propionibacterium;Propionibacterium cyclohexanicum	3	3	6	2	0	6	0	0	20
Bacteria;Bacteria_none;Bacteroidota;Flavobacteriia;Flavobacteriales;Weeksellaceae;Chryseobacterium;Chryseobacterium proteolyticum	4	7	5	2	1	1	0	0	20
Bacteria;Bacteria_none;Proteobacteria;Betaproteobacteria;Rhodocyclales;Zoogloeaceae;Pseudothauera;Pseudothauera rhizosphaerae	19	1	0	0	0	0	0	0	20
Bacteria;Bacteria_none;Firmicutes;Bacilli;Lactobacillales;Streptococcaceae;Streptococcus;Streptococcus merionis	18	0	0	1	0	0	0	1	20
Bacteria;Bacteria_none;Proteobacteria;Betaproteobacteria;Rhodocyclales;Zoogloeaceae;Thauera;Thauera phenolivorans	14	4	1	0	0	1	0	0	20
Bacteria;Bacteria_none;Firmicutes;Bacilli;Lactobacillales;Aerococcaceae;Fundicoccus;Fundicoccus ignavus	20	0	0	0	0	0	0	0	20
Bacteria;Bacteria_none;Proteobacteria;Alphaproteobacteria;Rhodospirillales;Acetobacteraceae;Acidisphaera;Acidisphaera rubrifaciens	5	8	4	1	1	1	0	0	20
Bacteria;Bacteria_none;Proteobacteria;Betaproteobacteria;Rhodocyclales;Zoogloeaceae;Uliginosibacterium;Uliginosibacterium gangwonense	15	1	1	1	0	0	1	1	20
Bacteria;Bacteria_none;Bacteroidota;Bacteroidia;Bacteroidales;Dysgonomonadaceae;Proteiniphilum;Proteiniphilum saccharofermentans	0	0	5	7	0	0	8	0	20
Bacteria;Bacteria_none;Proteobacteria;Gammaproteobacteria;Xanthomonadales;Xanthomonadaceae;Lysobacter;Lysobacter psychrotolerans	7	5	1	4	0	0	2	1	20
Bacteria;Bacteria_none;Actinobacteria;Actinomycetia;Micrococcales;Microbacteriaceae;Microbacterium;Microbacterium ulmi	2	6	4	6	1	1	0	0	20
Bacteria;Bacteria_none;Firmicutes;Bacilli;Bacillales;Staphylococcaceae;Staphylococcus;Staphylococcus auricularis	1	2	7	7	0	0	0	3	20
Bacteria;Bacteria_none;Proteobacteria;Gammaproteobacteria;Oceanospirillales;Halomonadaceae;Halomonas;Halomonas saliphila	7	9	4	0	0	0	0	0	20
Bacteria;Bacteria_none;Proteobacteria;Alphaproteobacteria;Rhodospirillales;Thalassobaculaceae;Nisaea;Nisaea nitritireducens	3	7	5	4	0	0	0	1	20
Bacteria;Bacteria_none;Proteobacteria;Alphaproteobacteria;Sphingomonadales;Erythrobacteraceae;Altererythrobacter;Altererythrobacter fulvus	3	7	5	2	0	2	1	0	20
Bacteria;Bacteria_none;Proteobacteria;Deltaproteobacteria;Desulfovibrionales;Desulfovibrionaceae;Desulfovibrio;Desulfovibrio subterraneus	3	4	5	0	8	0	0	0	20
Bacteria;Bacteria_none;Proteobacteria;Betaproteobacteria;Burkholderiales;Comamonadaceae;Tibeticola;Tibeticola sediminis	11	3	1	4	0	1	0	0	20
Bacteria;Bacteria_none;Planctomycetota;Phycisphaerae;Sedimentisphaerales;Sedimentisphaeraceae;Sedimentisphaera;Sedimentisphaera cyanobacteriorum	0	0	12	7	0	1	0	0	20
Bacteria;Bacteria_none;Bacteroidota;Chitinophagia;Chitinophagales;Chitinophagaceae;Panacibacter;Panacibacter ginsenosidivorans	19	1	0	0	0	0	0	0	20
Bacteria;Bacteria_none;Proteobacteria;Alphaproteobacteria;Maricaulales;Robiginitomaculaceae;Litorimonas;Litorimonas haliclonae	20	0	0	0	0	0	0	0	20
Bacteria;Bacteria_none;Proteobacteria;Betaproteobacteria;Burkholderiales;Sutterellaceae;Sutterella;Sutterella stercoricanis	4	7	1	0	2	0	0	6	20
Bacteria;Bacteria_none;Proteobacteria;Betaproteobacteria;Burkholderiales;Sphaerotilaceae;Schlegelella;Schlegelella koreensis	13	4	1	0	0	2	0	0	20
Bacteria;Bacteria_none;Proteobacteria;Alphaproteobacteria;Rhodobacterales;Rhodobacteraceae;Cereibacter;Cereibacter changlensis	6	8	1	4	1	0	0	0	20
Bacteria;Bacteria_none;Proteobacteria;Alphaproteobacteria;Rhodobacterales;Rhodobacteraceae;Arenibacillus;Arenibacillus arenosus	6	5	3	3	0	0	3	0	20
Bacteria;Bacteria_none;Firmicutes;Clostridia;Eubacteriales;Lachnospiraceae;Lacrimispora;Lacrimispora xylanolytica	20	0	0	0	0	0	0	0	20
Bacteria;Bacteria_none;Actinobacteria;Coriobacteriia;Eggerthellales;Eggerthellaceae;Gordonibacter;Gordonibacter pamelaeae	4	0	6	8	0	1	0	1	20
Bacteria;Bacteria_none;Actinobacteria;Actinomycetia;Actinomycetales;Actinomycetaceae;Actinomyces;Actinomyces qiguomingii	3	5	2	10	0	0	0	0	20
Bacteria;Bacteria_none;Proteobacteria;Alphaproteobacteria;Rhodobacterales;Rhodobacteraceae;Nioella;Nioella ostreopsis	3	10	1	5	1	0	0	0	20
Bacteria;Bacteria_none;Firmicutes;Clostridia;Eubacteriales;Lachnospiraceae;Lachnoanaerobaculum;Lachnoanaerobaculum saburreum	8	1	4	7	0	0	0	0	20
Bacteria;Bacteria_none;Proteobacteria;Gammaproteobacteria;Xanthomonadales;Xanthomonadaceae;Pseudoxanthomonas;Pseudoxanthomonas taiwanensis	6	4	1	1	2	4	2	0	20
Bacteria;Bacteria_none;Proteobacteria;Alphaproteobacteria;Hyphomicrobiales;Stappiaceae;Pseudovibrio;Pseudovibrio axinellae	6	0	4	10	0	0	0	0	20
Bacteria;Bacteria_none;Proteobacteria;Alphaproteobacteria;Hyphomicrobiales;Roseiarcaceae;Roseiarcus;Roseiarcus fermentans	4	8	3	4	1	0	0	0	20
Bacteria;Bacteria_none;Planctomycetota;Planctomycetia;Pirellulales;Pirellulaceae;Blastopirellula;Blastopirellula retiformator	0	0	0	11	7	0	0	2	20
Bacteria;Bacteria_none;Proteobacteria;Betaproteobacteria;Neisseriales;Neisseriaceae;Rivicola;Rivicola pingtungensis	6	0	1	5	0	0	1	7	20
Bacteria;Bacteria_none;Firmicutes;Clostridia;Thermoanaerobacterales;Thermoanaerobacteraceae;Thermoanaerobacter;Thermoanaerobacter brockii	0	0	3	7	0	10	0	0	20
Bacteria;Bacteria_none;Proteobacteria;Gammaproteobacteria;Xanthomonadales;Rhodanobacteraceae;Rudaea;Rudaea cellulosilytica	16	2	2	0	0	0	0	0	20
Bacteria;Bacteria_none;Proteobacteria;Gammaproteobacteria;Enterobacterales;Erwiniaceae;Buchnera;Buchnera aphidicola	13	2	1	3	0	0	1	0	20
Bacteria;Bacteria_none;Proteobacteria;Alphaproteobacteria;Hyphomicrobiales;Rhizobiaceae;Rhizobium;Rhizobium pseudoryzae	5	6	7	1	0	0	1	0	20
Bacteria;Bacteria_none;Firmicutes;Bacilli;Bacillales;Bacillaceae;Bacillus;Bacillus anthracis	0	0	13	7	0	0	0	0	20
Bacteria;Bacteria_none;Actinobacteria;Rubrobacteria;Rubrobacterales;Rubrobacteraceae;Rubrobacter;Rubrobacter aplysinae	0	0	7	9	2	0	2	0	20
Bacteria;Bacteria_none;Bacteroidota;Bacteroidia;Marinilabiliales;Prolixibacteraceae;Puteibacter;Puteibacter caeruleilacunae	1	4	3	6	0	1	1	4	20
Bacteria;Bacteria_none;Chloroflexi;Caldilineae;Caldilineales;Caldilineaceae;Caldilinea;Caldilinea tarbellica	11	6	3	0	0	0	0	0	20
Bacteria;Bacteria_none;Firmicutes;Bacilli;Lactobacillales;Streptococcaceae;Lactococcus;Lactococcus garvieae	16	2	0	0	0	1	0	1	20
Bacteria;Bacteria_none;Firmicutes;Clostridia;Eubacteriales;Clostridiaceae;Clostridium;Clostridium isatidis	1	3	5	5	1	3	0	2	20
Bacteria;Bacteria_none;Firmicutes;Clostridia;Eubacteriales;Oscillospiraceae;Oscillospiraceae_Incertae_sedis;[Clostridium] viride	12	3	3	0	0	1	0	1	20
Bacteria;Bacteria_none;Proteobacteria;Alphaproteobacteria;Hyphomicrobiales;Kaistiaceae;Kaistia;Kaistia adipata	2	5	6	3	1	1	2	0	20
Bacteria;Bacteria_none;Proteobacteria;Deltaproteobacteria;Desulfovibrionales;Desulfovibrionaceae;Oceanidesulfovibrio;Oceanidesulfovibrio gabonensis	2	6	5	1	6	0	0	0	20
Bacteria;Bacteria_none;Fusobacteria;Fusobacteriia;Fusobacteriales;Fusobacteriaceae;Hypnocyclicus;Hypnocyclicus thermotrophus	3	4	0	5	0	0	1	7	20
Bacteria;Bacteria_none;Proteobacteria;Betaproteobacteria;Burkholderiales;Burkholderiales_Incertae_sedis;Thiomonas;Thiomonas arsenitoxydans	11	2	0	2	2	0	0	3	20
Bacteria;Bacteria_none;Proteobacteria;Gammaproteobacteria;Enterobacterales;Erwiniaceae;Pantoea;Pantoea agglomerans	14	0	2	2	0	0	2	0	20
Bacteria;Bacteria_none;Proteobacteria;Deltaproteobacteria;Desulfovibrionales;Desulfovibrionaceae;Fundidesulfovibrio;Fundidesulfovibrio putealis	5	8	0	6	0	0	1	0	20
Bacteria;Bacteria_none;Firmicutes;Bacilli;Bacillales;Paenibacillaceae;Paenibacillus;Paenibacillus susongensis	0	4	13	0	2	0	1	0	20
Bacteria;Bacteria_none;Actinobacteria;Actinomycetia;Pseudonocardiales;Pseudonocardiaceae;Prauserella;Prauserella shujinwangii	0	0	1	19	0	0	0	0	20
Bacteria;Bacteria_none;Actinobacteria;Actinomycetia;Streptomycetales;Streptomycetaceae;Streptomyces;Streptomyces noboritoensis	0	6	3	7	0	0	3	0	19
Bacteria;Bacteria_none;Proteobacteria;Betaproteobacteria;Burkholderiales;Oxalobacteraceae;Massilia;Massilia horti	19	0	0	0	0	0	0	0	19
Bacteria;Bacteria_none;Proteobacteria;Betaproteobacteria;Burkholderiales;Alcaligenaceae;Eoetvoesia;Eoetvoesia caeni	1	8	3	0	2	5	0	0	19
Bacteria;Bacteria_none;Firmicutes;Bacilli;Lactobacillales;Enterococcaceae;Enterococcus;Enterococcus dispar	10	5	2	2	0	0	0	0	19
Bacteria;Bacteria_none;Proteobacteria;Gammaproteobacteria;Nevskiales;Algiphilaceae;Algiphilus;Algiphilus aromaticivorans	14	2	3	0	0	0	0	0	19
Bacteria;Bacteria_none;Actinobacteria;Coriobacteriia;Coriobacteriales;Atopobiaceae;Olsenella;Olsenella congonensis	0	0	17	0	1	0	0	1	19
Bacteria;Bacteria_none;Firmicutes;Negativicutes;Veillonellales;Veillonellaceae;Veillonella;Veillonella tobetsuensis	18	0	0	0	0	0	1	0	19
Bacteria;Bacteria_none;Proteobacteria;Gammaproteobacteria;Cellvibrionales;Cellvibrionaceae;Cellvibrio;Cellvibrio fontiphilus	2	16	0	0	1	0	0	0	19
Bacteria;Bacteria_none;Firmicutes;Negativicutes;Selenomonadales;Sporomusaceae;Anaerosporomusa;Anaerosporomusa subterranea	3	5	2	5	0	1	2	1	19
Bacteria;Bacteria_none;Planctomycetota;Planctomycetia;Planctomycetales;Planctomycetaceae;Thalassoglobus;Thalassoglobus neptunius	0	3	5	7	0	2	1	1	19
Bacteria;Bacteria_none;Proteobacteria;Gammaproteobacteria;Enterobacterales;Morganellaceae;Morganella;Morganella psychrotolerans	14	0	2	1	0	1	0	1	19
Bacteria;Bacteria_none;Proteobacteria;Gammaproteobacteria;Enterobacterales;Morganellaceae;Proteus;Proteus mirabilis	14	4	1	0	0	0	0	0	19
Bacteria;Bacteria_none;Firmicutes;Clostridia;Eubacteriales;Clostridiaceae;Caloramator;Caloramator viterbiensis	10	7	2	0	0	0	0	0	19
Bacteria;Bacteria_none;Actinobacteria;Actinomycetia;Actinomycetales;Actinomycetaceae;Actinomyces;Actinomyces polynesiensis	5	7	2	0	0	2	0	3	19
Bacteria;Bacteria_none;Proteobacteria;Alphaproteobacteria;Hyphomicrobiales;Rhodovibrionaceae;Fodinicurvata;Fodinicurvata fenggangensis	7	5	3	2	2	0	0	0	19
Bacteria;Bacteria_none;Actinobacteria;Actinomycetia;Streptomycetales;Streptomycetaceae;Streptomyces;Streptomyces jietaisiensis	5	1	4	7	0	1	0	1	19
Bacteria;Bacteria_none;Chloroflexi;Thermomicrobia;Sphaerobacterales;Sphaerobacteraceae;Sphaerobacter;Sphaerobacter thermophilus	1	4	4	6	0	2	2	0	19
Bacteria;Bacteria_none;Firmicutes;Clostridia;Eubacteriales;Clostridiaceae;Clostridium;Clostridium psychrophilum	11	1	2	2	1	0	1	1	19
Bacteria;Bacteria_none;Proteobacteria;Gammaproteobacteria;Xanthomonadales;Xanthomonadaceae;Pseudoxanthomonas;Pseudoxanthomonas gei	9	1	5	1	0	2	0	1	19
Bacteria;Bacteria_none;Actinobacteria;Actinomycetia;Micrococcales;Microbacteriaceae;Herbiconiux;Herbiconiux moechotypicola	4	3	5	6	1	0	0	0	19
Bacteria;Bacteria_none;Firmicutes;Bacilli;Bacillales;Bacillaceae;Lysinibacillus;Lysinibacillus capsici	2	4	2	7	2	1	0	1	19
Bacteria;Bacteria_none;Proteobacteria;Gammaproteobacteria;Chromatiales;Ectothiorhodospiraceae;Thiogranum;Thiogranum longum	5	7	2	3	1	1	0	0	19
Bacteria;Bacteria_none;Firmicutes;Clostridia;Eubacteriales;Clostridiaceae;Tindallia;Tindallia californiensis	13	6	0	0	0	0	0	0	19
Bacteria;Bacteria_none;Firmicutes;Bacilli;Bacillales;Bacillaceae;Calditerricola;Calditerricola satsumensis	1	4	10	4	0	0	0	0	19
Bacteria;Bacteria_none;Firmicutes;Negativicutes;Selenomonadales;Selenomonadaceae;Centipeda;Centipeda periodontii	3	11	3	1	0	0	0	1	19
Bacteria;Bacteria_none;Proteobacteria;Alphaproteobacteria;Hyphomicrobiales;Blastochloridaceae;Blastochloris;Blastochloris viridis	3	5	2	6	0	2	0	1	19
Bacteria;Bacteria_none;Proteobacteria;Gammaproteobacteria;Legionellales;Legionellaceae;Legionella;Legionella lytica	5	4	4	4	1	0	1	0	19
Bacteria;Bacteria_none;Proteobacteria;Betaproteobacteria;Burkholderiales;Comamonadaceae;Simplicispira;Simplicispira piscis	14	1	0	0	1	3	0	0	19
Bacteria;Bacteria_none;Bacteroidota;Bacteroidia;Bacteroidales;Prevotellaceae;Prevotella;Prevotella cerevisiae	0	1	3	8	0	1	2	4	19
Bacteria;Bacteria_none;Actinobacteria;Actinomycetia;Micrococcales;Intrasporangiaceae;Tetrasphaera;Tetrasphaera australiensis	9	4	1	3	0	1	0	1	19
Bacteria;Bacteria_none;Proteobacteria;Alphaproteobacteria;Hyphomicrobiales;Methylobacteriaceae;Methylorubrum;Methylorubrum suomiense	2	6	4	5	0	1	0	1	19
Bacteria;Bacteria_none;Proteobacteria;Alphaproteobacteria;Rhodospirillales;Azospirillaceae;Azospirillum;Azospirillum brasilense	8	4	4	3	0	0	0	0	19
Bacteria;Bacteria_none;Proteobacteria;Alphaproteobacteria;Rhodospirillales;Azospirillaceae;Azospirillum;Azospirillum fermentarium	4	2	3	3	0	6	1	0	19
Bacteria;Bacteria_none;Proteobacteria;Alphaproteobacteria;Rhodospirillales;Acetobacteraceae;Roseomonas;Roseomonas oryzicola	1	6	6	1	4	1	0	0	19
Bacteria;Bacteria_none;Bacteroidota;Bacteroidia;Bacteroidales;Prevotellaceae;Prevotella;Prevotella brevis	1	1	0	14	1	0	1	1	19
Bacteria;Bacteria_none;Firmicutes;Clostridia;Eubacteriales;Oscillospiraceae;Anaerotruncus;Anaerotruncus massiliensis	6	6	3	0	0	4	0	0	19
Bacteria;Bacteria_none;Proteobacteria;Deltaproteobacteria;Desulfovibrionales;Desulfovibrionaceae;Solidesulfovibrio;Solidesulfovibrio carbinolicus	0	0	0	19	0	0	0	0	19
Bacteria;Bacteria_none;Actinobacteria;Actinomycetia;Micrococcales;Brevibacteriaceae;Brevibacterium;Brevibacterium profundi	1	4	10	3	0	1	0	0	19
Bacteria;Bacteria_none;Proteobacteria;Alphaproteobacteria;Caulobacterales;Caulobacteraceae;Phenylobacterium;Phenylobacterium immobile	5	1	6	4	1	2	0	0	19
Bacteria;Bacteria_none;Firmicutes;Bacilli;Lactobacillales;Streptococcaceae;Streptococcus;Streptococcus alactolyticus	14	1	0	2	1	0	1	0	19
Bacteria;Bacteria_none;Proteobacteria;Hydrogenophilalia;Hydrogenophilales;Hydrogenophilaceae;Tepidiphilus;Tepidiphilus thermophilus	1	0	3	11	0	2	2	0	19
Bacteria;Bacteria_none;Actinobacteria;Actinomycetia;Pseudonocardiales;Pseudonocardiaceae;Saccharopolyspora;Saccharopolyspora gregorii	0	0	0	19	0	0	0	0	19
Bacteria;Bacteria_none;Spirochaetes;Spirochaetia;Spirochaetales;Treponemataceae;Treponema;Treponema bryantii	0	3	10	2	0	0	0	4	19
Bacteria;Bacteria_none;Firmicutes;Clostridia;Eubacteriales;Lachnospiraceae;Anaerosacchariphilus;Anaerosacchariphilus polymeriproducens	6	9	1	3	0	0	0	0	19
Bacteria;Bacteria_none;Actinobacteria;Actinomycetia;Propionibacteriales;Nocardioidaceae;Nocardioides;Nocardioides guangzhouensis	6	6	3	2	1	0	1	0	19
Bacteria;Bacteria_none;Proteobacteria;Alphaproteobacteria;Rhodobacterales;Rhodobacteraceae;Tabrizicola;Tabrizicola oligotrophica	3	8	1	4	0	3	0	0	19
Bacteria;Bacteria_none;Proteobacteria;Alphaproteobacteria;Rickettsiales;Rickettsiaceae;Rickettsia;Rickettsia fournieri	15	4	0	0	0	0	0	0	19
Bacteria;Bacteria_none;Firmicutes;Clostridia;Eubacteriales;Heliobacteriaceae;Heliobacterium;Heliobacterium chlorum	0	18	0	0	0	1	0	0	19
Bacteria;Bacteria_none;Chlamydiae;Chlamydiia;Parachlamydiales;Waddliaceae;Waddlia;Waddlia chondrophila	0	10	7	0	1	0	0	1	19
Bacteria;Bacteria_none;Proteobacteria;Gammaproteobacteria;Pseudomonadales;Pseudomonadaceae;Pseudomonas;Pseudomonas psychrophila	7	1	3	5	3	0	0	0	19
Bacteria;Bacteria_none;Actinobacteria;Actinomycetia;Streptomycetales;Streptomycetaceae;Streptomyces;Streptomyces puniciscabiei	2	2	12	3	0	0	0	0	19
Bacteria;Bacteria_none;Proteobacteria;Alphaproteobacteria;Rhodobacterales;Rhodobacteraceae;Tabrizicola;Tabrizicola fusiformis	2	4	4	8	0	1	0	0	19
Bacteria;Bacteria_none;Actinobacteria;Actinomycetia;Streptomycetales;Streptomycetaceae;Streptomyces;Streptomyces vinaceusdrappus	0	7	5	3	1	2	1	0	19
Bacteria;Bacteria_none;Actinobacteria;Actinomycetia;Micrococcales;Jonesiaceae;Flavimobilis;Flavimobilis soli	13	2	3	0	0	1	0	0	19
Bacteria;Bacteria_none;Proteobacteria;Alphaproteobacteria;Sphingomonadales;Sphingomonadaceae;Sphingopyxis;Sphingopyxis soli	5	8	2	4	0	0	0	0	19
Bacteria;Bacteria_none;Firmicutes;Clostridia;Eubacteriales;Heliobacteriaceae;Heliomicrobium;Heliomicrobium undosum	2	0	5	7	0	3	2	0	19
Bacteria;Bacteria_none;Proteobacteria;Betaproteobacteria;Burkholderiales;Sphaerotilaceae;Schlegelella;Schlegelella brevitalea	13	1	1	0	1	1	0	1	18
Bacteria;Bacteria_none;Actinobacteria;Actinomycetia;Corynebacteriales;Mycobacteriaceae;Mycolicibacterium;Mycolicibacterium lacusdiani	5	4	3	4	0	0	2	0	18
Bacteria;Bacteria_none;Actinobacteria;Actinomycetia;Micrococcales;Intrasporangiaceae;Marihabitans;Marihabitans asiaticum	5	9	3	1	0	0	0	0	18
Bacteria;Bacteria_none;Actinobacteria;Thermoleophilia;Solirubrobacterales;Conexibacteraceae;Conexibacter;Conexibacter arvalis	7	2	0	6	0	0	0	3	18
Bacteria;Bacteria_none;Bacteroidota;Bacteroidia;Bacteroidales;Prevotellaceae;Prevotellamassilia;Prevotellamassilia timonensis	0	0	6	8	1	0	2	1	18
Bacteria;Bacteria_none;Firmicutes;Erysipelotrichia;Erysipelotrichales;Erysipelotrichaceae;Stecheria;Stecheria intestinalis	0	0	0	0	0	0	0	18	18
Bacteria;Bacteria_none;Proteobacteria;Betaproteobacteria;Burkholderiales;Comamonadaceae;Limnohabitans;Limnohabitans curvus	16	0	0	1	0	0	0	1	18
Bacteria;Bacteria_none;Firmicutes;Bacilli;Lactobacillales;Enterococcaceae;Enterococcus;Enterococcus sulfureus	7	2	4	4	0	0	0	1	18
Bacteria;Bacteria_none;Proteobacteria;Alphaproteobacteria;Rhodobacterales;Rhodobacteraceae;Rhodovulum;Rhodovulum visakhapatnamense	6	3	0	7	0	1	0	1	18
Bacteria;Bacteria_none;Proteobacteria;Gammaproteobacteria;Enterobacterales;Erwiniaceae;Pantoea;Pantoea alhagi	12	0	1	3	0	0	0	2	18
Bacteria;Bacteria_none;Proteobacteria;Betaproteobacteria;Burkholderiales;Comamonadaceae;Comamonas;Comamonas suwonensis	8	0	4	1	0	2	3	0	18
Bacteria;Bacteria_none;Proteobacteria;Gammaproteobacteria;Xanthomonadales;Xanthomonadaceae;Vulcaniibacterium;Vulcaniibacterium gelatinicum	15	1	0	0	0	2	0	0	18
Bacteria;Bacteria_none;Bacteroidota;Chitinophagia;Chitinophagales;Chitinophagaceae;Niabella;Niabella terrae	15	1	0	1	0	0	0	1	18
Bacteria;Bacteria_none;Firmicutes;Clostridia;Eubacteriales;Eubacteriales_Incertae_sedis;Howardella;Howardella ureilytica	6	3	2	4	1	0	1	1	18
Bacteria;Bacteria_none;Bacteroidota;Bacteroidia;Bacteroidales;Bacteroidaceae;Bacteroides;Bacteroides neonati	1	0	0	14	0	0	2	1	18
Bacteria;Bacteria_none;Actinobacteria;Actinomycetia;Corynebacteriales;Mycobacteriaceae;Mycolicibacterium;Mycolicibacterium agri	1	8	1	5	0	2	1	0	18
Bacteria;Bacteria_none;Firmicutes;Bacilli;Lactobacillales;Streptococcaceae;Streptococcus;Streptococcus caprae	13	1	2	2	0	0	0	0	18
Bacteria;Bacteria_none;Proteobacteria;Gammaproteobacteria;Chromatiales;Woeseiaceae;Woeseia;Woeseia oceani	12	1	3	1	0	0	0	1	18
Bacteria;Bacteria_none;Bacteroidota;Bacteroidia;Bacteroidales;Bacteroidaceae;Bacteroides;Bacteroides caecicola	2	5	9	1	0	0	1	0	18
Bacteria;Bacteria_none;Bacteroidota;Chitinophagia;Chitinophagales;Chitinophagaceae;Lacibacter;Lacibacter nakdongensis	15	2	0	1	0	0	0	0	18
Bacteria;Bacteria_none;Proteobacteria;Gammaproteobacteria;Chromatiales;Halothiobacillaceae;Thiofaba;Thiofaba tepidiphila	9	0	1	5	0	3	0	0	18
Bacteria;Bacteria_none;Bacteroidota;Chitinophagia;Chitinophagales;Chitinophagaceae;Flavisolibacter;Flavisolibacter rigui	16	2	0	0	0	0	0	0	18
Bacteria;Bacteria_none;Firmicutes;Clostridia;Eubacteriales;Clostridiaceae;Clostridium;Clostridium amazonense	1	0	2	10	2	1	1	1	18
Bacteria;Bacteria_none;Proteobacteria;Betaproteobacteria;Burkholderiales;Comamonadaceae;Delftia;Delftia tsuruhatensis	18	0	0	0	0	0	0	0	18
Bacteria;Bacteria_none;Bacteroidota;Chitinophagia;Chitinophagales;Chitinophagaceae;Flavitalea;Flavitalea gansuensis	16	2	0	0	0	0	0	0	18
Bacteria;Bacteria_none;Proteobacteria;Alphaproteobacteria;Rhodospirillales;Acetobacteraceae;Roseomonas;Roseomonas eburnea	5	5	4	1	1	2	0	0	18
Bacteria;Bacteria_none;Firmicutes;Clostridia;Eubacteriales;Clostridiaceae;Clostridium;Clostridium huakuii	1	0	7	5	0	1	1	3	18
Bacteria;Bacteria_none;Firmicutes;Bacilli;Bacillales;Paenibacillaceae;Paenibacillus;Paenibacillus physcomitrellae	0	1	15	0	2	0	0	0	18
Bacteria;Bacteria_none;Actinobacteria;Actinomycetia;Pseudonocardiales;Pseudonocardiaceae;Saccharopolyspora;Saccharopolyspora flava	0	0	0	16	2	0	0	0	18
Bacteria;Bacteria_none;Proteobacteria;Gammaproteobacteria;Legionellales;Legionellaceae;Legionella;Legionella longbeachae	0	16	0	0	2	0	0	0	18
Bacteria;Bacteria_none;Proteobacteria;Deltaproteobacteria;Desulfovibrionales;Desulfovibrionaceae;Desulfocurvus;Desulfocurvus vexinensis	0	18	0	0	0	0	0	0	18
Bacteria;Bacteria_none;Firmicutes;Bacilli;Bacillales;Bacillaceae;Alkalihalophilus;Alkalihalophilus marmarensis	0	1	13	2	1	1	0	0	18
Bacteria;Bacteria_none;Firmicutes;Negativicutes;Selenomonadales;Selenomonadaceae;Propionispira;Propionispira paucivorans	3	8	3	0	0	0	4	0	18
Bacteria;Bacteria_none;Cyanobacteria;Cyanobacteria_Incertae_sedis;Chroococcales;Chroococcaceae;Alborzia;Alborzia kermanshahica	1	1	2	6	0	2	2	4	18
Bacteria;Bacteria_none;Firmicutes;Bacilli;Bacillales;Bacillaceae;Bacillus;Bacillus licheniformis	0	7	0	0	11	0	0	0	18
Bacteria;Bacteria_none;Proteobacteria;Gammaproteobacteria;Enterobacterales;Enterobacteriaceae;Mangrovibacter;Mangrovibacter plantisponsor	15	0	0	0	0	2	0	1	18
Bacteria;Bacteria_none;Firmicutes;Clostridia;Eubacteriales;Clostridiaceae;Natronincola;Natronincola histidinovorans	0	6	6	0	0	5	0	1	18
Bacteria;Bacteria_none;Firmicutes;Bacilli;Lactobacillales;Streptococcaceae;Streptococcus;Streptococcus hyovaginalis	15	1	1	1	0	0	0	0	18
Bacteria;Bacteria_none;Actinobacteria;Actinomycetia;Streptomycetales;Streptomycetaceae;Streptomyces;Streptomyces cinereus	0	2	8	5	0	3	0	0	18
Bacteria;Bacteria_none;Proteobacteria;Deltaproteobacteria;Desulfovibrionales;Desulfovibrionaceae;Desulfobaculum;Desulfobaculum senezii	0	16	1	0	1	0	0	0	18
Bacteria;Bacteria_none;Proteobacteria;Gammaproteobacteria;Chromatiales;Chromatiaceae;Allochromatium;Allochromatium warmingii	0	10	0	8	0	0	0	0	18
Bacteria;Bacteria_none;Firmicutes;Clostridia;Thermoanaerobacterales;Thermoanaerobacteraceae;Caloribacterium;Caloribacterium cisternae	2	13	1	0	0	0	0	2	18
Bacteria;Bacteria_none;Planctomycetota;Planctomycetia;Planctomycetales;Planctomycetaceae;Polystyrenella;Polystyrenella longa	10	3	2	2	0	0	0	1	18
Bacteria;Bacteria_none;Proteobacteria;Betaproteobacteria;Rhodocyclales;Fluviibacteraceae;Fluviibacter;Fluviibacter phosphoraccumulans	1	13	1	1	0	0	2	0	18
Bacteria;Bacteria_none;Actinobacteria;Actinomycetia;Micrococcales;Intrasporangiaceae;Arsenicicoccus;Arsenicicoccus piscis	6	5	3	2	0	0	2	0	18
Bacteria;Bacteria_none;Actinobacteria;Actinomycetia;Streptosporangiales;Thermomonosporaceae;Actinomadura;Actinomadura cremea	0	5	7	3	0	0	3	0	18
Bacteria;Bacteria_none;Actinobacteria;Actinomycetia;Frankiales;Frankiaceae;Frankia;Frankia asymbiotica	3	15	0	0	0	0	0	0	18
Bacteria;Bacteria_none;Firmicutes;Clostridia;Eubacteriales;Eubacteriaceae;Pseudoramibacter;Pseudoramibacter alactolyticus	4	0	6	5	0	2	0	1	18
Bacteria;Bacteria_none;Firmicutes;Clostridia;Halanaerobiales;Halanaerobiaceae;Halocella;Halocella cellulosilytica	2	7	4	4	0	0	0	1	18
Bacteria;Bacteria_none;Proteobacteria;Deltaproteobacteria;Desulfobacterales;Desulfobacteraceae;Algorimarina;Algorimarina butyrica	1	6	7	2	2	0	0	0	18
Bacteria;Bacteria_none;Proteobacteria;Alphaproteobacteria;Caulobacterales;Caulobacteraceae;Brevundimonas;Brevundimonas halotolerans	6	2	9	0	0	0	1	0	18
Bacteria;Bacteria_none;Actinobacteria;Actinomycetia;Glycomycetales;Glycomycetaceae;Glycomyces;Glycomyces phytohabitans	1	3	4	6	0	0	0	4	18
Bacteria;Bacteria_none;Firmicutes;Bacilli;Lactobacillales;Lactobacillaceae;Loigolactobacillus;Loigolactobacillus binensis	1	4	6	3	0	3	0	1	18
Bacteria;Bacteria_none;Proteobacteria;Alphaproteobacteria;Hyphomicrobiales;Rhizobiaceae;Rhizobium;Rhizobium giardinii	6	7	3	2	0	0	0	0	18
Bacteria;Bacteria_none;Proteobacteria;Betaproteobacteria;Nitrosomonadales;Nitrosomonadaceae;Nitrosomonas;Nitrosomonas ureae	16	2	0	0	0	0	0	0	18
Bacteria;Bacteria_none;Proteobacteria;Alphaproteobacteria;Hyphomicrobiales;Beijerinckiaceae;Methylocella;Methylocella silvestris	4	3	2	6	2	0	0	1	18
Bacteria;Bacteria_none;Proteobacteria;Alphaproteobacteria;Hyphomicrobiales;Brucellaceae;Brucella;[Ochrobactrum] teleogrylli	0	0	18	0	0	0	0	0	18
Bacteria;Bacteria_none;Proteobacteria;Gammaproteobacteria;Legionellales;Legionellaceae;Legionella;Legionella oakridgensis	2	2	7	3	0	2	2	0	18
Bacteria;Bacteria_none;Proteobacteria;Gammaproteobacteria;Alteromonadales;Colwelliaceae;Thalassotalea;Thalassotalea litorea	0	0	14	0	4	0	0	0	18
Bacteria;Bacteria_none;Acidobacteria;Holophagae;Acanthopleuribacterales;Acanthopleuribacteraceae;Sulfidibacter;Sulfidibacter corallicola	0	5	6	4	3	0	0	0	18
Bacteria;Bacteria_none;Actinobacteria;Actinomycetia;Streptosporangiales;Streptosporangiaceae;Microbispora;Microbispora sitophila	0	3	8	7	0	0	0	0	18
Bacteria;Bacteria_none;Firmicutes;Bacilli;Bacillales;Paenibacillaceae;Paenibacillus;Paenibacillus aceti	0	16	2	0	0	0	0	0	18
Bacteria;Bacteria_none;Actinobacteria;Actinomycetia;Pseudonocardiales;Pseudonocardiaceae;Pseudonocardia;Pseudonocardia artemisiae	2	5	2	8	0	1	0	0	18
Bacteria;Bacteria_none;Proteobacteria;Gammaproteobacteria;Xanthomonadales;Xanthomonadaceae;Luteimonas;Luteimonas composti	8	3	2	3	1	1	0	0	18
Bacteria;Bacteria_none;Proteobacteria;Alphaproteobacteria;Hyphomicrobiales;Rhizobiaceae;Sinorhizobium;Sinorhizobium xinjiangense	1	11	2	2	0	2	0	0	18
Bacteria;Bacteria_none;Proteobacteria;Deltaproteobacteria;Syntrophales;Syntrophaceae;Desulfomonile;Desulfomonile tiedjei	0	9	0	4	2	3	0	0	18
Bacteria;Bacteria_none;Actinobacteria;Actinomycetia;Streptomycetales;Streptomycetaceae;Streptomyces;Streptomyces nigrescens	0	1	3	13	0	1	0	0	18
Bacteria;Bacteria_none;Proteobacteria;Alphaproteobacteria;Hyphomicrobiales;Beijerinckiaceae;Methylorosula;Methylorosula polaris	4	5	3	2	0	2	1	1	18
Bacteria;Bacteria_none;Proteobacteria;Alphaproteobacteria;Hyphomicrobiales;Phyllobacteriaceae;Chelativorans;Chelativorans oligotrophicus	2	5	5	4	2	0	0	0	18
Bacteria;Bacteria_none;Firmicutes;Bacilli;Bacillales;Thermoactinomycetaceae;Marininema;Marininema mesophilum	1	3	3	7	1	1	0	2	18
Bacteria;Bacteria_none;Proteobacteria;Alphaproteobacteria;Hyphomicrobiales;Nitrobacteraceae;Bradyrhizobium;Bradyrhizobium elkanii	3	4	2	8	0	1	0	0	18
Bacteria;Bacteria_none;Tenericutes;Mollicutes;Mycoplasmatales;Mycoplasmataceae;Mesomycoplasma;Mesomycoplasma conjunctivae	0	0	4	12	0	0	0	1	17
Bacteria;Bacteria_none;Firmicutes;Negativicutes;Selenomonadales;Sporomusaceae;Sporomusa;Sporomusa sphaeroides	2	0	10	5	0	0	0	0	17
Bacteria;Bacteria_none;Firmicutes;Clostridia;Eubacteriales;Clostridiaceae;Clostridium;Clostridium budayi	2	2	7	3	1	1	1	0	17
Bacteria;Bacteria_none;Actinobacteria;Actinomycetia;Streptosporangiales;Nocardiopsaceae;Nocardiopsis;Nocardiopsis quinghaiensis	4	1	5	3	0	3	1	0	17
Bacteria;Bacteria_none;Proteobacteria;Alphaproteobacteria;Sphingomonadales;Sphingomonadaceae;Sphingobium;Sphingobium wenxiniae	3	6	6	1	0	0	0	1	17
Bacteria;Bacteria_none;Proteobacteria;Deltaproteobacteria;Desulfovibrionales;Desulfovibrionaceae;Desulfovibrio;Desulfovibrio litoralis	5	2	8	2	0	0	0	0	17
Bacteria;Bacteria_none;Firmicutes;Bacilli;Lactobacillales;Streptococcaceae;Streptococcus;Streptococcus gwangjuense	15	0	2	0	0	0	0	0	17
Bacteria;Bacteria_none;Proteobacteria;Betaproteobacteria;Burkholderiales;Comamonadaceae;Hydrogenophaga;Hydrogenophaga crassostreae	5	8	1	0	0	1	0	2	17
Bacteria;Bacteria_none;Proteobacteria;Betaproteobacteria;Burkholderiales;Comamonadaceae;Giesbergeria;Giesbergeria sinuosa	15	2	0	0	0	0	0	0	17
Bacteria;Bacteria_none;Actinobacteria;Actinomycetia;Micrococcales;Microbacteriaceae;Agromyces;Agromyces bracchium	13	2	2	0	0	0	0	0	17
Bacteria;Bacteria_none;Proteobacteria;Alphaproteobacteria;Rhodospirillales;Azospirillaceae;Arenibaculum;Arenibaculum pallidiluteum	2	6	5	3	0	0	1	0	17
Bacteria;Bacteria_none;Firmicutes;Clostridia;Eubacteriales;Lachnospiraceae;Acetitomaculum;Acetitomaculum ruminis	4	6	4	0	2	1	0	0	17
Bacteria;Bacteria_none;Bacteroidota;Chitinophagia;Chitinophagales;Chitinophagaceae;Compostibacter;Compostibacter hankyongensis	15	2	0	0	0	0	0	0	17
Bacteria;Bacteria_none;Firmicutes;Erysipelotrichia;Erysipelotrichales;Erysipelotrichaceae;Holdemanella;Holdemanella porci	16	1	0	0	0	0	0	0	17
Bacteria;Bacteria_none;Proteobacteria;Gammaproteobacteria;Enterobacterales;Enterobacteriaceae;Klebsiella;Klebsiella huaxiensis	7	0	2	4	0	0	1	3	17
Bacteria;Bacteria_none;Proteobacteria;Alphaproteobacteria;Hyphomicrobiales;Brucellaceae;Pseudochrobactrum;Pseudochrobactrum kiredjianiae	0	0	0	7	4	6	0	0	17
Bacteria;Bacteria_none;Proteobacteria;Alphaproteobacteria;Hyphomicrobiales;Chelatococcaceae;Camelimonas;Camelimonas lactis	8	5	1	0	1	2	0	0	17
Bacteria;Bacteria_none;Proteobacteria;Alphaproteobacteria;Hyphomicrobiales;Devosiaceae;Devosia;Devosia psychrophila	4	3	6	2	1	0	1	0	17
Bacteria;Bacteria_none;Firmicutes;Erysipelotrichia;Erysipelotrichales;Erysipelotrichaceae;Lactimicrobium;Lactimicrobium massiliense	3	0	5	3	1	2	2	1	17
Bacteria;Bacteria_none;Proteobacteria;Alphaproteobacteria;Hyphomicrobiales;Beijerinckiaceae;Methylocapsa;Methylocapsa palsarum	0	1	3	11	0	1	1	0	17
Bacteria;Bacteria_none;Actinobacteria;Actinomycetia;Corynebacteriales;Mycobacteriaceae;Mycobacterium;Mycobacterium conspicuum	0	3	4	4	2	0	0	4	17
Bacteria;Bacteria_none;Bacteroidota;Chitinophagia;Chitinophagales;Chitinophagaceae;Gynurincola;Gynurincola endophyticus	12	0	2	1	0	0	0	2	17
Bacteria;Bacteria_none;Proteobacteria;Gammaproteobacteria;Moraxellales;Moraxellaceae;Acinetobacter;Acinetobacter antiviralis	7	1	1	7	0	0	0	1	17
Bacteria;Bacteria_none;Proteobacteria;Betaproteobacteria;Burkholderiales;Alcaligenaceae;Alcaligenes;Alcaligenes pakistanensis	10	1	3	1	2	0	0	0	17
Bacteria;Bacteria_none;Actinobacteria;Actinomycetia;Streptomycetales;Streptomycetaceae;Streptomyces;Streptomyces glebosus	2	15	0	0	0	0	0	0	17
Bacteria;Bacteria_none;Firmicutes;Bacilli;Bacillales;Bacillaceae;Peribacillus;Peribacillus butanolivorans	1	11	3	1	0	1	0	0	17
Bacteria;Bacteria_none;Firmicutes;Tissierellia;Tissierellia_Incertae_sedis;Tissierellia_Incertae_sedis;Dethiosulfatibacter;Dethiosulfatibacter aminovorans	0	4	9	0	1	1	1	1	17
Bacteria;Bacteria_none;Chloroflexi;Ktedonobacteria;Thermogemmatisporales;Thermogemmatisporaceae;Thermogemmatispora;Thermogemmatispora carboxidivorans	0	0	0	0	0	0	0	17	17
Bacteria;Bacteria_none;Actinobacteria;Actinomycetia;Micrococcales;Brevibacteriaceae;Brevibacterium;Brevibacterium mcbrellneri	0	2	9	5	0	1	0	0	17
Bacteria;Bacteria_none;Proteobacteria;Deltaproteobacteria;Myxococcales;Myxococcaceae;Corallococcus;Corallococcus coralloides	17	0	0	0	0	0	0	0	17
Bacteria;Bacteria_none;Proteobacteria;Betaproteobacteria;Nitrosomonadales;Nitrosomonadaceae;Nitrosomonas;Nitrosomonas stercoris	17	0	0	0	0	0	0	0	17
Bacteria;Bacteria_none;Proteobacteria;Gammaproteobacteria;Enterobacterales;Enterobacteriaceae;Lelliottia;Lelliottia amnigena	15	1	0	0	0	0	0	1	17
Bacteria;Bacteria_none;Proteobacteria;Betaproteobacteria;Burkholderiales;Oxalobacteraceae;Pseudoduganella;Pseudoduganella buxea	12	1	1	3	0	0	0	0	17
Bacteria;Bacteria_none;Proteobacteria;Gammaproteobacteria;Legionellales;Legionellaceae;Legionella;Legionella anisa	1	3	1	8	2	1	1	0	17
Bacteria;Bacteria_none;Proteobacteria;Gammaproteobacteria;Legionellales;Legionellaceae;Legionella;Legionella adelaidensis	8	4	2	2	0	0	1	0	17
Bacteria;Bacteria_none;Proteobacteria;Gammaproteobacteria;Oceanospirillales;Halomonadaceae;Halomonas;Halomonas shantousis	1	1	12	0	2	1	0	0	17
Bacteria;Bacteria_none;Firmicutes;Bacilli;Bacillales;Paenibacillaceae;Paenibacillus;Paenibacillus koleovorans	3	1	7	2	1	2	0	1	17
Bacteria;Bacteria_none;Firmicutes;Clostridia;Eubacteriales;Clostridiaceae;Clostridium;Clostridium bornimense	1	0	3	9	0	2	0	2	17
Bacteria;Bacteria_none;Proteobacteria;Gammaproteobacteria;Xanthomonadales;Xanthomonadaceae;Stenotrophomonas;Stenotrophomonas bentonitica	10	3	3	0	0	1	0	0	17
Bacteria;Bacteria_none;Firmicutes;Clostridia;Eubacteriales;Clostridiaceae;Clostridium;Clostridium tepidiprofundi	1	3	2	6	2	1	2	0	17
Bacteria;Bacteria_none;Actinobacteria;Actinomycetia;Micrococcales;Dermabacteraceae;Dermabacter;Dermabacter hominis	3	2	4	6	0	1	1	0	17
Bacteria;Bacteria_none;Planctomycetota;Planctomycetia;Pirellulales;Lacipirellulaceae;Pseudobythopirellula;Pseudobythopirellula maris	3	4	3	5	0	1	1	0	17
Bacteria;Bacteria_none;Proteobacteria;Gammaproteobacteria;Xanthomonadales;Xanthomonadaceae;Arenimonas;Arenimonas maotaiensis	10	2	1	2	1	0	0	1	17
Bacteria;Bacteria_none;Proteobacteria;Alphaproteobacteria;Hyphomicrobiales;Xanthobacteraceae;Labrys;Labrys soli	7	5	0	2	0	3	0	0	17
Bacteria;Bacteria_none;Actinobacteria;Coriobacteriia;Eggerthellales;Eggerthellaceae;Arabiibacter;Arabiibacter massiliensis	0	4	5	7	0	0	0	1	17
Bacteria;Bacteria_none;Firmicutes;Bacilli;Lactobacillales;Enterococcaceae;Enterococcus;Enterococcus camelliae	13	3	0	1	0	0	0	0	17
Bacteria;Bacteria_none;Proteobacteria;Alphaproteobacteria;Rhodobacterales;Rhodobacteraceae;Paracoccus;Paracoccus alimentarius	3	7	0	7	0	0	0	0	17
Bacteria;Bacteria_none;Firmicutes;Clostridia;Eubacteriales;Lachnospiraceae;Jingyaoa;Jingyaoa shaoxingensis	13	0	1	1	1	0	0	1	17
Bacteria;Bacteria_none;Proteobacteria;Alphaproteobacteria;Rhodobacterales;Rhodobacteraceae;Oceanomicrobium;Oceanomicrobium pacificus	4	2	6	4	0	1	0	0	17
Bacteria;Bacteria_none;Proteobacteria;Alphaproteobacteria;Kordiimonadales;Kordiimonadaceae;Kordiimonas;Kordiimonas sediminis	7	0	5	5	0	0	0	0	17
Bacteria;Bacteria_none;Proteobacteria;Gammaproteobacteria;Xanthomonadales;Xanthomonadaceae;Pseudoxanthomonas;Pseudoxanthomonas daejeonensis	4	3	0	4	0	4	2	0	17
Bacteria;Bacteria_none;Firmicutes;Bacilli;Lactobacillales;Streptococcaceae;Streptococcus;Streptococcus pacificus	14	1	1	0	0	0	1	0	17
Bacteria;Bacteria_none;Firmicutes;Clostridia;Eubacteriales;Clostridiaceae;Anaerosolibacter;Anaerosolibacter carboniphilus	2	10	3	1	0	1	0	0	17
Bacteria;Bacteria_none;Firmicutes;Bacilli;Lactobacillales;Carnobacteriaceae;Alkalibacterium;Alkalibacterium gilvum	0	0	17	0	0	0	0	0	17
Bacteria;Bacteria_none;Firmicutes;Clostridia;Eubacteriales;Peptococcaceae;Desulforamulus;Desulforamulus ferrireducens	3	0	11	1	0	2	0	0	17
Bacteria;Bacteria_none;Proteobacteria;Deltaproteobacteria;Desulfovibrionales;Desulfohalobiaceae;Desulfonatronospira;Desulfonatronospira sulfatiphila	0	0	2	15	0	0	0	0	17
Bacteria;Bacteria_none;Proteobacteria;Deltaproteobacteria;Desulfobacterales;Desulfobacteraceae;Desulfosarcina;Desulfosarcina widdelii	3	14	0	0	0	0	0	0	17
Bacteria;Bacteria_none;Actinobacteria;Actinomycetia;Actinomycetales;Actinomycetaceae;Buchananella;Buchananella hordeovulneris	0	5	3	7	0	0	1	1	17
Bacteria;Bacteria_none;Proteobacteria;Alphaproteobacteria;Caulobacterales;Caulobacteraceae;Caulobacter;Caulobacter endophyticus	11	0	6	0	0	0	0	0	17
Bacteria;Bacteria_none;Firmicutes;Bacilli;Lactobacillales;Streptococcaceae;Streptococcus;Streptococcus downei	12	1	0	2	1	0	0	1	17
Bacteria;Bacteria_none;Firmicutes;Clostridia;Eubacteriales;Desulfallaceae;Desulfoscipio;Desulfoscipio geothermicus	0	1	8	3	0	2	3	0	17
Bacteria;Bacteria_none;Bacteroidota;Sphingobacteriia;Sphingobacteriales;Sphingobacteriaceae;Mucilaginibacter;Mucilaginibacter ginkgonis	0	4	3	6	3	1	0	0	17
Bacteria;Bacteria_none;Proteobacteria;Alphaproteobacteria;Hyphomicrobiales;Phyllobacteriaceae;Corticibacterium;Corticibacterium populi	1	3	1	10	1	0	1	0	17
Bacteria;Bacteria_none;Firmicutes;Clostridia;Eubacteriales;Clostridiaceae;Clostridium;Clostridium muellerianum	12	0	2	2	0	0	0	1	17
Bacteria;Bacteria_none;Firmicutes;Bacilli;Lactobacillales;Lactobacillaceae;Lactobacillus;Lactobacillus amylolyticus	13	1	0	0	1	0	0	2	17
Bacteria;Bacteria_none;Proteobacteria;Deltaproteobacteria;Desulfobacterales;Desulfobacteraceae;Desulfocella;Desulfocella halophila	2	4	3	5	1	2	0	0	17
Bacteria;Bacteria_none;Proteobacteria;Alphaproteobacteria;Rhodospirillales;Acetobacteraceae;Roseococcus;Roseococcus pinisoli	9	0	2	3	2	1	0	0	17
Bacteria;Bacteria_none;Actinobacteria;Coriobacteriia;Eggerthellales;Eggerthellaceae;Slackia;Slackia piriformis	1	0	0	16	0	0	0	0	17
Bacteria;Bacteria_none;Firmicutes;Bacilli;Bacillales;Bacillaceae;Virgibacillus;Virgibacillus kapii	0	0	10	3	2	2	0	0	17
Bacteria;Bacteria_none;Proteobacteria;Deltaproteobacteria;Bradymonadales;Bradymonadaceae;Bradymonas;Bradymonas sediminis	0	1	6	8	0	0	1	1	17
Bacteria;Bacteria_none;Actinobacteria;Actinomycetia;Glycomycetales;Glycomycetaceae;Glycomyces;Glycomyces rutgersensis	0	7	5	3	0	1	1	0	17
Bacteria;Bacteria_none;Firmicutes;Clostridia;Eubacteriales;Eubacteriaceae;Irregularibacter;Irregularibacter muris	4	1	1	6	2	1	0	2	17
Bacteria;Bacteria_none;Proteobacteria;Betaproteobacteria;Burkholderiales;Sphaerotilaceae;Inhella;Inhella proteolytica	17	0	0	0	0	0	0	0	17
Bacteria;Bacteria_none;Actinobacteria;Actinomycetia;Micrococcales;Demequinaceae;Demequina;Demequina aurantiaca	1	10	2	2	0	0	0	1	16
Bacteria;Bacteria_none;Actinobacteria;Actinomycetia;Micrococcales;Dermacoccaceae;Flexivirga;Flexivirga oryzae	0	4	6	6	0	0	0	0	16
Bacteria;Bacteria_none;Firmicutes;Clostridia;Eubacteriales;Clostridiaceae;Clostridium;Clostridium homopropionicum	0	1	8	3	3	1	0	0	16
Bacteria;Bacteria_none;Firmicutes;Clostridia;Eubacteriales;Clostridiaceae;Butyricicoccus;Butyricicoccus faecihominis	15	0	1	0	0	0	0	0	16
Bacteria;Bacteria_none;Firmicutes;Bacilli;Lactobacillales;Streptococcaceae;Streptococcus;Streptococcus lutetiensis	16	0	0	0	0	0	0	0	16
Bacteria;Bacteria_none;Firmicutes;Bacilli;Bacillales;Sporolactobacillaceae;Scopulibacillus;Scopulibacillus cellulosilyticus	0	0	15	0	0	1	0	0	16
Bacteria;Bacteria_none;Firmicutes;Clostridia;Eubacteriales;Clostridiaceae;Anaeromonas;Anaeromonas gelatinilytica	2	3	7	1	1	2	0	0	16
Bacteria;Bacteria_none;Firmicutes;Clostridia;Eubacteriales;Desulfitobacteriaceae;Desulfosporosinus;Desulfosporosinus fructosivorans	0	9	0	3	2	2	0	0	16
Bacteria;Bacteria_none;Firmicutes;Bacilli;Lactobacillales;Streptococcaceae;Lactococcus;Lactococcus laudensis	10	2	0	2	0	0	2	0	16
Bacteria;Bacteria_none;Firmicutes;Clostridia;Eubacteriales;Eubacteriales_Incertae_sedis;Anaerotalea;Anaerotalea alkaliphila	1	14	0	1	0	0	0	0	16
Bacteria;Bacteria_none;Proteobacteria;Betaproteobacteria;Burkholderiales;Oxalobacteraceae;Massilia;Massilia yuzhufengensis	11	2	0	1	0	1	1	0	16
Bacteria;Bacteria_none;Proteobacteria;Alphaproteobacteria;Hyphomicrobiales;Phyllobacteriaceae;Mesorhizobium;Mesorhizobium abyssinicae	9	2	1	1	0	3	0	0	16
Bacteria;Bacteria_none;Proteobacteria;Betaproteobacteria;Burkholderiales;Burkholderiaceae;Caballeronia;Caballeronia novacaledonica	8	6	1	0	0	0	1	0	16
Bacteria;Bacteria_none;Proteobacteria;Betaproteobacteria;Burkholderiales;Burkholderiaceae;Mycoavidus;Mycoavidus cysteinexigens	9	3	1	3	0	0	0	0	16
Bacteria;Bacteria_none;Proteobacteria;Alphaproteobacteria;Hyphomicrobiales;Nitrobacteraceae;Bradyrhizobium;Bradyrhizobium murdochi	0	6	6	2	2	0	0	0	16
Bacteria;Bacteria_none;Proteobacteria;Alphaproteobacteria;Hyphomicrobiales;Methylocystaceae;Methylosinus;Methylosinus trichosporium	4	5	4	1	0	0	1	1	16
Bacteria;Bacteria_none;Bacteroidota;Bacteroidia;Bacteroidales;Tannerellaceae;Parabacteroides;Parabacteroides pacaensis	3	1	1	7	1	0	3	0	16
Bacteria;Bacteria_none;Bacteroidota;Bacteroidia;Bacteroidales;Rikenellaceae;Alistipes;Alistipes onderdonkii	16	0	0	0	0	0	0	0	16
Bacteria;Bacteria_none;Bacteroidota;Bacteroidia;Bacteroidales;Odoribacteraceae;Butyricimonas;Butyricimonas paravirosa	0	16	0	0	0	0	0	0	16
Bacteria;Bacteria_none;Proteobacteria;Alphaproteobacteria;Hyphomicrobiales;Devosiaceae;Devosia;Devosia yakushimensis	6	4	3	2	0	1	0	0	16
Bacteria;Bacteria_none;Proteobacteria;Betaproteobacteria;Burkholderiales;Oxalobacteraceae;Noviherbaspirillum;Noviherbaspirillum galbum	10	0	4	0	0	1	0	1	16
Bacteria;Bacteria_none;Proteobacteria;Betaproteobacteria;Burkholderiales;Alcaligenaceae;Derxia;Derxia lacustris	9	6	0	0	0	1	0	0	16
Bacteria;Bacteria_none;Cyanobacteria;Cyanobacteria_Incertae_sedis;Pseudanabaenales;Heteroleibleiniaceae;Tapinothrix;Tapinothrix clintonii	0	3	2	9	1	0	1	0	16
Bacteria;Bacteria_none;Proteobacteria;Betaproteobacteria;Nitrosomonadales;Sterolibacteriaceae;Sulfurisoma;Sulfurisoma sediminicola	8	4	0	0	3	1	0	0	16
Bacteria;Bacteria_none;Proteobacteria;Deltaproteobacteria;Deltaproteobacteria_Incertae_sedis;Deltaproteobacteria_Incertae_sedis;Dissulfurimicrobium;Dissulfurimicrobium hydrothermale	0	10	0	0	6	0	0	0	16
Bacteria;Bacteria_none;Actinobacteria;Actinomycetia;Streptosporangiales;Streptosporangiaceae;Nonomuraea;Nonomuraea rubra	2	3	1	6	0	0	3	1	16
Bacteria;Bacteria_none;Proteobacteria;Alphaproteobacteria;Rhodobacterales;Rhodobacteraceae;Albimonas;Albimonas pacifica	5	3	1	4	0	3	0	0	16
Bacteria;Bacteria_none;Firmicutes;Bacilli;Bacillales;Alicyclobacillaceae;Kyrpidia;Kyrpidia tusciae	0	0	10	2	2	1	0	1	16
Bacteria;Bacteria_none;Proteobacteria;Deltaproteobacteria;Desulfovibrionales;Desulfovibrionaceae;Desulfovibrio;Desulfovibrio porci	2	6	6	0	2	0	0	0	16
Bacteria;Bacteria_none;Actinobacteria;Actinomycetia;Micrococcales;Microbacteriaceae;Microbacterium;Microbacterium assamensis	1	1	1	6	2	1	1	3	16
Bacteria;Bacteria_none;Firmicutes;Bacilli;Bacillales;Bacillaceae;Alteribacter;Alteribacter aurantiacus	3	2	8	0	2	1	0	0	16
Bacteria;Bacteria_none;Proteobacteria;Betaproteobacteria;Burkholderiales;Alcaligenaceae;Verticiella;Verticiella sediminum	15	0	1	0	0	0	0	0	16
Bacteria;Bacteria_none;Bacteroidota;Saprospiria;Saprospirales;Lewinellaceae;Lewinella;Lewinella cohaerens	14	0	0	0	0	1	0	1	16
Bacteria;Bacteria_none;Actinobacteria;Actinomycetia;Streptomycetales;Streptomycetaceae;Streptomyces;Streptomyces kurssanovii	0	4	1	7	0	0	4	0	16
Bacteria;Bacteria_none;Proteobacteria;Alphaproteobacteria;Hyphomicrobiales;Rhizobiaceae;Rhizobium;Rhizobium pongamiae	4	4	2	2	1	2	1	0	16
Bacteria;Bacteria_none;Bacteroidota;Flavobacteriia;Flavobacteriales;Flavobacteriaceae;Lutibacter;Lutibacter agarilyticus	0	2	3	7	2	0	2	0	16
Bacteria;Bacteria_none;Proteobacteria;Alphaproteobacteria;Rhodobacterales;Rhodobacteraceae;Oceaniglobus;Oceaniglobus trochenteri	5	2	5	3	1	0	0	0	16
Bacteria;Bacteria_none;Bacteroidota;Flavobacteriia;Flavobacteriales;Flavobacteriaceae;Muricauda;Muricauda hymeniacidonis	15	0	0	1	0	0	0	0	16
Bacteria;Bacteria_none;Proteobacteria;Alphaproteobacteria;Rhodobacterales;Rhodobacteraceae;Paracoccus;Paracoccus cavernae	8	5	2	0	0	1	0	0	16
Bacteria;Bacteria_none;Proteobacteria;Alphaproteobacteria;Rhodobacterales;Rhodobacteraceae;Paracoccus;Paracoccus niistensis	5	1	2	7	0	1	0	0	16
Bacteria;Bacteria_none;Proteobacteria;Alphaproteobacteria;Hyphomicrobiales;Rhizobiaceae;Shinella;Shinella curvata	0	16	0	0	0	0	0	0	16
Bacteria;Bacteria_none;Proteobacteria;Alphaproteobacteria;Rhodobacterales;Rhodobacteraceae;Paracoccus;Paracoccus solventivorans	1	1	3	8	0	3	0	0	16
Bacteria;Bacteria_none;Actinobacteria;Actinomycetia;Bifidobacteriales;Bifidobacteriaceae;Scardovia;Scardovia inopinata	0	3	4	4	2	2	1	0	16
Bacteria;Bacteria_none;Proteobacteria;Alphaproteobacteria;Rhodobacterales;Rhodobacteraceae;Pelagivirga;Pelagivirga sediminicola	1	3	4	6	0	1	1	0	16
Bacteria;Bacteria_none;Bacteroidota;Cytophagia;Cytophagales;Spirosomaceae;Huanghella;Huanghella arctica	0	2	6	0	7	0	0	1	16
Bacteria;Bacteria_none;Proteobacteria;Alphaproteobacteria;Sphingomonadales;Sphingomonadaceae;Sphingomonas;Sphingomonas mesophila	1	11	2	2	0	0	0	0	16
Bacteria;Bacteria_none;Bacteroidota;Cytophagia;Cytophagales;Hymenobacteraceae;Hymenobacter;Hymenobacter glacieicola	8	0	4	3	0	0	1	0	16
Bacteria;Bacteria_none;Actinobacteria;Actinomycetia;Bifidobacteriales;Bifidobacteriaceae;Bifidobacterium;Bifidobacterium longum	1	8	1	4	0	1	0	1	16
Bacteria;Bacteria_none;Proteobacteria;Alphaproteobacteria;Hyphomicrobiales;Rhizobiaceae;Rhizobium;Rhizobium cauense	7	3	3	3	0	0	0	0	16
Bacteria;Bacteria_none;Actinobacteria;Actinomycetia;Corynebacteriales;Corynebacteriaceae;Corynebacterium;Corynebacterium frankenforstense	1	4	3	8	0	0	0	0	16
Bacteria;Bacteria_none;Firmicutes;Clostridia;Eubacteriales;Eubacteriales_Incertae_sedis;Fenollaria;Fenollaria massiliensis	1	3	5	2	1	4	0	0	16
Bacteria;Bacteria_none;Proteobacteria;Alphaproteobacteria;Hyphomicrobiales;Phyllobacteriaceae;Pseudohoeflea;Pseudohoeflea suaedae	6	3	4	2	0	1	0	0	16
Bacteria;Bacteria_none;Proteobacteria;Alphaproteobacteria;Rhodospirillales;Thalassobaculaceae;Thalassobaculum;Thalassobaculum fulvum	8	6	2	0	0	0	0	0	16
Bacteria;Bacteria_none;Proteobacteria;Alphaproteobacteria;Rhodospirillales;Thalassospiraceae;Varunaivibrio;Varunaivibrio sulfuroxidans	2	5	4	3	1	1	0	0	16
Bacteria;Bacteria_none;Proteobacteria;Alphaproteobacteria;Sphingomonadales;Sphingomonadaceae;Sphingomonas;Sphingomonas chloroacetimidivorans	2	8	0	4	0	2	0	0	16
Bacteria;Bacteria_none;Proteobacteria;Epsilonproteobacteria;Campylobacterales;Arcobacteraceae;Aliarcobacter;Aliarcobacter vitoriensis	1	9	0	1	0	1	2	2	16
Bacteria;Bacteria_none;Deinococcus-Thermus;Deinococci;Thermales;Thermaceae;Calidithermus;Calidithermus roseus	0	0	7	7	0	2	0	0	16
Bacteria;Bacteria_none;Proteobacteria;Alphaproteobacteria;Rhodobacterales;Rhodobacteraceae;Defluviimonas;Defluviimonas aquaemixtae	11	0	2	3	0	0	0	0	16
Bacteria;Bacteria_none;Proteobacteria;Gammaproteobacteria;Enterobacterales;Enterobacteriaceae;Cedecea;Cedecea neteri	8	1	2	3	0	2	0	0	16
Bacteria;Bacteria_none;Proteobacteria;Gammaproteobacteria;Enterobacterales;Morganellaceae;Photorhabdus;Photorhabdus cinerea	11	0	1	4	0	0	0	0	16
Bacteria;Bacteria_none;Actinobacteria;Actinomycetia;Corynebacteriales;Mycobacteriaceae;Mycobacterium;Mycobacterium noviomagense	1	5	3	3	1	2	1	0	16
Bacteria;Bacteria_none;Proteobacteria;Gammaproteobacteria;Legionellales;Legionellaceae;Legionella;Legionella wadsworthii	6	2	0	5	1	2	0	0	16
Bacteria;Bacteria_none;Actinobacteria;Actinomycetia;Pseudonocardiales;Pseudonocardiaceae;Actinokineospora;Actinokineospora cianjurensis	0	0	2	0	0	0	14	0	16
Bacteria;Bacteria_none;Actinobacteria;Actinomycetia;Pseudonocardiales;Pseudonocardiaceae;Actinomycetospora;Actinomycetospora rhizophila	0	2	0	14	0	0	0	0	16
Bacteria;Bacteria_none;Firmicutes;Bacilli;Bacillales;Bacillaceae;Salisediminibacterium;Salisediminibacterium beveridgei	0	4	9	0	0	3	0	0	16
Bacteria;Bacteria_none;Proteobacteria;Gammaproteobacteria;Moraxellales;Moraxellaceae;Acinetobacter;Acinetobacter haemolyticus	7	0	4	5	0	0	0	0	16
Bacteria;Bacteria_none;Proteobacteria;Gammaproteobacteria;Pseudomonadales;Pseudomonadaceae;Pseudomonas;Pseudomonas mucidolens	2	4	6	3	0	0	0	1	16
Bacteria;Bacteria_none;Actinobacteria;Actinomycetia;Micromonosporales;Micromonosporaceae;Actinoplanes;Actinoplanes lutulentus	2	6	4	3	0	1	0	0	16
Bacteria;Bacteria_none;Proteobacteria;Gammaproteobacteria;Vibrionales;Vibrionaceae;Vibrio;Vibrio penaeicida	3	1	1	5	3	1	2	0	16
Bacteria;Bacteria_none;Proteobacteria;Gammaproteobacteria;Xanthomonadales;Xanthomonadaceae;Luteimonas;Luteimonas abyssi	8	3	1	4	0	0	0	0	16
Bacteria;Bacteria_none;Firmicutes;Clostridia;Eubacteriales;Peptostreptococcaceae;Criibacterium;Criibacterium bergeronii	1	2	9	1	2	1	0	0	16
Bacteria;Bacteria_none;Actinobacteria;Actinomycetia;Micrococcales;Microbacteriaceae;Microbacterium;Microbacterium terregens	0	5	3	4	0	3	0	1	16
Bacteria;Bacteria_none;Actinobacteria;Actinomycetia;Micrococcales;Intrasporangiaceae;Tetrasphaera;Tetrasphaera veronensis	8	6	0	1	0	1	0	0	16
Bacteria;Bacteria_none;Firmicutes;Bacilli;Bacillales;Bacillaceae;Caldibacillus;Caldibacillus thermolactis	0	2	5	9	0	0	0	0	16
Bacteria;Bacteria_none;Verrucomicrobia;Verrucomicrobiae;Verrucomicrobiales;Verrucomicrobiaceae;Oceaniferula;Oceaniferula marina	3	13	0	0	0	0	0	0	16
Bacteria;Bacteria_none;Firmicutes;Erysipelotrichia;Erysipelotrichales;Erysipelotrichaceae;Longibaculum;Longibaculum muris	0	0	12	0	3	1	0	0	16
Bacteria;Bacteria_none;Proteobacteria;Gammaproteobacteria;Alteromonadales;Pseudoalteromonadaceae;Pseudoalteromonas;Pseudoalteromonas peptidolytica	4	4	4	1	1	1	0	1	16
Bacteria;Bacteria_none;Actinobacteria;Actinomycetia;Micrococcales;Microbacteriaceae;Microbacterium;Microbacterium panaciterrae	1	4	3	6	0	0	1	1	16
Bacteria;Bacteria_none;Firmicutes;Bacilli;Bacillales;Paenibacillaceae;Cohnella;Cohnella thermotolerans	0	0	5	1	0	10	0	0	16
Bacteria;Bacteria_none;Proteobacteria;Gammaproteobacteria;Xanthomonadales;Xanthomonadaceae;Pseudoxanthomonas;Pseudoxanthomonas jiangsuensis	2	0	0	6	0	0	7	0	15
Bacteria;Bacteria_none;Proteobacteria;Gammaproteobacteria;Legionellales;Legionellaceae;Legionella;Legionella feeleii	4	4	2	2	2	1	0	0	15
Bacteria;Bacteria_none;Proteobacteria;Gammaproteobacteria;Legionellales;Legionellaceae;Legionella;Legionella gresilensis	1	9	1	2	1	0	1	0	15
Bacteria;Bacteria_none;Proteobacteria;Alphaproteobacteria;Sphingomonadales;Sphingomonadaceae;Sphingomonas;Sphingomonas molluscorum	0	9	2	3	0	0	0	1	15
Bacteria;Bacteria_none;Verrucomicrobia;Verrucomicrobiae;Verrucomicrobiales;Verrucomicrobiaceae;Luteolibacter;Luteolibacter arcticus	0	15	0	0	0	0	0	0	15
Bacteria;Bacteria_none;Proteobacteria;Gammaproteobacteria;Moraxellales;Moraxellaceae;Acinetobacter;Acinetobacter albensis	8	0	0	7	0	0	0	0	15
Bacteria;Bacteria_none;Spirochaetes;Spirochaetia;Spirochaetales;Treponemataceae;Treponema;Treponema medium	0	7	3	2	0	0	0	3	15
Bacteria;Bacteria_none;Proteobacteria;Alphaproteobacteria;Rhodobacterales;Rhodobacteraceae;Paracoccus;Paracoccus liaowanqingii	4	3	1	1	3	2	0	1	15
Bacteria;Bacteria_none;Proteobacteria;Gammaproteobacteria;Moraxellales;Moraxellaceae;Acinetobacter;Acinetobacter oleivorans	11	0	0	4	0	0	0	0	15
Bacteria;Bacteria_none;Proteobacteria;Gammaproteobacteria;Nevskiales;Sinobacteraceae;Fontimonas;Fontimonas thermophila	11	3	1	0	0	0	0	0	15
Bacteria;Bacteria_none;Proteobacteria;Gammaproteobacteria;Pseudomonadales;Marinobacteraceae;Marinobacter;Marinobacter lutaoensis	4	1	2	5	0	2	1	0	15
Bacteria;Bacteria_none;Bacteroidota;Cytophagia;Cytophagales;Cyclobacteriaceae;Algoriphagus;Algoriphagus ratkowskyi	1	4	1	8	1	0	0	0	15
Bacteria;Bacteria_none;Actinobacteria;Actinomycetia;Micrococcales;Microbacteriaceae;Protaetiibacter;Protaetiibacter intestinalis	1	1	4	3	5	0	0	1	15
Bacteria;Bacteria_none;Proteobacteria;Gammaproteobacteria;Enterobacterales;Yersiniaceae;Serratia;Serratia ficaria	12	1	0	2	0	0	0	0	15
Bacteria;Bacteria_none;Proteobacteria;Gammaproteobacteria;Xanthomonadales;Rhodanobacteraceae;Rhodanobacter;Rhodanobacter humi	15	0	0	0	0	0	0	0	15
Bacteria;Bacteria_none;Proteobacteria;Alphaproteobacteria;Rhodospirillales;Acetobacteraceae;Dankookia;Dankookia rubra	7	6	0	1	1	0	0	0	15
Bacteria;Bacteria_none;Proteobacteria;Epsilonproteobacteria;Campylobacterales;Sulfurospirillaceae;Sulfurospirillum;Sulfurospirillum halorespirans	5	0	3	4	0	0	0	3	15
Bacteria;Bacteria_none;Proteobacteria;Gammaproteobacteria;Enterobacterales;Morganellaceae;Photorhabdus;Photorhabdus hainanensis	4	6	1	3	0	0	0	1	15
Bacteria;Bacteria_none;Proteobacteria;Betaproteobacteria;Burkholderiales;Burkholderiaceae;Paraburkholderia;Paraburkholderia aromaticivorans	12	1	1	0	0	1	0	0	15
Bacteria;Bacteria_none;Actinobacteria;Actinomycetia;Streptomycetales;Streptomycetaceae;Streptomyces;Streptomyces synnematoformans	1	1	4	6	0	0	2	1	15
Bacteria;Bacteria_none;Proteobacteria;Gammaproteobacteria;Chromatiales;Ectothiorhodospiraceae;Ectothiorhodospira;Ectothiorhodospira haloalkaliphila	10	2	1	2	0	0	0	0	15
Bacteria;Bacteria_none;Proteobacteria;Deltaproteobacteria;Desulfovibrionales;Desulfomicrobiaceae;Desulfomicrobium;Desulfomicrobium baculatum	0	4	2	5	1	0	0	3	15
Bacteria;Bacteria_none;Proteobacteria;Deltaproteobacteria;Desulfobacterales;Desulfobulbaceae;Desulfobulbus;Desulfobulbus alkaliphilus	8	3	3	0	1	0	0	0	15
Bacteria;Bacteria_none;Actinobacteria;Actinomycetia;Actinomycetales;Actinomycetaceae;Actinomyces;Actinomyces denticolens	0	2	5	8	0	0	0	0	15
Bacteria;Bacteria_none;Proteobacteria;Gammaproteobacteria;Chromatiales;Ectothiorhodospiraceae;Thioalkalivibrio;Thioalkalivibrio nitratireducens	6	5	1	2	0	1	0	0	15
Bacteria;Bacteria_none;Firmicutes;Bacilli;Lactobacillales;Streptococcaceae;Streptococcus;Streptococcus pasteurianus	7	1	0	7	0	0	0	0	15
Bacteria;Bacteria_none;Proteobacteria;Gammaproteobacteria;Enterobacterales;Budviciaceae;Insectihabitans;Insectihabitans xujianqingii	12	0	1	1	1	0	0	0	15
Bacteria;Bacteria_none;Proteobacteria;Betaproteobacteria;Neisseriales;Chromobacteriaceae;Chromobacterium;Chromobacterium haemolyticum	15	0	0	0	0	0	0	0	15
Bacteria;Bacteria_none;Proteobacteria;Betaproteobacteria;Neisseriales;Chromobacteriaceae;Aquaspirillum;Aquaspirillum soli	10	3	1	1	0	0	0	0	15
Bacteria;Bacteria_none;Proteobacteria;Betaproteobacteria;Neisseriales;Chromobacteriaceae;Aquaspirillum;Aquaspirillum serpens	13	0	0	2	0	0	0	0	15
Bacteria;Bacteria_none;Proteobacteria;Betaproteobacteria;Burkholderiales;Sutterellaceae;Duodenibacillus;Duodenibacillus massiliensis	11	3	1	0	0	0	0	0	15
Bacteria;Bacteria_none;Proteobacteria;Betaproteobacteria;Burkholderiales;Sphaerotilaceae;Calidifontimicrobium;Calidifontimicrobium sediminis	13	2	0	0	0	0	0	0	15
Bacteria;Bacteria_none;Proteobacteria;Gammaproteobacteria;Enterobacterales;Enterobacteriaceae;Citrobacter;Citrobacter amalonaticus	11	0	0	2	2	0	0	0	15
Bacteria;Bacteria_none;Proteobacteria;Gammaproteobacteria;Enterobacterales;Enterobacteriaceae;Citrobacter;Citrobacter bitternis	11	0	0	4	0	0	0	0	15
Bacteria;Bacteria_none;Actinobacteria;Actinomycetia;Micrococcales;Microbacteriaceae;Leucobacter;Leucobacter populi	2	3	2	7	0	0	1	0	15
Bacteria;Bacteria_none;Firmicutes;Clostridia;Eubacteriales;Clostridiaceae;Clostridium;Clostridium beijerinckii	1	1	1	9	0	1	2	0	15
Bacteria;Bacteria_none;Actinobacteria;Actinomycetia;Pseudonocardiales;Pseudonocardiaceae;Amycolatopsis;Amycolatopsis niigatensis	0	1	2	11	0	1	0	0	15
Bacteria;Bacteria_none;Bacteroidota;Bacteroidia;Bacteroidales;Muribaculaceae;Duncaniella;Duncaniella freteri	1	0	3	7	0	0	0	4	15
Bacteria;Bacteria_none;Actinobacteria;Actinomycetia;Pseudonocardiales;Pseudonocardiaceae;Amycolatopsis;Amycolatopsis alba	0	0	0	15	0	0	0	0	15
Bacteria;Bacteria_none;Proteobacteria;Betaproteobacteria;Burkholderiales;Comamonadaceae;Hydrogenophaga;Hydrogenophaga palleronii	12	3	0	0	0	0	0	0	15
Bacteria;Bacteria_none;Actinobacteria;Actinomycetia;Actinomycetales;Actinomycetaceae;Fudania;Fudania jinshanensis	7	3	2	1	0	1	1	0	15
Bacteria;Bacteria_none;Firmicutes;Clostridia;Eubacteriales;Clostridiaceae;Clostridium;Clostridium cavendishii	2	2	5	4	1	0	1	0	15
Bacteria;Bacteria_none;Proteobacteria;Gammaproteobacteria;Enterobacterales;Enterobacteriaceae;Shigella;Shigella boydii	9	0	0	2	0	1	2	1	15
Bacteria;Bacteria_none;Bacteroidota;Bacteroidia;Marinilabiliales;Marinilabiliaceae;Saccharicrinis;Saccharicrinis aurantiacus	2	1	1	4	0	0	7	0	15
Bacteria;Bacteria_none;Proteobacteria;Gammaproteobacteria;Enterobacterales;Enterobacteriaceae;Shimwellia;Shimwellia pseudoproteus	8	0	1	4	0	0	1	1	15
Bacteria;Bacteria_none;Bacteroidota;Chitinophagia;Chitinophagales;Chitinophagaceae;Sediminibacterium;Sediminibacterium roseum	13	1	1	0	0	0	0	0	15
Bacteria;Bacteria_none;Proteobacteria;Alphaproteobacteria;Rhodobacterales;Rhodobacteraceae;Gemmobacter;Gemmobacter aestuarii	4	4	1	6	0	0	0	0	15
Bacteria;Bacteria_none;Proteobacteria;Alphaproteobacteria;Hyphomicrobiales;Phyllobacteriaceae;Aliihoeflea;Aliihoeflea aestuarii	1	2	6	4	0	1	1	0	15
Bacteria;Bacteria_none;Firmicutes;Bacilli;Bacillales;Bacillaceae;Lentibacillus;Lentibacillus persicus	0	0	0	12	1	2	0	0	15
Bacteria;Bacteria_none;Firmicutes;Clostridia;Halanaerobiales;Halobacteroidaceae;Orenia;Orenia chitinitropha	3	2	5	1	2	1	0	1	15
Bacteria;Bacteria_none;Firmicutes;Clostridia;Thermoanaerobacterales;Thermoanaerobacteraceae;Thermoanaerobacter;Thermoanaerobacter thermocopriae	0	2	8	0	0	5	0	0	15
Bacteria;Bacteria_none;Bacteroidota;Saprospiria;Saprospirales;Haliscomenobacteraceae;Phaeodactylibacter;Phaeodactylibacter luteus	8	7	0	0	0	0	0	0	15
Bacteria;Bacteria_none;Proteobacteria;Alphaproteobacteria;Hyphomicrobiales;Brucellaceae;Brucella;Brucella pecoris	0	0	1	14	0	0	0	0	15
Bacteria;Bacteria_none;Actinobacteria;Actinomycetia;Micrococcales;Microbacteriaceae;Agrococcus;Agrococcus baldri	5	2	3	3	1	0	1	0	15
Bacteria;Bacteria_none;Actinobacteria;Actinomycetia;Corynebacteriales;Mycobacteriaceae;Mycobacterium;Mycobacterium rufum	3	2	7	1	1	0	1	0	15
Bacteria;Bacteria_none;Proteobacteria;Alphaproteobacteria;Hyphomicrobiales;Phyllobacteriaceae;Aquamicrobium;Aquamicrobium soli	3	4	3	2	2	0	1	0	15
Bacteria;Bacteria_none;Chlorobi;Chlorobia;Chlorobiales;Chlorobiaceae;Chlorobaculum;Chlorobaculum chlorovibrioides	5	0	0	4	6	0	0	0	15
Bacteria;Bacteria_none;Actinobacteria;Actinomycetia;Corynebacteriales;Nocardiaceae;Nocardia;Nocardia yunnanensis	3	2	4	2	3	1	0	0	15
Bacteria;Bacteria_none;Firmicutes;Clostridia;Eubacteriales;Clostridiaceae;Clostridium;Clostridium rectalis	0	10	4	0	1	0	0	0	15
Bacteria;Bacteria_none;Proteobacteria;Alphaproteobacteria;Hyphomicrobiales;Methylobacteriaceae;Microvirga;Microvirga pakistanensis	3	3	4	5	0	0	0	0	15
Bacteria;Bacteria_none;Proteobacteria;Alphaproteobacteria;Hyphomicrobiales;Amorphaceae;Acuticoccus;Acuticoccus mangrovi	3	4	5	2	0	0	0	1	15
Bacteria;Bacteria_none;Chloroflexi;Ktedonobacteria;Ktedonobacterales;Ktedonobacteraceae;Ktedonospora;Ktedonospora formicarum	0	7	1	7	0	0	0	0	15
Bacteria;Bacteria_none;Firmicutes;Bacilli;Bacillales;Thermoactinomycetaceae;Thermoflavimicrobium;Thermoflavimicrobium dichotomicum	1	1	7	2	1	1	1	1	15
Bacteria;Bacteria_none;Proteobacteria;Alphaproteobacteria;Hyphomicrobiales;Hyphomicrobiaceae;Rhodoplanes;Rhodoplanes roseus	5	4	0	3	0	3	0	0	15
Bacteria;Bacteria_none;Proteobacteria;Alphaproteobacteria;Hyphomicrobiales;Aurantimonadaceae;Fulvimarina;Fulvimarina pelagi	3	2	6	3	0	1	0	0	15
Bacteria;Bacteria_none;Proteobacteria;Alphaproteobacteria;Hyphomicrobiales;Devosiaceae;Devosia;Devosia equisanguinis	1	2	5	7	0	0	0	0	15
Bacteria;Bacteria_none;Firmicutes;Bacilli;Bacillales;Bacillaceae;Parageobacillus;Parageobacillus thermantarcticus	2	0	10	2	0	1	0	0	15
Bacteria;Bacteria_none;Proteobacteria;Alphaproteobacteria;Hyphomicrobiales;Brucellaceae;Brucella;Brucella pituitosa	0	4	0	0	11	0	0	0	15
Bacteria;Bacteria_none;Actinobacteria;Actinomycetia;Corynebacteriales;Nocardiaceae;Rhodococcus;Rhodococcus cavernicola	0	15	0	0	0	0	0	0	15
Bacteria;Bacteria_none;Proteobacteria;Alphaproteobacteria;Hyphomicrobiales;Rhodovibrionaceae;Pelagibius;Pelagibius litoralis	7	4	2	1	0	0	0	1	15
Bacteria;Bacteria_none;Firmicutes;Clostridia;Eubacteriales;Heliobacteriaceae;Heliomicrobium;Heliomicrobium gestii	0	0	1	3	0	11	0	0	15
Bacteria;Bacteria_none;Firmicutes;Clostridia;Eubacteriales;Lachnospiraceae;Lacrimispora;Lacrimispora sphenoides	5	2	4	0	0	3	0	1	15
Bacteria;Bacteria_none;Proteobacteria;Alphaproteobacteria;Hyphomicrobiales;Rhizobiaceae;Rhizobium;Rhizobium mongolense	1	6	2	4	0	1	0	1	15
Bacteria;Bacteria_none;Firmicutes;Bacilli;Bacillales;Bacillaceae;Anaerobacillus;Anaerobacillus alkalilacustris	2	1	5	3	1	0	0	2	14
Bacteria;Bacteria_none;Proteobacteria;Deltaproteobacteria;Myxococcales;Polyangiaceae;Polyangium;Polyangium spumosum	11	3	0	0	0	0	0	0	14
Bacteria;Bacteria_none;Actinobacteria;Actinomycetia;Streptomycetales;Streptomycetaceae;Streptomyces;Streptomyces olivaceus	1	2	6	4	0	0	1	0	14
Bacteria;Bacteria_none;Firmicutes;Tissierellia;Tissierellales;Peptoniphilaceae;Miniphocaeibacter;Miniphocaeibacter massiliensis	2	8	0	2	0	1	1	0	14
Bacteria;Bacteria_none;Proteobacteria;Gammaproteobacteria;Xanthomonadales;Xanthomonadaceae;Lysobacter;Lysobacter ximonensis	8	5	1	0	0	0	0	0	14
Bacteria;Bacteria_none;Firmicutes;Bacilli;Bacillales;Bacillaceae;Alkalihalobacillus;Alkalihalobacillus hemicentroti	0	1	1	2	0	7	2	1	14
Bacteria;Bacteria_none;Fusobacteria;Fusobacteriia;Fusobacteriales;Fusobacteriaceae;Psychrilyobacter;Psychrilyobacter atlanticus	4	3	0	4	0	0	1	2	14
Bacteria;Bacteria_none;Proteobacteria;Gammaproteobacteria;Xanthomonadales;Xanthomonadaceae;Pseudoxanthomonas;Pseudoxanthomonas broegbernensis	5	1	0	4	0	1	2	1	14
Bacteria;Bacteria_none;Firmicutes;Bacilli;Bacillales;Thermoactinomycetaceae;Marininema;Marininema halotolerans	3	6	2	0	0	1	0	2	14
Bacteria;Bacteria_none;Actinobacteria;Actinomycetia;Streptosporangiales;Thermomonosporaceae;Actinomadura;Actinomadura glauciflava	1	5	3	4	1	0	0	0	14
Bacteria;Bacteria_none;Proteobacteria;Betaproteobacteria;Nitrosomonadales;Sterolibacteriaceae;Methyloversatilis;Methyloversatilis thermotolerans	12	0	0	2	0	0	0	0	14
Bacteria;Bacteria_none;Proteobacteria;Gammaproteobacteria;Legionellales;Legionellaceae;Legionella;Legionella jordanis	0	1	3	7	1	2	0	0	14
Bacteria;Bacteria_none;Firmicutes;Clostridia;Eubacteriales;Lachnospiraceae;Muricomes;Muricomes intestini	9	1	2	0	0	1	1	0	14
Bacteria;Bacteria_none;Proteobacteria;Alphaproteobacteria;Caulobacterales;Caulobacteraceae;Brevundimonas;Brevundimonas terrae	10	3	1	0	0	0	0	0	14
Bacteria;Bacteria_none;Actinobacteria;Rubrobacteria;Gaiellales;Gaiellaceae;Gaiella;Gaiella occulta	2	7	0	2	0	1	2	0	14
Bacteria;Bacteria_none;Firmicutes;Clostridia;Eubacteriales;Lachnospiraceae;Lachnotalea;Lachnotalea glycerini	1	1	2	9	0	0	1	0	14
Bacteria;Bacteria_none;Proteobacteria;Alphaproteobacteria;Hyphomicrobiales;Ancalomicrobiaceae;Siculibacillus;Siculibacillus lacustris	3	0	1	4	1	2	2	1	14
Bacteria;Bacteria_none;Actinobacteria;Actinomycetia;Micrococcales;Beutenbergiaceae;Beutenbergia;Beutenbergia cavernae	1	5	0	4	1	2	0	1	14
Bacteria;Bacteria_none;Firmicutes;Bacilli;Bacillales;Paenibacillaceae;Paenibacillus;Paenibacillus piscarius	3	4	2	0	0	5	0	0	14
Bacteria;Bacteria_none;Actinobacteria;Thermoleophilia;Solirubrobacterales;Patulibacteraceae;Patulibacter;Patulibacter americanus	0	4	3	7	0	0	0	0	14
Bacteria;Bacteria_none;Firmicutes;Clostridia;Eubacteriales;Lachnospiraceae;Anaerostipes;Anaerostipes faecalis	2	2	1	2	5	1	1	0	14
Bacteria;Bacteria_none;Actinobacteria;Thermoleophilia;Solirubrobacterales;Solirubrobacteraceae;Solirubrobacter;Solirubrobacter ginsenosidimutans	4	0	0	8	0	2	0	0	14
Bacteria;Bacteria_none;Proteobacteria;Betaproteobacteria;Burkholderiales;Oxalobacteraceae;Undibacterium;Undibacterium nitidum	7	7	0	0	0	0	0	0	14
Bacteria;Bacteria_none;Proteobacteria;Betaproteobacteria;Burkholderiales;Oxalobacteraceae;Pseudoduganella;Pseudoduganella ginsengisoli	10	1	0	1	0	1	0	1	14
Bacteria;Bacteria_none;Actinobacteria;Actinomycetia;Micrococcales;Micrococcaceae;Arthrobacter;Arthrobacter ginkgonis	2	6	2	3	0	0	1	0	14
Bacteria;Bacteria_none;Firmicutes;Negativicutes;Selenomonadales;Sporomusaceae;Propionispora;Propionispora hippei	0	0	10	4	0	0	0	0	14
Bacteria;Bacteria_none;Actinobacteria;Actinomycetia;Streptomycetales;Streptomycetaceae;Streptomyces;Streptomyces griseus	2	3	0	7	0	0	0	2	14
Bacteria;Bacteria_none;Proteobacteria;Gammaproteobacteria;Oceanospirillales;Pleioneaceae;Pleionea;Pleionea mediterranea	4	0	3	6	0	1	0	0	14
Bacteria;Bacteria_none;Firmicutes;Clostridia;Eubacteriales;Oscillospiraceae;Ligaoa;Ligaoa zhengdingensis	1	6	1	3	2	1	0	0	14
Bacteria;Bacteria_none;Proteobacteria;Gammaproteobacteria;Gammaproteobacteria_Incertae_sedis;Candidatus Competibacteraceae;Plasticicumulans;Plasticicumulans lactativorans	9	3	0	2	0	0	0	0	14
Bacteria;Bacteria_none;Actinobacteria;Actinomycetia;Propionibacteriales;Propionibacteriaceae;Arachnia;Arachnia rubra	5	6	0	1	0	1	0	1	14
Bacteria;Bacteria_none;Firmicutes;Clostridia;Eubacteriales;Peptostreptococcaceae;Peptostreptococcaceae_Incertae_sedis;[Clostridium] thermoalcaliphilum	0	1	6	4	1	1	1	0	14
Bacteria;Bacteria_none;Firmicutes;Bacilli;Bacillales;Bacillaceae;Mesobacillus;Mesobacillus boroniphilus	0	0	10	0	0	0	0	4	14
Bacteria;Bacteria_none;Proteobacteria;Gammaproteobacteria;Enterobacterales;Erwiniaceae;Pantoea;Pantoea dispersa	12	0	1	0	0	0	0	1	14
Bacteria;Bacteria_none;Firmicutes;Clostridia;Eubacteriales;Peptostreptococcaceae;Tepidibacter;Tepidibacter thalassicus	0	1	8	4	0	0	0	1	14
Bacteria;Bacteria_none;Actinobacteria;Actinomycetia;Corynebacteriales;Mycobacteriaceae;Mycolicibacter;Mycolicibacter senuensis	0	3	4	3	0	1	2	1	14
Bacteria;Bacteria_none;Proteobacteria;Gammaproteobacteria;Moraxellales;Moraxellaceae;Acinetobacter;Acinetobacter baylyi	9	0	2	1	0	1	0	1	14
Bacteria;Bacteria_none;Proteobacteria;Gammaproteobacteria;Enterobacterales;Enterobacteriaceae;Phytobacter;Phytobacter diazotrophicus	8	2	2	1	0	0	1	0	14
Bacteria;Bacteria_none;Firmicutes;Clostridia;Halanaerobiales;Halanaerobiaceae;Halarsenatibacter;Halarsenatibacter silvermanii	4	6	2	1	0	1	0	0	14
Bacteria;Bacteria_none;Acidobacteria;Blastocatellia;Blastocatellales;Pyrinomonadaceae;Pyrinomonas;Pyrinomonas methylaliphatogenes	1	0	7	2	1	3	0	0	14
Bacteria;Bacteria_none;Firmicutes;Bacilli;Bacillales;Bacillaceae;Bacillus;Bacillus manliponensis	0	0	0	11	0	0	0	3	14
Bacteria;Bacteria_none;Actinobacteria;Actinomycetia;Pseudonocardiales;Pseudonocardiaceae;Amycolatopsis;Amycolatopsis nivea	0	1	0	13	0	0	0	0	14
Bacteria;Bacteria_none;Firmicutes;Clostridia;Thermoanaerobacterales;Thermoanaerobacterales Family III. Incertae Sedis;Caldicellulosiruptor;Caldicellulosiruptor kronotskyensis	4	10	0	0	0	0	0	0	14
Bacteria;Bacteria_none;Actinobacteria;Actinomycetia;Frankiales;Frankiaceae;Frankia;Frankia casuarinae	0	9	5	0	0	0	0	0	14
Bacteria;Bacteria_none;Firmicutes;Bacilli;Lactobacillales;Streptococcaceae;Streptococcus;Streptococcus ovuberis	13	0	1	0	0	0	0	0	14
Bacteria;Bacteria_none;Proteobacteria;Gammaproteobacteria;Thiotrichales;Thiotrichaceae;Thiothrix;Thiothrix nivea	4	8	0	0	1	1	0	0	14
Bacteria;Bacteria_none;Proteobacteria;Gammaproteobacteria;Enterobacterales;Enterobacteriaceae;Buttiauxella;Buttiauxella warmboldiae	9	1	1	0	2	0	0	1	14
Bacteria;Bacteria_none;Proteobacteria;Gammaproteobacteria;Enterobacterales;Enterobacteriaceae;Buttiauxella;Buttiauxella brennerae	11	0	3	0	0	0	0	0	14
Bacteria;Bacteria_none;Firmicutes;Erysipelotrichia;Erysipelotrichales;Erysipelotrichaceae;Holdemania;Holdemania massiliensis	0	14	0	0	0	0	0	0	14
Bacteria;Bacteria_none;Firmicutes;Bacilli;Bacillales;Bacillales_Incertae_sedis;Acidibacillus;Acidibacillus ferrooxidans	1	3	8	0	0	1	0	1	14
Bacteria;Bacteria_none;Firmicutes;Negativicutes;Acidaminococcales;Acidaminococcaceae;Acidaminococcus;Acidaminococcus timonensis	0	1	3	3	0	0	4	3	14
Bacteria;Bacteria_none;Proteobacteria;Gammaproteobacteria;Aeromonadales;Succinivibrionaceae;Anaerobiospirillum;Anaerobiospirillum succiniciproducens	2	9	1	2	0	0	0	0	14
Bacteria;Bacteria_none;Firmicutes;Bacilli;Bacillales;Staphylococcaceae;Salinicoccus;Salinicoccus iranensis	1	1	5	2	0	4	0	1	14
Bacteria;Bacteria_none;Proteobacteria;Alphaproteobacteria;Rhodobacterales;Rhodobacteraceae;Albimonas;Albimonas donghaensis	2	4	3	5	0	0	0	0	14
Bacteria;Bacteria_none;Proteobacteria;Betaproteobacteria;Nitrosomonadales;Methylophilaceae;Novimethylophilus;Novimethylophilus kurashikiensis	10	1	0	1	1	0	0	1	14
Bacteria;Bacteria_none;Proteobacteria;Alphaproteobacteria;Sphingomonadales;Sphingosinicellaceae;Sandaracinobacter;Sandaracinobacter sibiricus	3	1	3	7	0	0	0	0	14
Bacteria;Bacteria_none;Proteobacteria;Alphaproteobacteria;Hyphomicrobiales;Rhizobiaceae;Liberibacter;Liberibacter crescens	0	2	12	0	0	0	0	0	14
Bacteria;Bacteria_none;Firmicutes;Clostridia;Eubacteriales;Clostridiaceae;Clostridium;Clostridium peptidivorans	1	2	4	3	1	0	2	1	14
Bacteria;Bacteria_none;Bacteroidota;Flavobacteriia;Flavobacteriales;Weeksellaceae;Chryseobacterium;Chryseobacterium rhizosphaerae	0	0	0	14	0	0	0	0	14
Bacteria;Bacteria_none;Bacteroidota;Chitinophagia;Chitinophagales;Chitinophagaceae;Aurantisolimonas;Aurantisolimonas haloimpatiens	10	1	2	1	0	0	0	0	14
Bacteria;Bacteria_none;Proteobacteria;Betaproteobacteria;Burkholderiales;Burkholderiaceae;Caballeronia;Caballeronia zhejiangensis	10	1	1	0	0	0	2	0	14
Bacteria;Bacteria_none;Proteobacteria;Betaproteobacteria;Burkholderiales;Burkholderiaceae;Caballeronia;Caballeronia udeis	13	1	0	0	0	0	0	0	14
Bacteria;Bacteria_none;Proteobacteria;Alphaproteobacteria;Hyphomicrobiales;Phyllobacteriaceae;Phyllobacterium;Phyllobacterium catacumbae	1	5	3	2	0	0	0	3	14
Bacteria;Bacteria_none;Proteobacteria;Alphaproteobacteria;Rhodobacterales;Rhodobacteraceae;Thioclava;Thioclava pacifica	4	5	2	1	2	0	0	0	14
Bacteria;Bacteria_none;Proteobacteria;Betaproteobacteria;Burkholderiales;Burkholderiaceae;Burkholderia;Burkholderia ambifaria	7	3	3	0	0	1	0	0	14
Bacteria;Bacteria_none;Bacteroidota;Cytophagia;Cytophagales;Spirosomaceae;Leadbetterella;Leadbetterella byssophila	10	2	0	2	0	0	0	0	14
Bacteria;Bacteria_none;Proteobacteria;Alphaproteobacteria;Hyphomicrobiales;Phyllobacteriaceae;Mesorhizobium;Mesorhizobium temperatum	0	9	0	3	0	0	2	0	14
Bacteria;Bacteria_none;Proteobacteria;Alphaproteobacteria;Hyphomicrobiales;Phyllobacteriaceae;Nitratireductor;Nitratireductor alexandrii	4	9	0	1	0	0	0	0	14
Bacteria;Bacteria_none;Bacteroidota;Chitinophagia;Chitinophagales;Chitinophagaceae;Chitinophaga;Chitinophaga solisilvae	14	0	0	0	0	0	0	0	14
Bacteria;Bacteria_none;Proteobacteria;Betaproteobacteria;Burkholderiales;Alcaligenaceae;Paenalcaligenes;Paenalcaligenes hermetiae	3	0	5	3	0	3	0	0	14
Bacteria;Bacteria_none;Firmicutes;Clostridia;Eubacteriales;Clostridiaceae;Clostridium;Clostridium subterminale	0	1	2	7	0	0	2	2	14
Bacteria;Bacteria_none;Proteobacteria;Alphaproteobacteria;Hyphomicrobiales;Phyllobacteriaceae;Mesorhizobium;Mesorhizobium xinjiangense	1	9	0	3	1	0	0	0	14
Bacteria;Bacteria_none;Bacteroidota;Chitinophagia;Chitinophagales;Chitinophagaceae;Limnovirga;Limnovirga soli	14	0	0	0	0	0	0	0	14
Bacteria;Bacteria_none;Firmicutes;Clostridia;Eubacteriales;Clostridiaceae;Clostridium;Clostridium vitabionis	3	4	4	2	0	0	0	1	14
Bacteria;Bacteria_none;Firmicutes;Clostridia;Eubacteriales;Clostridiaceae;Clostridium;Clostridium hydrogenum	0	1	8	1	0	3	0	1	14
Bacteria;Bacteria_none;Proteobacteria;Alphaproteobacteria;Rhodobacterales;Rhodobacteraceae;Pseudooceanicola;Pseudooceanicola nitratireducens	4	5	3	0	1	1	0	0	14
Bacteria;Bacteria_none;Proteobacteria;Alphaproteobacteria;Hyphomicrobiales;Nitrobacteraceae;Rhodopseudomonas;Rhodopseudomonas pentothenatexigens	4	0	2	7	0	1	0	0	14
Bacteria;Bacteria_none;Proteobacteria;Betaproteobacteria;Burkholderiales;Burkholderiales_Incertae_sedis;Tepidimonas;Tepidimonas fonticaldi	14	0	0	0	0	0	0	0	14
Bacteria;Bacteria_none;Proteobacteria;Alphaproteobacteria;Hyphomicrobiales;Xanthobacteraceae;Pseudolabrys;Pseudolabrys taiwanensis	4	2	5	1	1	0	0	1	14
Bacteria;Bacteria_none;Bacteroidota;Bacteroidia;Bacteroidales;Bacteroidaceae;Bacteroides;Bacteroides cellulosilyticus	0	2	0	9	0	0	0	3	14
Bacteria;Bacteria_none;Proteobacteria;Betaproteobacteria;Burkholderiales;Oxalobacteraceae;Herbaspirillum;Herbaspirillum huttiense	10	1	3	0	0	0	0	0	14
Bacteria;Bacteria_none;Bacteroidota;Cytophagia;Cytophagales;Hymenobacteraceae;Rufibacter;Rufibacter glacialis	0	0	4	9	0	1	0	0	14
Bacteria;Bacteria_none;Proteobacteria;Betaproteobacteria;Burkholderiales;Oxalobacteraceae;Herbaspirillum;Herbaspirillum camelliae	6	5	0	2	1	0	0	0	14
Bacteria;Bacteria_none;Proteobacteria;Alphaproteobacteria;Hyphomicrobiales;Kaistiaceae;Kaistia;Kaistia defluvii	0	5	4	3	1	1	0	0	14
Bacteria;Bacteria_none;Actinobacteria;Actinomycetia;Actinomycetia_Incertae_sedis;Actinomycetia_Incertae_sedis;Bounagaea;Bounagaea algeriensis	2	3	5	3	0	1	0	0	14
Bacteria;Bacteria_none;Proteobacteria;Alphaproteobacteria;Rhodobacterales;Rhodobacteraceae;Mangrovicoccus;Mangrovicoccus algicola	3	6	2	3	0	0	0	0	14
Bacteria;Bacteria_none;Proteobacteria;Alphaproteobacteria;Hyphomicrobiales;Rhizobiaceae;Rhizobium;Rhizobium halophytocola	6	6	1	1	0	0	0	0	14
Bacteria;Bacteria_none;Proteobacteria;Betaproteobacteria;Burkholderiales;Alcaligenaceae;Advenella;Advenella mandrilli	6	5	1	0	0	2	0	0	14
Bacteria;Bacteria_none;Proteobacteria;Alphaproteobacteria;Hyphomicrobiales;Methylocystaceae;Methylocystis;Methylocystis hirsuta	9	3	2	0	0	0	0	0	14
Bacteria;Bacteria_none;Proteobacteria;Alphaproteobacteria;Rhodobacterales;Rhodobacteraceae;Rhodobacter;Rhodobacter ruber	7	4	1	0	0	1	0	1	14
Bacteria;Bacteria_none;Bacteroidota;Bacteroidia;Marinilabiliales;Marinifilaceae;Labilibaculum;Labilibaculum antarcticum	2	1	4	6	0	0	0	1	14
Bacteria;Bacteria_none;Bacteroidota;Bacteroidia;Marinilabiliales;Marinilabiliaceae;Carboxylicivirga;Carboxylicivirga marina	3	6	3	1	0	0	0	1	14
Bacteria;Bacteria_none;Bacteroidota;Flavobacteriia;Flavobacteriales;Flavobacteriaceae;Myroides;Myroides pelagicus	7	1	3	1	0	1	1	0	14
Bacteria;Bacteria_none;Proteobacteria;Gammaproteobacteria;Moraxellales;Moraxellaceae;Faucicola;Faucicola mancuniensis	3	0	2	5	1	1	1	0	13
Bacteria;Bacteria_none;Firmicutes;Clostridia;Eubacteriales;Clostridiaceae;Clostridium;Clostridium pabulibutyricum	4	0	5	0	2	1	0	1	13
Bacteria;Bacteria_none;Proteobacteria;Alphaproteobacteria;Rhodobacterales;Rhodobacteraceae;Rhodovulum;Rhodovulum kholense	4	2	5	1	0	1	0	0	13
Bacteria;Bacteria_none;Firmicutes;Clostridia;Eubacteriales;Oscillospiraceae;Anaerotruncus;Anaerotruncus colihominis	0	9	1	2	1	0	0	0	13
Bacteria;Bacteria_none;Firmicutes;Clostridia;Eubacteriales;Eubacteriaceae;Eubacterium;Eubacterium ramulus	9	1	2	1	0	0	0	0	13
Bacteria;Bacteria_none;Proteobacteria;Gammaproteobacteria;Pasteurellales;Pasteurellaceae;Haemophilus;Haemophilus sputorum	0	0	0	13	0	0	0	0	13
Bacteria;Bacteria_none;Firmicutes;Clostridia;Eubacteriales;Oscillospiraceae;Agathobaculum;Agathobaculum desmolans	10	1	1	0	0	1	0	0	13
Bacteria;Bacteria_none;Firmicutes;Bacilli;Lactobacillales;Streptococcaceae;Streptococcus;Streptococcus cuniculipharyngis	7	1	2	3	0	0	0	0	13
Bacteria;Bacteria_none;Actinobacteria;Actinomycetia;Micrococcales;Dermacoccaceae;Allobranchiibius;Allobranchiibius huperziae	0	1	4	5	0	3	0	0	13
Bacteria;Bacteria_none;Firmicutes;Clostridia;Eubacteriales;Eubacteriaceae;Intestinibacillus;Intestinibacillus massiliensis	0	2	4	2	2	3	0	0	13
Bacteria;Bacteria_none;Verrucomicrobia;Verrucomicrobiae;Verrucomicrobiales;Verrucomicrobiaceae;Roseibacillus;Roseibacillus ishigakijimensis	13	0	0	0	0	0	0	0	13
Bacteria;Bacteria_none;Verrucomicrobia;Verrucomicrobiae;Verrucomicrobiales;Verrucomicrobiaceae;Persicirhabdus;Persicirhabdus sediminis	2	11	0	0	0	0	0	0	13
Bacteria;Bacteria_none;Firmicutes;Clostridia;Eubacteriales;Clostridiaceae;Clostridium;Clostridium punense	3	2	5	1	0	1	1	0	13
Bacteria;Bacteria_none;Verrucomicrobia;Opitutae;Puniceicoccales;Puniceicoccaceae;Ruficoccus;Ruficoccus amylovorans	2	10	0	1	0	0	0	0	13
Bacteria;Bacteria_none;Tenericutes;Mollicutes;Entomoplasmatales;Spiroplasmataceae;Spiroplasma;Spiroplasma platyhelix	1	5	6	0	0	1	0	0	13
Bacteria;Bacteria_none;Proteobacteria;Alphaproteobacteria;Rhodobacterales;Rhodobacteraceae;Paracoccus;Paracoccus aminophilus	3	3	0	7	0	0	0	0	13
Bacteria;Bacteria_none;Proteobacteria;Alphaproteobacteria;Rhodobacterales;Rhodobacteraceae;Paracoccus;Paracoccus chinensis	5	0	0	4	0	1	3	0	13
Bacteria;Bacteria_none;Spirochaetes;Spirochaetia;Spirochaetales;Sphaerochaetaceae;Sphaerochaeta;Sphaerochaeta globosa	0	12	1	0	0	0	0	0	13
Bacteria;Bacteria_none;Proteobacteria;Alphaproteobacteria;Hyphomicrobiales;Stappiaceae;Stappia;Stappia albiluteola	6	3	1	1	1	0	1	0	13
Bacteria;Bacteria_none;Proteobacteria;Gammaproteobacteria;Xanthomonadales;Xanthomonadaceae;Stenotrophomonas;Stenotrophomonas pavanii	12	1	0	0	0	0	0	0	13
Bacteria;Bacteria_none;Firmicutes;Clostridia;Eubacteriales;Lachnospiraceae;Mobilitalea;Mobilitalea sibirica	0	3	1	5	1	3	0	0	13
Bacteria;Bacteria_none;Proteobacteria;Alphaproteobacteria;Rhodobacterales;Rhodobacteraceae;Paracoccus;Paracoccus sediminilitoris	8	1	2	2	0	0	0	0	13
Bacteria;Bacteria_none;Proteobacteria;Alphaproteobacteria;Hyphomicrobiales;Rhizobiaceae;Rhizobium;Rhizobium tumorigenes	4	3	2	3	0	0	1	0	13
Bacteria;Bacteria_none;Proteobacteria;Gammaproteobacteria;Xanthomonadales;Xanthomonadaceae;Lysobacter;Lysobacter telluris	8	1	0	2	0	1	1	0	13
Bacteria;Bacteria_none;Proteobacteria;Alphaproteobacteria;Hyphomicrobiales;Rhizobiaceae;Rhizobium;Rhizobium soli	5	1	2	4	0	1	0	0	13
Bacteria;Bacteria_none;Firmicutes;Clostridia;Eubacteriales;Lachnospiraceae;Wansuia;Wansuia hejianensis	2	1	2	3	1	2	1	1	13
Bacteria;Bacteria_none;Actinobacteria;Actinomycetia;Glycomycetales;Glycomycetaceae;Glycomyces;Glycomyces tritici	1	1	1	6	0	3	1	0	13
Bacteria;Bacteria_none;Proteobacteria;Alphaproteobacteria;Rhodobacterales;Rhodobacteraceae;Sinirhodobacter;Sinirhodobacter ferrireducens	1	6	0	5	0	0	1	0	13
Bacteria;Bacteria_none;Proteobacteria;Alphaproteobacteria;Hyphomicrobiales;Chelatococcaceae;Chelatococcus;Chelatococcus reniformis	3	6	0	4	0	0	0	0	13
Bacteria;Bacteria_none;Firmicutes;Clostridia;Eubacteriales;Clostridiaceae;Clostridium;Clostridium novyi	1	1	3	5	0	2	0	1	13
Bacteria;Bacteria_none;Proteobacteria;Deltaproteobacteria;Desulfarculales;Desulfarculaceae;Dethiosulfatarculus;Dethiosulfatarculus sandiegensis	2	9	0	1	0	0	1	0	13
Bacteria;Bacteria_none;Proteobacteria;Deltaproteobacteria;Desulfovibrionales;Desulfovibrionaceae;Megalodesulfovibrio;Megalodesulfovibrio paquesii	0	6	6	0	1	0	0	0	13
Bacteria;Bacteria_none;Firmicutes;Tissierellia;Tissierellales;Peptoniphilaceae;Finegoldia;Finegoldia magna	3	4	5	0	0	0	1	0	13
Bacteria;Bacteria_none;Proteobacteria;Betaproteobacteria;Burkholderiales;Burkholderiaceae;Ephemeroptericola;Ephemeroptericola cinctiostellae	8	1	2	1	0	0	1	0	13
Bacteria;Bacteria_none;Firmicutes;Tissierellia;Tissierellales;Peptoniphilaceae;Peptoniphilus;Peptoniphilus gorbachii	5	0	8	0	0	0	0	0	13
Bacteria;Bacteria_none;Proteobacteria;Betaproteobacteria;Burkholderiales;Burkholderiaceae;Paraburkholderia;Paraburkholderia caseinilytica	9	3	1	0	0	0	0	0	13
Bacteria;Bacteria_none;Planctomycetota;Planctomycetia;Isosphaerales;Isosphaeraceae;Tautonia;Tautonia rosea	9	4	0	0	0	0	0	0	13
Bacteria;Bacteria_none;Proteobacteria;Deltaproteobacteria;Desulfobacterales;Desulfobacteraceae;Desulfosarcina;Desulfosarcina variabilis	3	6	0	0	4	0	0	0	13
Bacteria;Bacteria_none;Proteobacteria;Betaproteobacteria;Nitrosomonadales;Thiobacillaceae;Annwoodia;Annwoodia aquaesulis	10	0	1	0	0	1	0	1	13
Bacteria;Bacteria_none;Firmicutes;Clostridia;Eubacteriales;Peptococcaceae;Desulfofalx;Desulfofalx alkaliphila	1	3	6	2	0	1	0	0	13
Bacteria;Bacteria_none;Planctomycetota;Planctomycetia;Pirellulales;Pirellulaceae;Bremerella;Bremerella volcania	13	0	0	0	0	0	0	0	13
Bacteria;Bacteria_none;Proteobacteria;Betaproteobacteria;Nitrosomonadales;Methylophilaceae;Pseudomethylobacillus;Pseudomethylobacillus aquaticus	3	2	2	1	0	5	0	0	13
Bacteria;Bacteria_none;Proteobacteria;Betaproteobacteria;Neisseriales;Chromobacteriaceae;Microvirgula;Microvirgula curvata	4	2	0	6	0	0	1	0	13
Bacteria;Bacteria_none;Actinobacteria;Actinomycetia;Corynebacteriales;Dietziaceae;Dietzia;Dietzia kunjamensis	0	0	2	7	1	2	1	0	13
Bacteria;Bacteria_none;Firmicutes;Clostridia;Eubacteriales;Clostridiaceae;Clostridium;Clostridium carnis	1	3	2	6	0	0	0	1	13
Bacteria;Bacteria_none;Proteobacteria;Alphaproteobacteria;Hyphomicrobiales;Methylobacteriaceae;Methylorubrum;Methylorubrum populi	5	5	1	2	0	0	0	0	13
Bacteria;Bacteria_none;Firmicutes;Clostridia;Eubacteriales;Clostridiaceae;Caminicella;Caminicella sporogenes	1	2	5	1	0	3	1	0	13
Bacteria;Bacteria_none;Firmicutes;Clostridia;Eubacteriales;Defluviitaleaceae;Defluviitalea;Defluviitalea saccharophila	0	1	5	1	0	5	1	0	13
Bacteria;Bacteria_none;Proteobacteria;Betaproteobacteria;Burkholderiales;Burkholderiaceae;Burkholderia;Burkholderia mallei	7	2	0	3	0	0	1	0	13
Bacteria;Bacteria_none;Proteobacteria;Epsilonproteobacteria;Campylobacterales;Campylobacteraceae;Campylobacter;Campylobacter ureolyticus	0	8	5	0	0	0	0	0	13
Bacteria;Bacteria_none;Proteobacteria;Epsilonproteobacteria;Campylobacterales;Sulfurospirillaceae;Sulfurospirillum;Sulfurospirillum deleyianum	1	0	6	1	0	1	2	2	13
Bacteria;Bacteria_none;Proteobacteria;Gammaproteobacteria;Enterobacterales;Yersiniaceae;Rahnella;Rahnella aceris	12	1	0	0	0	0	0	0	13
Bacteria;Bacteria_none;Proteobacteria;Alphaproteobacteria;Rhodobacterales;Roseobacteraceae;Roseovarius;Roseovarius confluentis	5	8	0	0	0	0	0	0	13
Bacteria;Bacteria_none;Actinobacteria;Actinomycetia;Bifidobacteriales;Bifidobacteriaceae;Bifidobacterium;Bifidobacterium thermacidophilum	0	0	4	5	0	0	1	3	13
Bacteria;Bacteria_none;Proteobacteria;Alphaproteobacteria;Hyphomicrobiales;Rhizobiaceae;Rhizobium;Rhizobium etli	4	9	0	0	0	0	0	0	13
Bacteria;Bacteria_none;Proteobacteria;Gammaproteobacteria;Enterobacterales;Erwiniaceae;Erwinia;Erwinia typographi	11	0	0	2	0	0	0	0	13
Bacteria;Bacteria_none;Proteobacteria;Alphaproteobacteria;Rhodospirillales;Acetobacteraceae;Roseomonas;Roseomonas oryzae	4	5	0	3	0	0	1	0	13
Bacteria;Bacteria_none;Proteobacteria;Gammaproteobacteria;Enterobacterales;Enterobacteriaceae;Shigella;Shigella flexneri	8	3	2	0	0	0	0	0	13
Bacteria;Bacteria_none;Firmicutes;Clostridia;Eubacteriales;Clostridiaceae;Clostridium;Clostridium moniliforme	0	1	1	7	2	0	1	1	13
Bacteria;Bacteria_none;Proteobacteria;Alphaproteobacteria;Hyphomicrobiales;Rhizobiaceae;Rhizobium;Rhizobium ecuadorense	2	4	4	2	0	1	0	0	13
Bacteria;Bacteria_none;Proteobacteria;Betaproteobacteria;Burkholderiales;Oxalobacteraceae;Massilia;Massilia atriviolacea	12	0	0	0	1	0	0	0	13
Bacteria;Bacteria_none;Firmicutes;Erysipelotrichia;Erysipelotrichales;Erysipelotrichaceae;Bulleidia;Bulleidia extructa	7	0	3	2	0	1	0	0	13
Bacteria;Bacteria_none;Proteobacteria;Betaproteobacteria;Burkholderiales;Alcaligenaceae;Derxia;Derxia gummosa	6	5	1	0	0	1	0	0	13
Bacteria;Bacteria_none;Firmicutes;Erysipelotrichia;Erysipelotrichales;Erysipelotrichaceae;Tannockella;Tannockella kyphosi	1	2	4	5	0	0	0	1	13
Bacteria;Bacteria_none;Proteobacteria;Alphaproteobacteria;Hyphomicrobiales;Phyllobacteriaceae;Mesorhizobium;Mesorhizobium thiogangeticum	3	5	0	1	0	2	0	2	13
Bacteria;Bacteria_none;Proteobacteria;Gammaproteobacteria;Aeromonadales;Aeromonadaceae;Pseudaeromonas;Pseudaeromonas pectinilytica	4	0	2	2	0	3	1	1	13
Bacteria;Bacteria_none;Proteobacteria;Alphaproteobacteria;Rhodospirillales;Stellaceae;Constrictibacter;Constrictibacter antarcticus	11	0	1	1	0	0	0	0	13
Bacteria;Bacteria_none;Actinobacteria;Actinomycetia;Micrococcales;Microbacteriaceae;Microbacterium;Microbacterium excoecariae	0	1	3	4	0	4	1	0	13
Bacteria;Bacteria_none;Actinobacteria;Actinomycetia;Streptomycetales;Streptomycetaceae;Streptomyces;Streptomyces beijiangensis	0	1	4	6	0	1	0	1	13
Bacteria;Bacteria_none;Actinobacteria;Actinomycetia;Micromonosporales;Micromonosporaceae;Mangrovihabitans;Mangrovihabitans endophyticus	2	11	0	0	0	0	0	0	13
Bacteria;Bacteria_none;Firmicutes;Bacilli;Bacillales;Paenibacillaceae;Paenibacillus;Paenibacillus brasilensis	0	1	7	2	0	3	0	0	13
Bacteria;Bacteria_none;Firmicutes;Bacilli;Bacillales;Bacillaceae;Pontibacillus;Pontibacillus yanchengensis	0	1	9	0	2	0	1	0	13
Bacteria;Bacteria_none;Bacteroidota;Flavobacteriia;Flavobacteriales;Flavobacteriaceae;Flavobacterium;Flavobacterium lutivivi	5	0	2	5	0	0	1	0	13
Bacteria;Bacteria_none;Actinobacteria;Actinomycetia;Pseudonocardiales;Pseudonocardiaceae;Actinomycetospora;Actinomycetospora callitridis	0	0	2	11	0	0	0	0	13
Bacteria;Bacteria_none;Cyanobacteria;Cyanobacteria_Incertae_sedis;Nostocales;Symphyonemataceae;Loriellopsis;Loriellopsis cavernicola	5	3	2	0	2	0	0	1	13
Bacteria;Bacteria_none;Firmicutes;Bacilli;Bacillales;Sporolactobacillaceae;Sporolactobacillus;Sporolactobacillus nakayamae	0	1	7	1	1	2	0	1	13
Bacteria;Bacteria_none;Actinobacteria;Actinomycetia;Micrococcales;Microbacteriaceae;Leucobacter;Leucobacter albus	0	3	6	2	1	1	0	0	13
Bacteria;Bacteria_none;Actinobacteria;Actinomycetia;Pseudonocardiales;Pseudonocardiaceae;Pseudonocardia;Pseudonocardia nigra	0	0	0	13	0	0	0	0	13
Bacteria;Bacteria_none;Bacteroidota;Bacteroidia;Bacteroidales;Porphyromonadaceae;Falsiporphyromonas;Falsiporphyromonas endometrii	1	0	6	6	0	0	0	0	13
Bacteria;Bacteria_none;Actinobacteria;Actinomycetia;Streptomycetales;Streptomycetaceae;Streptomyces;Streptomyces camponoti	1	3	3	3	1	1	1	0	13
Bacteria;Bacteria_none;Actinobacteria;Actinomycetia;Micrococcales;Microbacteriaceae;Leucobacter;Leucobacter chromiireducens	1	1	0	6	0	0	5	0	13
Bacteria;Bacteria_none;Actinobacteria;Actinomycetia;Streptomycetales;Streptomycetaceae;Streptomyces;Streptomyces burgazadensis	0	2	2	8	0	1	0	0	13
Bacteria;Bacteria_none;Actinobacteria;Actinomycetia;Streptomycetales;Streptomycetaceae;Streptomyces;Streptomyces broussonetiae	0	2	3	4	2	1	0	1	13
Bacteria;Bacteria_none;Firmicutes;Bacilli;Bacillales;Bacillaceae;Anoxybacillus;Anoxybacillus kestanbolensis	1	0	10	1	1	0	0	0	13
Bacteria;Bacteria_none;Firmicutes;Bacilli;Bacillales;Paenibacillaceae;Aneurinibacillus;Aneurinibacillus aneurinilyticus	0	1	11	0	0	0	0	1	13
Bacteria;Bacteria_none;Firmicutes;Bacilli;Bacillales;Staphylococcaceae;Jeotgalicoccus;Jeotgalicoccus coquinae	1	1	4	5	0	0	1	1	13
Bacteria;Bacteria_none;Firmicutes;Bacilli;Lactobacillales;Lactobacillaceae;Leuconostoc;Leuconostoc mesenteroides	4	9	0	0	0	0	0	0	13
Bacteria;Bacteria_none;Firmicutes;Bacilli;Bacillales;Paenibacillaceae;Cohnella;Cohnella ferri	1	1	6	0	0	4	1	0	13
Bacteria;Bacteria_none;Firmicutes;Bacilli;Bacillales;Bacillaceae;Anaerobacillus;Anaerobacillus alkaliphilus	0	0	6	1	1	5	0	0	13
Bacteria;Bacteria_none;Cyanobacteria;Cyanobacteria_Incertae_sedis;Pseudanabaenales;Oculatellaceae;Oculatella;Oculatella mojaviensis	1	4	3	5	0	0	0	0	13
Bacteria;Bacteria_none;Firmicutes;Bacilli;Bacillales;Paenibacillaceae;Paenibacillus;Paenibacillus assamensis	0	1	6	1	2	2	0	1	13
Bacteria;Bacteria_none;Cyanobacteria;Cyanobacteria_Incertae_sedis;Nostocales;Hapalosiphonaceae;Neowestiellopsis;Neowestiellopsis bilateralis	0	3	1	9	0	0	0	0	13
Bacteria;Bacteria_none;Chloroflexi;Chloroflexi_Incertae_sedis;Chloroflexi_Incertae_sedis;Chloroflexi_Incertae_sedis;Thermobaculum;Thermobaculum terrenum	0	2	4	5	1	0	0	1	13
Bacteria;Bacteria_none;Firmicutes;Bacilli;Bacillales;Bacillaceae;Lysinibacillus;Lysinibacillus fusiformis	0	0	10	0	3	0	0	0	13
Bacteria;Bacteria_none;Deferribacteres;Deferribacteres;Deferribacterales;Mucispirillaceae;Mucispirillum;Mucispirillum schaedleri	1	5	4	0	1	2	0	0	13
Bacteria;Bacteria_none;Actinobacteria;Actinomycetia;Streptomycetales;Streptomycetaceae;Streptomyces;Streptomyces yanii	0	1	3	6	0	0	3	0	13
Bacteria;Bacteria_none;Chlorobi;Chlorobia;Chlorobiales;Chlorobiaceae;Chlorobaculum;Chlorobaculum thiosulfatiphilum	0	0	13	0	0	0	0	0	13
Bacteria;Bacteria_none;Actinobacteria;Actinomycetia;Propionibacteriales;Nocardioidaceae;Propionicimonas;Propionicimonas ferrireducens	3	1	3	4	0	2	0	0	13
Bacteria;Bacteria_none;Firmicutes;Bacilli;Lactobacillales;Lactobacillaceae;Ligilactobacillus;Ligilactobacillus animalis	10	0	2	0	0	0	1	0	13
Bacteria;Bacteria_none;Cyanobacteria;Cyanobacteria_Incertae_sedis;Pseudanabaenales;Prochlorotrichaceae;Nodosilinea;Nodosilinea svalbardensis	0	3	4	2	2	1	0	1	13
Bacteria;Bacteria_none;Firmicutes;Bacilli;Lactobacillales;Streptococcaceae;Lactococcus;Lactococcus allomyrinae	11	0	0	0	0	0	1	1	13
Bacteria;Bacteria_none;Chlorobi;Chlorobia;Chlorobiales;Chlorobiaceae;Prosthecochloris;Prosthecochloris vibrioformis	1	2	5	2	0	1	2	0	13
Bacteria;Bacteria_none;Bacteroidota;Bacteroidia;Bacteroidales;Prevotellaceae;Prevotella;Prevotella maculosa	4	0	0	8	0	0	1	0	13
Bacteria;Bacteria_none;Actinobacteria;Actinomycetia;Micromonosporales;Micromonosporaceae;Actinoplanes;Actinoplanes durhamensis	1	0	8	3	0	1	0	0	13
Bacteria;Bacteria_none;Actinobacteria;Actinomycetia;Streptomycetales;Streptomycetaceae;Streptomyces;Streptomyces scopuliridis	0	7	0	0	0	3	0	3	13
Bacteria;Bacteria_none;Firmicutes;Bacilli;Lactobacillales;Enterococcaceae;Bavariicoccus;Bavariicoccus seileri	1	0	7	1	3	0	1	0	13
Bacteria;Bacteria_none;Bacteroidota;Bacteroidia;Bacteroidales;Prevotellaceae;Prevotella;Prevotella ruminicola	4	0	0	3	2	2	0	2	13
Bacteria;Bacteria_none;Proteobacteria;Alphaproteobacteria;Caulobacterales;Caulobacteraceae;Brevundimonas;Brevundimonas kwangchunensis	6	2	0	4	0	0	0	0	12
Bacteria;Bacteria_none;Firmicutes;Bacilli;Bacillales;Staphylococcaceae;Salinicoccus;Salinicoccus alkaliphilus	0	0	7	2	0	3	0	0	12
Bacteria;Bacteria_none;Firmicutes;Clostridia;Eubacteriales;Eubacteriales_Incertae_sedis;Eubacteriales_Incertae_sedis;[Bacteroides] pectinophilus	6	4	0	1	0	1	0	0	12
Bacteria;Bacteria_none;Proteobacteria;Alphaproteobacteria;Sphingomonadales;Sphingosinicellaceae;Sandaracinobacteroides;Sandaracinobacteroides hominis	1	0	2	7	0	1	1	0	12
Bacteria;Bacteria_none;Firmicutes;Clostridia;Eubacteriales;Eubacteriales Family XIII. Incertae Sedis;Mogibacterium;Mogibacterium vescum	2	0	1	0	0	7	0	2	12
Bacteria;Bacteria_none;Cyanobacteria;Cyanobacteria_Incertae_sedis;Pseudanabaenales;Prochlorotrichaceae;Nodosilinea;Nodosilinea bijugata	1	4	0	4	0	3	0	0	12
Bacteria;Bacteria_none;Proteobacteria;Alphaproteobacteria;Caulobacterales;Caulobacteraceae;Caulobacter;Caulobacter profundus	9	0	0	1	1	0	1	0	12
Bacteria;Bacteria_none;Bacteroidota;Bacteroidia;Marinilabiliales;Marinilabiliaceae;Saccharicrinis;Saccharicrinis fermentans	0	9	0	0	1	0	2	0	12
Bacteria;Bacteria_none;Proteobacteria;Betaproteobacteria;Burkholderiales;Burkholderiaceae;Paraburkholderia;Paraburkholderia caballeronis	4	3	1	1	0	3	0	0	12
Bacteria;Bacteria_none;Proteobacteria;Gammaproteobacteria;Legionellales;Legionellaceae;Legionella;Legionella sainthelensi	5	1	0	5	0	1	0	0	12
Bacteria;Bacteria_none;Proteobacteria;Gammaproteobacteria;Legionellales;Legionellaceae;Legionella;Legionella rubrilucens	2	3	0	2	3	1	1	0	12
Bacteria;Bacteria_none;Proteobacteria;Betaproteobacteria;Burkholderiales;Burkholderiaceae;Chitinimonas;Chitinimonas lacunae	6	2	2	0	0	2	0	0	12
Bacteria;Bacteria_none;Firmicutes;Clostridia;Eubacteriales;Eubacteriaceae;Eubacterium;Eubacterium multiforme	2	4	2	3	0	1	0	0	12
Bacteria;Bacteria_none;Firmicutes;Clostridia;Eubacteriales;Eubacteriaceae;Garciella;Garciella nitratireducens	0	0	9	1	1	1	0	0	12
Bacteria;Bacteria_none;Proteobacteria;Alphaproteobacteria;Hyphomicrobiales;Rhizobiaceae;Pseudorhizobium;Pseudorhizobium marinum	7	3	2	0	0	0	0	0	12
Bacteria;Bacteria_none;Firmicutes;Clostridia;Eubacteriales;Desulfitobacteriaceae;Syntrophobotulus;Syntrophobotulus glycolicus	1	1	7	0	1	2	0	0	12
Bacteria;Bacteria_none;Proteobacteria;Gammaproteobacteria;Moraxellales;Moraxellaceae;Acinetobacter;Acinetobacter chengduensis	8	0	0	0	0	0	4	0	12
Bacteria;Bacteria_none;Proteobacteria;Alphaproteobacteria;Hyphomicrobiales;Nitrobacteraceae;Bradyrhizobium;Bradyrhizobium neotropicale	0	8	0	4	0	0	0	0	12
Bacteria;Bacteria_none;Actinobacteria;Actinomycetia;Micrococcales;Micrococcaceae;Nesterenkonia;Nesterenkonia alba	0	1	1	9	0	0	0	1	12
Bacteria;Bacteria_none;Bacteroidota;Sphingobacteriia;Sphingobacteriales;Sphingobacteriaceae;Sphingobacterium;Sphingobacterium paludis	4	0	2	2	0	1	3	0	12
Bacteria;Bacteria_none;Caldiserica;Caldisericia;Caldisericales;Caldisericaceae;Caldisericum;Caldisericum exile	0	4	3	5	0	0	0	0	12
Bacteria;Bacteria_none;Proteobacteria;Alphaproteobacteria;Rhodobacterales;Rhodobacteraceae;Rhodovulum;Rhodovulum phaeolacus	5	1	0	6	0	0	0	0	12
Bacteria;Bacteria_none;Proteobacteria;Alphaproteobacteria;Hyphomicrobiales;Methylocystaceae;Methylopila;Methylopila carotae	2	2	2	3	2	0	1	0	12
Bacteria;Bacteria_none;Proteobacteria;Gammaproteobacteria;Xanthomonadales;Rhodanobacteraceae;Aerosticca;Aerosticca soli	0	1	6	1	0	0	3	1	12
Bacteria;Bacteria_none;Chloroflexi;Anaerolineae;Anaerolineales;Anaerolineaceae;Anaerolinea;Anaerolinea thermolimosa	2	5	5	0	0	0	0	0	12
Bacteria;Bacteria_none;Proteobacteria;Alphaproteobacteria;Hyphomicrobiales;Methylocystaceae;Albibacter;Albibacter methylovorans	2	4	3	2	0	1	0	0	12
Bacteria;Bacteria_none;Firmicutes;Clostridia;Eubacteriales;Clostridiaceae;Clostridium;Clostridium tarantellae	3	1	1	2	0	0	3	2	12
Bacteria;Bacteria_none;Proteobacteria;Alphaproteobacteria;Rhodospirillales;Rhodospirillaceae;Ferruginivarius;Ferruginivarius sediminum	1	6	3	1	0	0	1	0	12
Bacteria;Bacteria_none;Actinobacteria;Actinomycetia;Micrococcales;Microbacteriaceae;Amnibacterium;Amnibacterium endophyticum	0	2	3	7	0	0	0	0	12
Bacteria;Bacteria_none;Firmicutes;Clostridia;Eubacteriales;Clostridiaceae;Crassaminicella;Crassaminicella profunda	0	0	1	2	3	2	2	2	12
Bacteria;Bacteria_none;Cyanobacteria;Cyanobacteria_Incertae_sedis;Nostocales;Nostocaceae;Nostoc;Nostoc lichenoides	3	7	1	0	0	1	0	0	12
Bacteria;Bacteria_none;Proteobacteria;Alphaproteobacteria;Sphingomonadales;Erythrobacteraceae;Erythrobacter;Erythrobacter cryptus	0	0	7	1	4	0	0	0	12
Bacteria;Bacteria_none;Proteobacteria;Alphaproteobacteria;Sphingomonadales;Erythrobacteraceae;Erythrobacter;Erythrobacter longus	1	2	0	6	1	2	0	0	12
Bacteria;Bacteria_none;Proteobacteria;Gammaproteobacteria;Nevskiales;Steroidobacteraceae;Steroidobacter;Steroidobacter denitrificans	10	2	0	0	0	0	0	0	12
Bacteria;Bacteria_none;Proteobacteria;Alphaproteobacteria;Hyphomicrobiales;Boseaceae;Bosea;Bosea minatitlanensis	0	0	0	12	0	0	0	0	12
Bacteria;Bacteria_none;Proteobacteria;Gammaproteobacteria;Nevskiales;Algiphilaceae;Algiphilus;Algiphilus acroporae	3	3	2	3	0	0	0	1	12
Bacteria;Bacteria_none;Proteobacteria;Gammaproteobacteria;Moraxellales;Moraxellaceae;Acinetobacter;Acinetobacter ursingii	8	0	2	2	0	0	0	0	12
Bacteria;Bacteria_none;Proteobacteria;Alphaproteobacteria;Sphingomonadales;Sphingomonadaceae;Sphingomonas;Sphingomonas astaxanthinifaciens	0	8	1	0	3	0	0	0	12
Bacteria;Bacteria_none;Proteobacteria;Alphaproteobacteria;Sphingomonadales;Sphingomonadaceae;Sphingomonas;Sphingomonas canadensis	0	8	1	2	0	0	1	0	12
Bacteria;Bacteria_none;Proteobacteria;Gammaproteobacteria;Moraxellales;Moraxellaceae;Acinetobacter;Acinetobacter pullicarnis	9	0	0	2	0	0	1	0	12
Bacteria;Bacteria_none;Firmicutes;Clostridia;Eubacteriales;Desulfallaceae;Desulfoscipio;Desulfoscipio gibsoniae	0	1	3	0	4	4	0	0	12
Bacteria;Bacteria_none;Proteobacteria;Alphaproteobacteria;Hyphomicrobiales;Aurantimonadaceae;Jiella;Jiella sonneratiae	1	3	2	2	1	0	2	1	12
Bacteria;Bacteria_none;Proteobacteria;Betaproteobacteria;Burkholderiales;Burkholderiaceae;Paraburkholderia;Paraburkholderia xenovorans	8	0	1	0	3	0	0	0	12
Bacteria;Bacteria_none;Proteobacteria;Alphaproteobacteria;Hyphomicrobiales;Aurantimonadaceae;Aureimonas;Aureimonas phyllosphaerae	1	4	2	1	0	1	3	0	12
Bacteria;Bacteria_none;Proteobacteria;Alphaproteobacteria;Hyphomicrobiales;Aurantimonadaceae;Aurantimonas;Aurantimonas coralicida	0	12	0	0	0	0	0	0	12
Bacteria;Bacteria_none;Proteobacteria;Gammaproteobacteria;Moraxellales;Moraxellaceae;Acinetobacter;Acinetobacter dispersus	7	2	1	0	0	1	0	1	12
Bacteria;Bacteria_none;Proteobacteria;Betaproteobacteria;Burkholderiales;Burkholderiaceae;Paraburkholderia;Paraburkholderia ultramafica	5	3	0	0	2	2	0	0	12
Bacteria;Bacteria_none;Actinobacteria;Actinomycetia;Propionibacteriales;Propionibacteriaceae;Propionimicrobium;Propionimicrobium lymphophilum	2	3	4	2	0	1	0	0	12
Bacteria;Bacteria_none;Firmicutes;Bacilli;Bacillales;Paenibacillaceae;Paenibacillus;Paenibacillus yonginensis	2	3	5	0	0	0	1	1	12
Bacteria;Bacteria_none;Actinobacteria;Actinomycetia;Streptosporangiales;Thermomonosporaceae;Thermomonospora;Thermomonospora curvata	1	8	2	0	0	1	0	0	12
Bacteria;Bacteria_none;Firmicutes;Negativicutes;Selenomonadales;Sporomusaceae;Psychrosinus;Psychrosinus fermentans	1	0	2	6	1	0	0	2	12
Bacteria;Bacteria_none;Firmicutes;Bacilli;Bacillales;Bacillaceae;Bacillus;Bacillus marcorestinctum	0	0	4	3	0	2	0	3	12
Bacteria;Bacteria_none;Proteobacteria;Betaproteobacteria;Burkholderiales;Sutterellaceae;Sutterella;Sutterella parvirubra	4	1	0	7	0	0	0	0	12
Bacteria;Bacteria_none;Firmicutes;Negativicutes;Selenomonadales;Selenomonadaceae;Pectinatus;Pectinatus haikarae	7	0	0	0	0	3	2	0	12
Bacteria;Bacteria_none;Firmicutes;Bacilli;Bacillales;Bacillaceae;Bacillus;Bacillus pervagus	0	0	12	0	0	0	0	0	12
Bacteria;Bacteria_none;Proteobacteria;Betaproteobacteria;Neisseriales;Chromobacteriaceae;Gulbenkiania;Gulbenkiania indica	6	2	0	3	0	0	1	0	12
Bacteria;Bacteria_none;Firmicutes;Bacilli;Bacillales;Bacillaceae;Bacillus;Bacillus smithii	0	1	5	2	0	4	0	0	12
Bacteria;Bacteria_none;Proteobacteria;Deltaproteobacteria;Syntrophobacterales;Syntrophobacteraceae;Desulfacinum;Desulfacinum infernum	2	7	2	1	0	0	0	0	12
Bacteria;Bacteria_none;Proteobacteria;Betaproteobacteria;Neisseriales;Chromobacteriaceae;Vogesella;Vogesella oryzae	5	1	2	1	0	0	0	3	12
Bacteria;Bacteria_none;Firmicutes;Bacilli;Bacillales;Bacillaceae;Calculibacillus;Calculibacillus koreensis	0	0	9	0	3	0	0	0	12
Bacteria;Bacteria_none;Proteobacteria;Deltaproteobacteria;Myxococcales;Polyangiaceae;Polyangium;Polyangium sorediatum	9	0	2	1	0	0	0	0	12
Bacteria;Bacteria_none;Proteobacteria;Deltaproteobacteria;Myxococcales;Polyangiaceae;Aetherobacter;Aetherobacter fasciculatus	8	2	2	0	0	0	0	0	12
Bacteria;Bacteria_none;Actinobacteria;Actinomycetia;Streptomycetales;Streptomycetaceae;Streptomyces;Streptomyces plicatus	4	2	1	1	1	3	0	0	12
Bacteria;Bacteria_none;Firmicutes;Clostridia;Eubacteriales;Peptococcaceae;Desulfitispora;Desulfitispora elongata	0	0	5	0	2	5	0	0	12
Bacteria;Bacteria_none;Firmicutes;Clostridia;Eubacteriales;Eubacteriales_Incertae_sedis;Intestinimonas;Intestinimonas gabonensis	6	1	3	1	0	0	0	1	12
Bacteria;Bacteria_none;Firmicutes;Clostridia;Eubacteriales;Peptococcaceae;Desulforadius;Desulforadius tongensis	0	1	3	1	1	5	1	0	12
Bacteria;Bacteria_none;Proteobacteria;Betaproteobacteria;Rhodocyclales;Rhodocyclaceae;Rhodocyclus;Rhodocyclus gracilis	8	3	0	0	0	0	0	1	12
Bacteria;Bacteria_none;Actinobacteria;Actinomycetia;Corynebacteriales;Mycobacteriaceae;Mycolicibacterium;Mycolicibacterium psychrotolerans	1	4	1	3	0	2	1	0	12
Bacteria;Bacteria_none;Firmicutes;Clostridia;Thermoanaerobacterales;Thermoanaerobacteraceae;Moorella;Moorella perchloratireducens	0	1	8	1	1	1	0	0	12
Bacteria;Bacteria_none;Firmicutes;Bacilli;Bacillales;Bacillaceae;Gracilibacillus;Gracilibacillus timonensis	6	4	0	2	0	0	0	0	12
Bacteria;Bacteria_none;Actinobacteria;Actinomycetia;Streptomycetales;Streptomycetaceae;Streptomyces;Streptomyces violaceus	0	0	0	0	0	12	0	0	12
Bacteria;Bacteria_none;Firmicutes;Clostridia;Eubacteriales;Peptostreptococcaceae;Peptoclostridium;Peptoclostridium acidaminophilum	1	1	4	4	1	0	1	0	12
Bacteria;Bacteria_none;Firmicutes;Bacilli;Bacillales;Bacillaceae;Mesobacillus;Mesobacillus stamsii	2	0	3	4	0	2	1	0	12
Bacteria;Bacteria_none;Proteobacteria;Betaproteobacteria;Rhodocyclales;Zoogloeaceae;Uliginosibacterium;Uliginosibacterium sangjuense	10	1	0	1	0	0	0	0	12
Bacteria;Bacteria_none;Proteobacteria;Deltaproteobacteria;Desulfobacterales;Desulfobacteraceae;Desulfatibacillum;Desulfatibacillum aliphaticivorans	2	4	3	3	0	0	0	0	12
Bacteria;Bacteria_none;Actinobacteria;Actinomycetia;Streptosporangiales;Streptosporangiaceae;Microbispora;Microbispora fusca	0	2	4	6	0	0	0	0	12
Bacteria;Bacteria_none;Actinobacteria;Actinomycetia;Streptosporangiales;Streptosporangiaceae;Microbispora;Microbispora siamensis	0	3	2	5	0	0	0	2	12
Bacteria;Bacteria_none;Firmicutes;Bacilli;Bacillales;Bacillaceae;Lysinibacillus;Lysinibacillus antri	1	4	3	4	0	0	0	0	12
Bacteria;Bacteria_none;Actinobacteria;Actinomycetia;Geodermatophilales;Geodermatophilaceae;Modestobacter;Modestobacter marinus	0	0	12	0	0	0	0	0	12
Bacteria;Bacteria_none;Proteobacteria;Betaproteobacteria;Burkholderiales;Oxalobacteraceae;Pseudoduganella;Pseudoduganella danionis	12	0	0	0	0	0	0	0	12
Bacteria;Bacteria_none;Firmicutes;Bacilli;Bacillales;Bacillaceae;Weizmannia;Weizmannia ginsengihumi	0	0	9	2	0	1	0	0	12
Bacteria;Bacteria_none;Proteobacteria;Betaproteobacteria;Burkholderiales;Oxalobacteraceae;Noviherbaspirillum;Noviherbaspirillum pedocola	10	1	1	0	0	0	0	0	12
Bacteria;Bacteria_none;Proteobacteria;Betaproteobacteria;Burkholderiales;Burkholderiaceae;Ralstonia;Ralstonia syzygii	11	0	0	1	0	0	0	0	12
Bacteria;Bacteria_none;Proteobacteria;Gammaproteobacteria;Enterobacterales;Erwiniaceae;Tatumella;Tatumella morbirosei	8	0	1	0	0	0	3	0	12
Bacteria;Bacteria_none;Firmicutes;Clostridia;Eubacteriales;Lachnospiraceae;Anaerocolumna;Anaerocolumna jejuensis	4	1	3	1	0	1	1	1	12
Bacteria;Bacteria_none;Proteobacteria;Betaproteobacteria;Burkholderiales;Burkholderiales_Incertae_sedis;Thiomonas;Thiomonas thermosulfata	9	1	0	0	1	0	0	1	12
Bacteria;Bacteria_none;Firmicutes;Bacilli;Bacillales;Paenibacillaceae;Paenibacillus;Paenibacillus pueri	0	1	10	1	0	0	0	0	12
Bacteria;Bacteria_none;Proteobacteria;Gammaproteobacteria;Enterobacterales;Erwiniaceae;Pantoea;Pantoea stewartii	9	0	0	2	0	0	0	1	12
Bacteria;Bacteria_none;Proteobacteria;Alphaproteobacteria;Rhodobacterales;Rhodobacteraceae;Paracoccus;Paracoccus yeei	2	3	0	7	0	0	0	0	12
Bacteria;Bacteria_none;Proteobacteria;Gammaproteobacteria;Enterobacterales;Enterobacteriaceae;Siccibacter;Siccibacter turicensis	10	0	1	1	0	0	0	0	12
Bacteria;Bacteria_none;Firmicutes;Clostridia;Eubacteriales;Lachnospiraceae;Blautia;Blautia producta	2	3	4	1	1	1	0	0	12
Bacteria;Bacteria_none;Actinobacteria;Actinomycetia;Propionibacteriales;Propionibacteriaceae;Tessaracoccus;Tessaracoccus antarcticus	1	2	0	4	1	2	0	2	12
Bacteria;Bacteria_none;Firmicutes;Clostridia;Eubacteriales;Lachnospiraceae;Blautia;Blautia stercoris	11	0	0	1	0	0	0	0	12
Bacteria;Bacteria_none;Firmicutes;Clostridia;Eubacteriales;Lachnospiraceae;Catenibacillus;Catenibacillus scindens	2	8	1	1	0	0	0	0	12
Bacteria;Bacteria_none;Firmicutes;Clostridia;Eubacteriales;Lachnospiraceae;Coprococcus;Coprococcus catus	7	2	2	1	0	0	0	0	12
Bacteria;Bacteria_none;Actinobacteria;Actinomycetia;Pseudonocardiales;Pseudonocardiaceae;Amycolatopsis;Amycolatopsis pittospori	0	2	10	0	0	0	0	0	12
Bacteria;Bacteria_none;Bacteroidota;Bacteroidia;Bacteroidales;Muribaculaceae;Sodaliphilus;Sodaliphilus pleomorphus	1	7	3	0	0	0	0	1	12
Bacteria;Bacteria_none;Proteobacteria;Gammaproteobacteria;Chromatiales;Wenzhouxiangellaceae;Wenzhouxiangella;Wenzhouxiangella sediminis	4	0	0	5	0	0	1	2	12
Bacteria;Bacteria_none;Firmicutes;Clostridia;Eubacteriales;Lachnospiraceae;Lachnoanaerobaculum;Lachnoanaerobaculum umeaense	6	4	1	1	0	0	0	0	12
Bacteria;Bacteria_none;Proteobacteria;Gammaproteobacteria;Chromatiales;Halothiobacillaceae;Thiovirga;Thiovirga sulfuroxydans	1	3	2	5	0	0	0	1	12
Bacteria;Bacteria_none;Proteobacteria;Gammaproteobacteria;Chromatiales;Ectothiorhodospiraceae;Thioalkalivibrio;Thioalkalivibrio versutus	4	3	0	3	0	2	0	0	12
Bacteria;Bacteria_none;Proteobacteria;Gammaproteobacteria;Chromatiales;Ectothiorhodospiraceae;Halorhodospira;Halorhodospira abdelmalekii	4	8	0	0	0	0	0	0	12
Bacteria;Bacteria_none;Firmicutes;Clostridia;Eubacteriales;Lachnospiraceae;Lachnoclostridium;[Clostridium] populeti	4	0	2	1	1	4	0	0	12
Bacteria;Bacteria_none;Firmicutes;Clostridia;Eubacteriales;Lachnospiraceae;Lachnoclostridium;[Clostridium] symbiosum	4	5	3	0	0	0	0	0	12
Bacteria;Bacteria_none;Firmicutes;Clostridia;Eubacteriales;Lachnospiraceae;Lacrimispora;Lacrimispora celerecrescens	1	4	4	0	1	2	0	0	12
Bacteria;Bacteria_none;Proteobacteria;Gammaproteobacteria;Chromatiales;Chromatiaceae;Nitrosococcus;Nitrosococcus halophilus	5	1	3	1	1	1	0	0	12
Bacteria;Bacteria_none;Actinobacteria;Actinomycetia;Corynebacteriales;Mycobacteriaceae;Mycobacterium;Mycobacterium bouchedurhonense	4	0	0	3	0	3	2	0	12
Bacteria;Bacteria_none;Proteobacteria;Gammaproteobacteria;Cellvibrionales;Spongiibacteraceae;Spongiibacter;Spongiibacter tropicus	12	0	0	0	0	0	0	0	12
Bacteria;Bacteria_none;Proteobacteria;Gammaproteobacteria;Cardiobacteriales;Cardiobacteriaceae;Dichelobacter;Dichelobacter nodosus	4	8	0	0	0	0	0	0	12
Bacteria;Bacteria_none;Proteobacteria;Gammaproteobacteria;Xanthomonadales;Xanthomonadaceae;Pseudoxanthomonas;Pseudoxanthomonas helianthi	9	0	2	0	0	0	0	1	12
Bacteria;Bacteria_none;Proteobacteria;Deltaproteobacteria;Desulfobacterales;Desulfobulbaceae;Desulfobulbus;Desulfobulbus oligotrophicus	7	4	0	0	0	1	0	0	12
Bacteria;Bacteria_none;Firmicutes;Bacilli;Lactobacillales;Streptococcaceae;Streptococcus;Streptococcus zalophi	7	3	0	1	1	0	0	0	12
Bacteria;Bacteria_none;Proteobacteria;Alphaproteobacteria;Rhodobacterales;Rhodobacteraceae;Paenirhodobacter;Paenirhodobacter enshiensis	0	2	0	9	0	1	0	0	12
Bacteria;Bacteria_none;Thermotogae;Thermotogae;Thermotogales;Fervidobacteriaceae;Fervidobacterium;Fervidobacterium nodosum	0	0	2	0	0	8	1	1	12
Bacteria;Bacteria_none;Proteobacteria;Oligoflexia;Bacteriovoracales;Bacteriovoracaceae;Bacteriovorax;Bacteriovorax stolpii	3	0	3	4	2	0	0	0	12
Bacteria;Bacteria_none;Proteobacteria;Alphaproteobacteria;Hyphomicrobiales;Xanthobacteraceae;Ancylobacter;Ancylobacter abiegnus	7	5	0	0	0	0	0	0	12
Bacteria;Bacteria_none;Spirochaetes;Spirochaetia;Leptospirales;Leptospiraceae;Leptonema;Leptonema illini	1	3	4	0	2	2	0	0	12
Bacteria;Bacteria_none;Firmicutes;Bacilli;Lactobacillales;Streptococcaceae;Streptococcus;Streptococcus castoreus	8	1	1	1	0	0	0	1	12
Bacteria;Bacteria_none;Proteobacteria;Alphaproteobacteria;Hyphomicrobiales;Rhizobiaceae;Rhizobium;Rhizobium cellulosilyticum	3	5	0	4	0	0	0	0	12
Bacteria;Bacteria_none;Bacteroidota;Flavobacteriia;Flavobacteriales;Flavobacteriaceae;Flavivirga;Flavivirga algicola	0	7	4	1	0	0	0	0	12
Bacteria;Bacteria_none;Firmicutes;Bacilli;Lactobacillales;Streptococcaceae;Streptococcus;Streptococcus equinus	8	1	0	3	0	0	0	0	12
Bacteria;Bacteria_none;Firmicutes;Bacilli;Lactobacillales;Lactobacillaceae;Periweissella;Periweissella cryptocerci	5	0	2	2	1	2	0	0	12
Bacteria;Bacteria_none;Bacteroidota;Flavobacteriia;Flavobacteriales;Flavobacteriaceae;Bizionia;Bizionia saleffrena	0	0	9	3	0	0	0	0	12
Bacteria;Bacteria_none;Actinobacteria;Actinomycetia;Micrococcales;Microbacteriaceae;Pseudolysinimonas;Pseudolysinimonas kribbensis	1	7	1	3	0	0	0	0	12
Bacteria;Bacteria_none;Proteobacteria;Alphaproteobacteria;Hyphomicrobiales;Xanthobacteraceae;Azorhizobium;Azorhizobium oxalatiphilum	0	0	5	3	1	2	0	1	12
Bacteria;Bacteria_none;Actinobacteria;Actinomycetia;Micrococcales;Microbacteriaceae;Pseudoclavibacter;Pseudoclavibacter caeni	0	0	1	9	0	0	0	2	12
Bacteria;Bacteria_none;Actinobacteria;Actinomycetia;Micrococcales;Microbacteriaceae;Microbacterium;Microbacterium profundi	0	4	2	2	0	0	2	2	12
Bacteria;Bacteria_none;Actinobacteria;Actinomycetia;Micrococcales;Intrasporangiaceae;Knoellia;Knoellia flava	3	3	2	1	0	0	2	1	12
Bacteria;Bacteria_none;Proteobacteria;Alphaproteobacteria;Rhodobacterales;Rhodobacteraceae;Paracoccus;Paracoccus onubensis	4	2	2	3	0	1	0	0	12
Bacteria;Bacteria_none;Synergistetes;Synergistia;Synergistales;Synergistaceae;Fretibacterium;Fretibacterium fastidiosum	0	8	1	1	0	1	0	1	12
Bacteria;Bacteria_none;Synergistetes;Synergistia;Synergistales;Synergistaceae;Rarimicrobium;Rarimicrobium hominis	0	12	0	0	0	0	0	0	12
Bacteria;Bacteria_none;Proteobacteria;Alphaproteobacteria;Rhodobacterales;Rhodobacteraceae;Albidovulum;Albidovulum inexpectatum	1	5	3	3	0	0	0	0	12
Bacteria;Bacteria_none;Proteobacteria;Deltaproteobacteria;Desulfovibrionales;Desulfovibrionaceae;Pseudodesulfovibrio;Pseudodesulfovibrio tunisiensis	7	0	3	0	1	0	0	0	11
Bacteria;Bacteria_none;Firmicutes;Clostridia;Eubacteriales;Eubacteriales_Incertae_sedis;Natranaerovirga;Natranaerovirga hydrolytica	0	3	3	0	0	5	0	0	11
Bacteria;Bacteria_none;Actinobacteria;Actinomycetia;Streptomycetales;Streptomycetaceae;Streptomyces;Streptomyces lasii	3	1	2	5	0	0	0	0	11
Bacteria;Bacteria_none;Proteobacteria;Gammaproteobacteria;Pasteurellales;Pasteurellaceae;Pasteurellaceae_Incertae_sedis;[Actinobacillus] rossii	4	1	0	1	2	2	1	0	11
Bacteria;Bacteria_none;Firmicutes;Clostridia;Eubacteriales;Eubacteriales_Incertae_sedis;Intestinimonas;Intestinimonas timonensis	0	4	2	2	1	1	0	1	11
Bacteria;Bacteria_none;Proteobacteria;Alphaproteobacteria;Rickettsiales;Rickettsiaceae;Rickettsia;Rickettsia hulinii	1	3	0	5	0	2	0	0	11
Bacteria;Bacteria_none;Proteobacteria;Alphaproteobacteria;Rhodospirillales;Thalassobaculaceae;Nisaea;Nisaea sediminum	2	7	1	0	0	1	0	0	11
Bacteria;Bacteria_none;Deinococcus-Thermus;Deinococci;Deinococcales;Deinococcaceae;Deinococcus;Deinococcus yunweiensis	0	0	2	7	0	1	1	0	11
Bacteria;Bacteria_none;Firmicutes;Clostridia;Eubacteriales;Clostridiaceae;Clostridium;Clostridium thailandense	1	1	0	6	0	1	1	1	11
Bacteria;Bacteria_none;Bacteroidota;Bacteroidia;Bacteroidales;Salinivirgaceae;Salinivirga;Salinivirga cyanobacteriivorans	0	6	2	1	2	0	0	0	11
Bacteria;Bacteria_none;Firmicutes;Clostridia;Eubacteriales;Lachnospiraceae;Anaerocolumna;Anaerocolumna sedimenticola	0	0	4	3	2	2	0	0	11
Bacteria;Bacteria_none;Proteobacteria;Alphaproteobacteria;Rhodospirillales;Acetobacteraceae;Novacetimonas;Novacetimonas cocois	5	3	2	0	1	0	0	0	11
Bacteria;Bacteria_none;Proteobacteria;Gammaproteobacteria;Enterobacterales;Erwiniaceae;Erwinia;Erwinia gerundensis	9	0	0	2	0	0	0	0	11
Bacteria;Bacteria_none;Proteobacteria;Alphaproteobacteria;Rhodospirillales;Acetobacteraceae;Roseomonas;Roseomonas globiformis	10	0	0	1	0	0	0	0	11
Bacteria;Bacteria_none;Proteobacteria;Alphaproteobacteria;Rhodospirillales;Acetobacteraceae;Roseomonas;Roseomonas rubea	2	1	5	3	0	0	0	0	11
Bacteria;Bacteria_none;Firmicutes;Bacilli;Bacillales;Bacillaceae;Bacillus;Bacillus halotolerans	0	2	3	0	3	3	0	0	11
Bacteria;Bacteria_none;Proteobacteria;Alphaproteobacteria;Hyphomicrobiales;Hyphomicrobiaceae;Pedomicrobium;Pedomicrobium ferrugineum	0	3	3	4	0	1	0	0	11
Bacteria;Bacteria_none;Actinobacteria;Actinomycetia;Micrococcales;Microbacteriaceae;Microbacterium;Microbacterium terricola	1	0	6	2	2	0	0	0	11
Bacteria;Bacteria_none;Proteobacteria;Alphaproteobacteria;Rhodospirillales;Rhodospirillaceae;Pararhodospirillum;Pararhodospirillum oryzae	0	11	0	0	0	0	0	0	11
Bacteria;Bacteria_none;Actinobacteria;Coriobacteriia;Coriobacteriales;Atopobiaceae;Olsenella;Olsenella uli	4	1	0	4	0	2	0	0	11
Bacteria;Bacteria_none;Proteobacteria;Deltaproteobacteria;Desulfovibrionales;Desulfovibrionaceae;Oceanidesulfovibrio;Oceanidesulfovibrio marinus	0	11	0	0	0	0	0	0	11
Bacteria;Bacteria_none;Proteobacteria;Betaproteobacteria;Burkholderiales;Burkholderiales_Incertae_sedis;Saezia;Saezia sanguinis	10	0	1	0	0	0	0	0	11
Bacteria;Bacteria_none;Actinobacteria;Actinomycetia;Propionibacteriales;Propionibacteriaceae;Granulicoccus;Granulicoccus phenolivorans	0	3	3	5	0	0	0	0	11
Bacteria;Bacteria_none;Firmicutes;Clostridia;Thermoanaerobacterales;Thermoanaerobacteraceae;Moorella;Moorella glycerini	0	0	7	4	0	0	0	0	11
Bacteria;Bacteria_none;Proteobacteria;Alphaproteobacteria;Sphingomonadales;Erythrobacteraceae;Altererythrobacter;Altererythrobacter lauratis	4	0	4	3	0	0	0	0	11
Bacteria;Bacteria_none;Proteobacteria;Gammaproteobacteria;Oceanospirillales;Halomonadaceae;Kushneria;Kushneria phosphatilytica	3	4	0	4	0	0	0	0	11
Bacteria;Bacteria_none;Proteobacteria;Betaproteobacteria;Burkholderiales;Burkholderiaceae;Paraburkholderia;Paraburkholderia acidiphila	5	0	6	0	0	0	0	0	11
Bacteria;Bacteria_none;Proteobacteria;Alphaproteobacteria;Rhodobacterales;Rhodobacteraceae;Paracoccus;Paracoccus gahaiensis	2	3	1	3	0	1	1	0	11
Bacteria;Bacteria_none;Proteobacteria;Betaproteobacteria;Nitrosomonadales;Nitrosomonadaceae;Nitrosomonas;Nitrosomonas communis	8	3	0	0	0	0	0	0	11
Bacteria;Bacteria_none;Firmicutes;Clostridia;Eubacteriales;Defluviitaleaceae;Defluviitalea;Defluviitalea raffinosedens	3	1	0	0	1	6	0	0	11
Bacteria;Bacteria_none;Proteobacteria;Betaproteobacteria;Burkholderiales;Alcaligenaceae;Oligella;Oligella urethralis	3	3	5	0	0	0	0	0	11
Bacteria;Bacteria_none;Firmicutes;Bacilli;Lactobacillales;Lactobacillaceae;Weissella;Weissella halotolerans	1	0	6	1	3	0	0	0	11
Bacteria;Bacteria_none;Proteobacteria;Alphaproteobacteria;Caulobacterales;Caulobacteraceae;Brevundimonas;Brevundimonas vesicularis	2	7	1	0	1	0	0	0	11
Bacteria;Bacteria_none;Proteobacteria;Alphaproteobacteria;Rhodobacterales;Rhodobacteraceae;Paracoccus;Paracoccus alkenifer	1	1	1	3	0	3	2	0	11
Bacteria;Bacteria_none;Proteobacteria;Betaproteobacteria;Burkholderiales;Alcaligenaceae;Brackiella;Brackiella oedipodis	6	4	1	0	0	0	0	0	11
Bacteria;Bacteria_none;Proteobacteria;Betaproteobacteria;Nitrosomonadales;Sterolibacteriaceae;Denitratisoma;Denitratisoma oestradiolicum	9	1	0	0	0	0	1	0	11
Bacteria;Bacteria_none;Proteobacteria;Betaproteobacteria;Neisseriales;Chromobacteriaceae;Formivibrio;Formivibrio citricus	5	1	0	4	0	0	0	1	11
Bacteria;Bacteria_none;Proteobacteria;Deltaproteobacteria;Myxococcales;Myxococcaceae;Aggregicoccus;Aggregicoccus edonensis	11	0	0	0	0	0	0	0	11
Bacteria;Bacteria_none;Proteobacteria;Alphaproteobacteria;Caulobacterales;Caulobacteraceae;Phenylobacterium;Phenylobacterium lituiforme	6	0	3	0	0	0	2	0	11
Bacteria;Bacteria_none;Bacteroidota;Flavobacteriia;Flavobacteriales;Flavobacteriaceae;Flavobacterium;Flavobacterium gossypii	1	3	2	5	0	0	0	0	11
Bacteria;Bacteria_none;Bacteroidota;Sphingobacteriia;Sphingobacteriales;Sphingobacteriaceae;Arcticibacter;Arcticibacter eurypsychrophilus	2	2	1	2	1	1	1	1	11
Bacteria;Bacteria_none;Firmicutes;Bacilli;Bacillales;Staphylococcaceae;Salinicoccus;Salinicoccus luteus	0	3	2	2	0	1	1	2	11
Bacteria;Bacteria_none;Firmicutes;Clostridia;Eubacteriales;Bianqueaceae;Bianquea;Bianquea renquensis	1	4	1	3	0	2	0	0	11
Bacteria;Bacteria_none;Spirochaetes;Spirochaetia;Spirochaetales;Treponemataceae;Treponema;Treponema parvum	0	3	6	1	1	0	0	0	11
Bacteria;Bacteria_none;Proteobacteria;Betaproteobacteria;Rhodocyclales;Rhodocyclaceae;Aromatoleum;Aromatoleum anaerobium	6	3	0	0	0	2	0	0	11
Bacteria;Bacteria_none;Proteobacteria;Betaproteobacteria;Neisseriales;Neisseriaceae;Stenoxybacter;Stenoxybacter acetivorans	9	1	0	0	1	0	0	0	11
Bacteria;Bacteria_none;Bacteroidota;Chitinophagia;Chitinophagales;Chitinophagaceae;Chitinophaga;Chitinophaga cymbidii	6	3	1	1	0	0	0	0	11
Bacteria;Bacteria_none;Proteobacteria;Alphaproteobacteria;Sphingomonadales;Sphingomonadaceae;Sphingomonas;Sphingomonas aquatica	3	1	5	2	0	0	0	0	11
Bacteria;Bacteria_none;Actinobacteria;Actinomycetia;Micromonosporales;Micromonosporaceae;Virgisporangium;Virgisporangium aliadipatigenens	0	1	6	1	2	0	0	1	11
Bacteria;Bacteria_none;Proteobacteria;Betaproteobacteria;Burkholderiales;Burkholderiaceae;Chitinimonas;Chitinimonas koreensis	6	2	2	0	0	0	0	1	11
Bacteria;Bacteria_none;Firmicutes;Bacilli;Bacillales;Bacillaceae;Bacillus;Bacillus thermozeamaize	0	11	0	0	0	0	0	0	11
Bacteria;Bacteria_none;Firmicutes;Bacilli;Bacillales;Bacillaceae;Bacillus;Bacillus subtilis	0	0	3	0	3	3	2	0	11
Bacteria;Bacteria_none;Bacteroidota;Chitinophagia;Chitinophagales;Chitinophagaceae;Niastella;Niastella koreensis	9	2	0	0	0	0	0	0	11
Bacteria;Bacteria_none;Actinobacteria;Actinomycetia;Micrococcales;Microbacteriaceae;Canibacter;Canibacter oris	8	0	1	2	0	0	0	0	11
Bacteria;Bacteria_none;Firmicutes;Bacilli;Lactobacillales;Aerococcaceae;Aerococcus;Aerococcus urinae	9	1	0	1	0	0	0	0	11
Bacteria;Bacteria_none;Bacteroidota;Flavobacteriia;Flavobacteriales;Flavobacteriaceae;Flavobacterium;Flavobacterium panaciterrae	0	2	4	3	2	0	0	0	11
Bacteria;Bacteria_none;Bacteroidota;Bacteroidia;Bacteroidales;Prevotellaceae;Prevotella;Prevotella corporis	1	0	2	5	1	2	0	0	11
Bacteria;Bacteria_none;Cyanobacteria;Cyanobacteria_Incertae_sedis;Synechococcales;Synechococcales_Incertae_sedis;Aegeococcus;Aegeococcus anagnostidisi	11	0	0	0	0	0	0	0	11
Bacteria;Bacteria_none;Firmicutes;Bacilli;Lactobacillales;Streptococcaceae;Streptococcus;Streptococcus rifensis	8	1	1	1	0	0	0	0	11
Bacteria;Bacteria_none;Firmicutes;Bacilli;Lactobacillales;Aerococcaceae;Dolosicoccus;Dolosicoccus paucivorans	11	0	0	0	0	0	0	0	11
Bacteria;Bacteria_none;Proteobacteria;Alphaproteobacteria;Rhodospirillales;Acetobacteraceae;Gluconobacter;Gluconobacter frateurii	3	4	2	0	0	0	2	0	11
Bacteria;Bacteria_none;Firmicutes;Bacilli;Lactobacillales;Streptococcaceae;Streptococcus;Streptococcus tangierensis	7	0	0	3	0	1	0	0	11
Bacteria;Bacteria_none;Proteobacteria;Alphaproteobacteria;Rhodospirillales;Azospirillaceae;Azospirillum;Azospirillum canadense	2	4	1	2	0	2	0	0	11
Bacteria;Bacteria_none;Firmicutes;Bacilli;Bacillales;Bacillaceae;Anoxybacillus;Anoxybacillus contaminans	0	0	4	2	0	3	2	0	11
Bacteria;Bacteria_none;Bacteroidota;Cytophagia;Cytophagales;Spirosomaceae;Lacihabitans;Lacihabitans lacunae	9	0	1	0	0	0	1	0	11
Bacteria;Bacteria_none;Proteobacteria;Gammaproteobacteria;Aeromonadales;Aeromonadaceae;Dongshaea;Dongshaea marina	1	1	2	6	0	0	0	1	11
Bacteria;Bacteria_none;Proteobacteria;Gammaproteobacteria;Cellvibrionales;Cellvibrionaceae;Cellvibrio;Cellvibrio ostraviensis	3	2	3	0	2	1	0	0	11
Bacteria;Bacteria_none;Firmicutes;Clostridia;Halanaerobiales;Halobacteroidaceae;Orenia;Orenia marismortui	0	1	6	2	0	0	1	1	11
Bacteria;Bacteria_none;Actinobacteria;Actinomycetia;Micrococcales;Microbacteriaceae;Microbacterium;Microbacterium paraoxydans	2	0	2	5	0	0	2	0	11
Bacteria;Bacteria_none;Proteobacteria;Deltaproteobacteria;Desulfovibrionales;Desulfovibrionaceae;Desulfovibrio;Desulfovibrio inopinatus	0	8	2	1	0	0	0	0	11
Bacteria;Bacteria_none;Proteobacteria;Gammaproteobacteria;Chromatiales;Chromatiaceae;Thiohalocapsa;Thiohalocapsa halophila	11	0	0	0	0	0	0	0	11
Bacteria;Bacteria_none;Actinobacteria;Actinomycetia;Streptomycetales;Streptomycetaceae;Streptomyces;Streptomyces cheonanensis	1	6	1	3	0	0	0	0	11
Bacteria;Bacteria_none;Proteobacteria;Gammaproteobacteria;Xanthomonadales;Xanthomonadaceae;Lysobacter;Lysobacter prati	6	1	0	1	1	0	1	1	11
Bacteria;Bacteria_none;Firmicutes;Negativicutes;Veillonellales;Veillonellaceae;Dialister;Dialister micraerophilus	7	1	1	1	0	0	0	1	11
Bacteria;Bacteria_none;Proteobacteria;Gammaproteobacteria;Chromatiales;Ectothiorhodospiraceae;Acidihalobacter;Acidihalobacter ferrooxydans	2	2	2	2	1	0	1	1	11
Bacteria;Bacteria_none;Proteobacteria;Alphaproteobacteria;Rhodobacterales;Rhodobacteraceae;Tabrizicola;Tabrizicola aquatica	3	5	1	1	0	1	0	0	11
Bacteria;Bacteria_none;Actinobacteria;Actinomycetia;Pseudonocardiales;Pseudonocardiaceae;Saccharopolyspora;Saccharopolyspora kobensis	3	1	2	0	0	2	0	3	11
Bacteria;Bacteria_none;Firmicutes;Bacilli;Bacillales;Bacillales_Incertae_sedis;Exiguobacterium;Exiguobacterium soli	1	0	8	1	1	0	0	0	11
Bacteria;Bacteria_none;Tenericutes;Tenericutes_Incertae_sedis;Mycoplasmoidales;Metamycoplasmataceae;Mycoplasmoides;Mycoplasma cavipharyngis	5	0	3	0	1	0	1	1	11
Bacteria;Bacteria_none;Verrucomicrobia;Terrimicrobia;Terrimicrobiales;Terrimicrobiaceae;Terrimicrobium;Terrimicrobium sacchariphilum	1	4	4	2	0	0	0	0	11
Bacteria;Bacteria_none;Proteobacteria;Betaproteobacteria;Burkholderiales;Comamonadaceae;Polaromonas;Polaromonas eurypsychrophila	4	3	3	0	0	0	0	1	11
Bacteria;Bacteria_none;Proteobacteria;Gammaproteobacteria;Enterobacterales;Bruguierivoracaceae;Biostraticola;Biostraticola tofi	9	0	0	0	0	0	0	2	11
Bacteria;Bacteria_none;Proteobacteria;Betaproteobacteria;Burkholderiales;Oxalobacteraceae;Oxalobacter;Oxalobacter formigenes	3	2	2	1	2	0	1	0	11
Bacteria;Bacteria_none;Proteobacteria;Alphaproteobacteria;Hyphomicrobiales;Xanthobacteraceae;Labrys;Labrys monachus	0	2	9	0	0	0	0	0	11
Bacteria;Bacteria_none;Actinobacteria;Actinomycetia;Corynebacteriales;Corynebacteriaceae;Corynebacterium;Corynebacterium incognita	2	7	0	2	0	0	0	0	11
Bacteria;Bacteria_none;Verrucomicrobia;Verrucomicrobiae;Verrucomicrobiales;Akkermansiaceae;Akkermansia;Akkermansia glycaniphila	0	11	0	0	0	0	0	0	11
Bacteria;Bacteria_none;Proteobacteria;Alphaproteobacteria;Hyphomicrobiales;Xanthobacteraceae;Ancylobacter;Ancylobacter polymorphus	0	7	3	0	0	1	0	0	11
Bacteria;Bacteria_none;Actinobacteria;Actinomycetia;Micrococcales;Intrasporangiaceae;Pedococcus;Pedococcus dokdonensis	5	4	0	1	0	0	1	0	11
Bacteria;Bacteria_none;Proteobacteria;Gammaproteobacteria;Enterobacterales;Enterobacteriaceae;Enterobacter;Enterobacter oligotrophicus	8	0	3	0	0	0	0	0	11
Bacteria;Bacteria_none;Firmicutes;Clostridia;Eubacteriales;Lachnospiraceae;Coprococcus;Coprococcus phoceensis	11	0	0	0	0	0	0	0	11
Bacteria;Bacteria_none;Proteobacteria;Alphaproteobacteria;Rhodobacterales;Rhodobacteraceae;Parasedimentitalea;Parasedimentitalea marina	4	2	2	1	2	0	0	0	11
Bacteria;Bacteria_none;Proteobacteria;Alphaproteobacteria;Hyphomicrobiales;Nitrobacteraceae;Rhodopseudomonas;Rhodopseudomonas thermotolerans	3	3	3	0	2	0	0	0	11
Bacteria;Bacteria_none;Firmicutes;Clostridia;Eubacteriales;Clostridiaceae;Clostridium;Clostridium algidicarnis	2	1	1	5	0	0	1	1	11
Bacteria;Bacteria_none;Proteobacteria;Alphaproteobacteria;Rhodospirillales;Acetobacteraceae;Acetobacter;Acetobacter senegalensis	1	4	0	4	0	0	1	1	11
Bacteria;Bacteria_none;Firmicutes;Clostridia;Eubacteriales;Clostridiaceae;Clostridium;Clostridium akagii	1	1	2	2	0	1	3	1	11
Bacteria;Bacteria_none;Proteobacteria;Alphaproteobacteria;Rhodospirillales;Acetobacteraceae;Caldovatus;Caldovatus sediminis	2	3	1	2	1	2	0	0	11
Bacteria;Bacteria_none;Bacteroidota;Bacteroidia;Bacteroidales;Prevotellaceae;Metaprevotella;Metaprevotella massiliensis	0	1	1	6	0	2	0	1	11
Bacteria;Bacteria_none;Firmicutes;Clostridia;Eubacteriales;Lachnospiraceae;Oribacterium;Oribacterium sinus	2	0	0	4	0	5	0	0	11
Bacteria;Bacteria_none;Firmicutes;Tissierellia;Tissierellales;Tissierellaceae;Tissierella;Tissierella pigra	5	3	1	1	0	1	0	0	11
Bacteria;Bacteria_none;Actinobacteria;Actinomycetia;Streptomycetales;Streptomycetaceae;Streptomyces;Streptomyces decoyicus	0	3	0	6	2	0	0	0	11
Bacteria;Bacteria_none;Proteobacteria;Alphaproteobacteria;Hyphomonadales;Hyphomonadaceae;Asprobacter;Asprobacter aquaticus	7	4	0	0	0	0	0	0	11
Bacteria;Bacteria_none;Proteobacteria;Alphaproteobacteria;Hyphomicrobiales;Methylobacteriaceae;Microvirga;Microvirga arabica	4	6	1	0	0	0	0	0	11
Bacteria;Bacteria_none;Proteobacteria;Gammaproteobacteria;Chromatiales;Chromatiaceae;Allochromatium;Allochromatium tepidum	11	0	0	0	0	0	0	0	11
Bacteria;Bacteria_none;Firmicutes;Bacilli;Bacillales;Bacillaceae;Mesobacillus;Mesobacillus harenae	0	0	8	3	0	0	0	0	11
Bacteria;Bacteria_none;Proteobacteria;Gammaproteobacteria;Chromatiales;Chromatiaceae;Halochromatium;Halochromatium salexigens	1	1	6	3	0	0	0	0	11
Bacteria;Bacteria_none;Proteobacteria;Betaproteobacteria;Burkholderiales;Sphaerotilaceae;Azohydromonas;Azohydromonas australica	11	0	0	0	0	0	0	0	11
Bacteria;Bacteria_none;Proteobacteria;Gammaproteobacteria;Aeromonadales;Aeromonadaceae;Aeromonas;Aeromonas crassostreae	5	0	6	0	0	0	0	0	11
Bacteria;Bacteria_none;Bacteroidota;Chitinophagia;Chitinophagales;Chitinophagaceae;Arvibacter;Arvibacter flaviflagrans	7	1	0	1	0	0	1	0	10
Bacteria;Bacteria_none;Firmicutes;Bacilli;Lactobacillales;Streptococcaceae;Streptococcus;Streptococcus cristatus	9	0	1	0	0	0	0	0	10
Bacteria;Bacteria_none;Proteobacteria;Betaproteobacteria;Burkholderiales;Comamonadaceae;Ramlibacter;Ramlibacter monticola	8	0	0	0	1	1	0	0	10
Bacteria;Bacteria_none;Proteobacteria;Gammaproteobacteria;Chromatiales;Chromatiaceae;Nitrosococcus;Nitrosococcus watsonii	9	0	0	0	1	0	0	0	10
Bacteria;Bacteria_none;Proteobacteria;Gammaproteobacteria;Gammaproteobacteria_Incertae_sedis;Gammaproteobacteria_Incertae_sedis;Thiolapillus;Thiolapillus brandeum	5	2	0	3	0	0	0	0	10
Bacteria;Bacteria_none;Actinobacteria;Actinomycetia;Micrococcales;Microbacteriaceae;Microbacterium;Microbacterium xylanilyticum	0	3	1	5	0	1	0	0	10
Bacteria;Bacteria_none;Proteobacteria;Betaproteobacteria;Burkholderiales;Burkholderiaceae;Chitinasiproducens;Chitinasiproducens palmae	6	2	1	0	1	0	0	0	10
Bacteria;Bacteria_none;Proteobacteria;Deltaproteobacteria;Myxococcales;Polyangiaceae;Aetherobacter;Aetherobacter rufus	3	3	0	4	0	0	0	0	10
Bacteria;Bacteria_none;Planctomycetota;Planctomycetia;Planctomycetales;Planctomycetaceae;Rubinisphaera;Rubinisphaera italica	3	0	2	2	0	2	0	1	10
Bacteria;Bacteria_none;Actinobacteria;Actinomycetia;Corynebacteriales;Nocardiaceae;Nocardia;Nocardia jejuensis	0	0	0	5	2	0	0	3	10
Bacteria;Bacteria_none;Proteobacteria;Alphaproteobacteria;Hyphomicrobiales;Xanthobacteraceae;Ancylobacter;Ancylobacter aquaticus	4	3	0	3	0	0	0	0	10
Bacteria;Bacteria_none;Actinobacteria;Actinomycetia;Micrococcales;Microbacteriaceae;Leucobacter;Leucobacter muris	1	5	1	3	0	0	0	0	10
Bacteria;Bacteria_none;Spirochaetes;Spirochaetia;Spirochaetales;Treponemataceae;Treponema;Treponema pectinovorum	0	1	3	2	1	1	1	1	10
Bacteria;Bacteria_none;Proteobacteria;Betaproteobacteria;Burkholderiales;Oxalobacteraceae;Massilia;Massilia timonae	4	3	1	0	0	1	0	1	10
Bacteria;Bacteria_none;Firmicutes;Clostridia;Eubacteriales;Lachnospiraceae;Roseburia;Roseburia porci	2	2	1	4	0	1	0	0	10
Bacteria;Bacteria_none;Proteobacteria;Betaproteobacteria;Nitrosomonadales;Nitrosomonadaceae;Nitrosomonas;Nitrosomonas halophila	7	3	0	0	0	0	0	0	10
Bacteria;Bacteria_none;Firmicutes;Erysipelotrichia;Erysipelotrichales;Erysipelotrichaceae;Faecalitalea;Faecalitalea cylindroides	5	0	0	4	0	0	0	1	10
Bacteria;Bacteria_none;Proteobacteria;Betaproteobacteria;Burkholderiales;Oxalobacteraceae;Massilia;Massilia alkalitolerans	4	2	2	0	0	2	0	0	10
Bacteria;Bacteria_none;Proteobacteria;Alphaproteobacteria;Caulobacterales;Caulobacteraceae;Phenylobacterium;Phenylobacterium conjunctum	5	2	1	1	0	0	1	0	10
Bacteria;Bacteria_none;Planctomycetota;Planctomycetia;Planctomycetales;Planctomycetaceae;Maioricimonas;Maioricimonas rarisocia	3	4	0	2	1	0	0	0	10
Bacteria;Bacteria_none;Bacteroidota;Chitinophagia;Chitinophagales;Chitinophagaceae;Flavihumibacter;Flavihumibacter cheonanensis	3	7	0	0	0	0	0	0	10
Bacteria;Bacteria_none;Actinobacteria;Actinomycetia;Micrococcales;Microbacteriaceae;Leucobacter;Leucobacter holotrichiae	1	1	6	0	0	0	1	1	10
Bacteria;Bacteria_none;Firmicutes;Bacilli;Bacillales;Sporolactobacillaceae;Caenibacillus;Caenibacillus caldisaponilyticus	0	0	4	1	0	5	0	0	10
Bacteria;Bacteria_none;Actinobacteria;Actinomycetia;Corynebacteriales;Nocardiaceae;Nocardia;Nocardia polyresistens	1	1	5	1	0	2	0	0	10
Bacteria;Bacteria_none;Actinobacteria;Actinomycetia;Actinomycetales;Actinomycetaceae;Arcanobacterium;Arcanobacterium hippocoleae	0	0	1	6	0	2	1	0	10
Bacteria;Bacteria_none;Proteobacteria;Alphaproteobacteria;Hyphomicrobiales;Rhizobiaceae;Agrobacterium;Agrobacterium leguminum	1	3	3	3	0	0	0	0	10
Bacteria;Bacteria_none;Proteobacteria;Gammaproteobacteria;Legionellales;Legionellaceae;Legionella;Legionella londiniensis	3	1	3	2	1	0	0	0	10
Bacteria;Bacteria_none;Proteobacteria;Betaproteobacteria;Burkholderiales;Alcaligenaceae;Achromobacter;Achromobacter denitrificans	4	1	2	3	0	0	0	0	10
Bacteria;Bacteria_none;Spirochaetes;Spirochaetia;Spirochaetales;Spirochaetaceae;Spirochaeta;Spirochaeta lutea	0	5	4	0	0	1	0	0	10
Bacteria;Bacteria_none;Firmicutes;Bacilli;Lactobacillales;Lactobacillaceae;Secundilactobacillus;Secundilactobacillus similis	10	0	0	0	0	0	0	0	10
Bacteria;Bacteria_none;Proteobacteria;Epsilonproteobacteria;Campylobacterales;Sulfurovaceae;Nitratifractor;Nitratifractor salsuginis	1	1	3	1	4	0	0	0	10
Bacteria;Bacteria_none;Firmicutes;Bacilli;Bacillales;Planococcaceae;Rummeliibacillus;Rummeliibacillus stabekisii	1	0	0	4	0	0	0	5	10
Bacteria;Bacteria_none;Bacteroidota;Bacteroidia;Bacteroidales;Muribaculaceae;Sangeribacter;Sangeribacter muris	3	1	1	3	0	0	0	2	10
Bacteria;Bacteria_none;Proteobacteria;Alphaproteobacteria;Hyphomicrobiales;Phyllobacteriaceae;Salaquimonas;Salaquimonas pukyongi	5	2	1	0	0	0	2	0	10
Bacteria;Bacteria_none;Proteobacteria;Betaproteobacteria;Burkholderiales;Burkholderiales_Incertae_sedis;Leptothrix;Leptothrix discophora	7	1	1	1	0	0	0	0	10
Bacteria;Bacteria_none;Proteobacteria;Betaproteobacteria;Burkholderiales;Sutterellaceae;Sutterella;Sutterella timonensis	8	1	1	0	0	0	0	0	10
Bacteria;Bacteria_none;Bacteroidota;Bacteroidia;Bacteroidales;Porphyromonadaceae;Porphyromonas;Porphyromonas asaccharolytica	0	10	0	0	0	0	0	0	10
Bacteria;Bacteria_none;Proteobacteria;Gammaproteobacteria;Enterobacterales;Morganellaceae;Providencia;Providencia alcalifaciens	8	0	0	1	1	0	0	0	10
Bacteria;Bacteria_none;Proteobacteria;Betaproteobacteria;Burkholderiales;Burkholderiales_Incertae_sedis;Rhizobacter;Rhizobacter profundi	8	2	0	0	0	0	0	0	10
Bacteria;Bacteria_none;Firmicutes;Negativicutes;Selenomonadales;Sporomusaceae;Sporomusa;Sporomusa paucivorans	7	1	0	0	0	2	0	0	10
Bacteria;Bacteria_none;Verrucomicrobia;Verrucomicrobiae;Verrucomicrobiales;Rubritaleaceae;Rubritalea;Rubritalea marina	0	10	0	0	0	0	0	0	10
Bacteria;Bacteria_none;Firmicutes;Bacilli;Bacillales;Paenibacillaceae;Paenibacillus;Paenibacillus hispanicus	0	1	7	0	1	1	0	0	10
Bacteria;Bacteria_none;Actinobacteria;Actinomycetia;Propionibacteriales;Propionibacteriaceae;Luteococcus;Luteococcus sanguinis	5	3	2	0	0	0	0	0	10
Bacteria;Bacteria_none;Proteobacteria;Gammaproteobacteria;Enterobacterales;Enterobacteriaceae;Klebsiella;Klebsiella africana	8	1	0	0	0	0	0	1	10
Bacteria;Bacteria_none;Proteobacteria;Betaproteobacteria;Burkholderiales;Burkholderiales_Incertae_sedis;Tepidicella;Tepidicella xavieri	1	0	0	9	0	0	0	0	10
Bacteria;Bacteria_none;Proteobacteria;Epsilonproteobacteria;Campylobacterales;Campylobacteraceae;Campylobacter;Campylobacter rectus	0	0	0	9	0	0	1	0	10
Bacteria;Bacteria_none;Firmicutes;Clostridia;Eubacteriales;Lachnospiraceae;Anaerosporobacter;Anaerosporobacter mobilis	0	3	0	0	0	2	2	3	10
Bacteria;Bacteria_none;Actinobacteria;Actinomycetia;Actinomycetia_Incertae_sedis;Actinomycetia_Incertae_sedis;Halopolyspora;Halopolyspora alba	0	5	5	0	0	0	0	0	10
Bacteria;Bacteria_none;Actinobacteria;Actinomycetia;Micrococcales;Intrasporangiaceae;Tetrasphaera;Tetrasphaera japonica	0	1	3	6	0	0	0	0	10
Bacteria;Bacteria_none;Firmicutes;Clostridia;Eubacteriales;Clostridiaceae;Clostridium;Clostridium acidisoli	0	0	2	4	1	1	1	1	10
Bacteria;Bacteria_none;Proteobacteria;Gammaproteobacteria;Enterobacterales;Erwiniaceae;Izhakiella;Izhakiella capsodis	9	0	1	0	0	0	0	0	10
Bacteria;Bacteria_none;Proteobacteria;Gammaproteobacteria;Acidiferrobacterales;Acidiferrobacteraceae;Sulfuricaulis;Sulfuricaulis limicola	10	0	0	0	0	0	0	0	10
Bacteria;Bacteria_none;Firmicutes;Bacilli;Bacillales;Bacillaceae;Bacillus;Bacillus cytotoxicus	0	1	0	0	0	0	6	3	10
Bacteria;Bacteria_none;Firmicutes;Tissierellia;Tissierellales;Tissierellaceae;Tissierella;Tissierella simiarum	0	4	3	2	0	0	0	1	10
Bacteria;Bacteria_none;Proteobacteria;Epsilonproteobacteria;Epsilonproteobacteria_Incertae_sedis;Epsilonproteobacteria_Incertae_sedis;Thioreductor;Thioreductor micantisoli	1	6	1	2	0	0	0	0	10
Bacteria;Bacteria_none;Proteobacteria;Betaproteobacteria;Burkholderiales;Sphaerotilaceae;Inhella;Inhella fonticola	10	0	0	0	0	0	0	0	10
Bacteria;Bacteria_none;Proteobacteria;Gammaproteobacteria;Enterobacterales;Morganellaceae;Xenorhabdus;Xenorhabdus ishibashii	8	0	0	0	0	0	2	0	10
Bacteria;Bacteria_none;Bacteroidota;Bacteroidia;Bacteroidales;Porphyromonadaceae;Massilibacteroides;Massilibacteroides vaginae	0	5	0	4	1	0	0	0	10
Bacteria;Bacteria_none;Actinobacteria;Actinomycetia;Corynebacteriales;Corynebacteriaceae;Corynebacterium;Corynebacterium dentalis	9	0	0	0	0	0	1	0	10
Bacteria;Bacteria_none;Acidobacteria;Acidobacteriia;Bryobacterales;Bryobacteraceae;Bryobacter;Bryobacter aggregatus	5	0	4	0	1	0	0	0	10
Bacteria;Bacteria_none;Firmicutes;Clostridia;Eubacteriales;Lachnospiraceae;Konateibacter;Konateibacter massiliensis	2	2	1	3	0	0	1	1	10
Bacteria;Bacteria_none;Proteobacteria;Deltaproteobacteria;Desulfobacterales;Desulfofabaceae;Desulfofaba;Desulfofaba fastidiosa	2	3	1	1	2	1	0	0	10
Bacteria;Bacteria_none;Actinobacteria;Coriobacteriia;Eggerthellales;Eggerthellaceae;Gordonibacter;Gordonibacter massiliensis	1	2	2	1	0	4	0	0	10
Bacteria;Bacteria_none;Proteobacteria;Alphaproteobacteria;Rhodobacterales;Rhodobacteraceae;Gemmobacter;Gemmobacter caeni	3	0	0	7	0	0	0	0	10
Bacteria;Bacteria_none;Actinobacteria;Actinomycetia;Pseudonocardiales;Pseudonocardiaceae;Saccharothrix;Saccharothrix tharensis	0	1	1	6	0	1	0	1	10
Bacteria;Bacteria_none;Actinobacteria;Actinomycetia;Micrococcales;Microbacteriaceae;Microbacterium;Microbacterium telephonicum	3	1	3	2	0	0	0	1	10
Bacteria;Bacteria_none;Firmicutes;Bacilli;Bacillales;Planococcaceae;Jeotgalibacillus;Jeotgalibacillus aurantiacus	1	0	2	3	0	4	0	0	10
Bacteria;Bacteria_none;Proteobacteria;Gammaproteobacteria;Enterobacterales;Enterobacteriaceae;Cedecea;Cedecea davisae	7	0	1	1	0	0	1	0	10
Bacteria;Bacteria_none;Proteobacteria;Gammaproteobacteria;Alteromonadales;Idiomarinaceae;Aliidiomarina;Aliidiomarina indica	1	1	1	4	2	0	1	0	10
Bacteria;Bacteria_none;Actinobacteria;Actinomycetia;Corynebacteriales;Mycobacteriaceae;Mycobacterium;Mycobacterium koreense	0	4	4	2	0	0	0	0	10
Bacteria;Bacteria_none;Proteobacteria;Deltaproteobacteria;Syntrophobacterales;Syntrophobacteraceae;Thermodesulforhabdus;Thermodesulforhabdus norvegica	3	7	0	0	0	0	0	0	10
Bacteria;Bacteria_none;Firmicutes;Clostridia;Eubacteriales;Eubacteriales_Incertae_sedis;Natranaerovirga;Natranaerovirga pectinivora	1	4	0	1	2	0	1	1	10
Bacteria;Bacteria_none;Bacteroidota;Flavobacteriia;Flavobacteriales;Weeksellaceae;Chryseobacterium;Chryseobacterium gwangjuense	10	0	0	0	0	0	0	0	10
Bacteria;Bacteria_none;Planctomycetota;Planctomycetia;Pirellulales;Lacipirellulaceae;Botrimarina;Botrimarina hoheduenensis	5	0	0	4	1	0	0	0	10
Bacteria;Bacteria_none;Planctomycetota;Planctomycetia;Pirellulales;Lacipirellulaceae;Aeoliella;Aeoliella mucimassa	3	2	1	3	0	0	0	1	10
Bacteria;Bacteria_none;Proteobacteria;Alphaproteobacteria;Rhodobacterales;Rhodobacteraceae;Cypionkella;Cypionkella aquatica	5	2	1	2	0	0	0	0	10
Bacteria;Bacteria_none;Firmicutes;Tissierellia;Tissierellales;Peptoniphilaceae;Peptoniphilus;Peptoniphilus lacrimalis	4	1	0	1	0	1	3	0	10
Bacteria;Bacteria_none;Proteobacteria;Betaproteobacteria;Burkholderiales;Burkholderiaceae;Ralstonia;Ralstonia mannitolilytica	4	1	0	4	0	1	0	0	10
Bacteria;Bacteria_none;Bacteroidota;Bacteroidia;Bacteroidales;Odoribacteraceae;Odoribacter;Odoribacter splanchnicus	0	8	1	1	0	0	0	0	10
Bacteria;Bacteria_none;Firmicutes;Bacilli;Bacillales;Bacillaceae;Bacillus;Bacillus pakistanensis	2	1	4	1	0	0	1	1	10
Bacteria;Bacteria_none;Firmicutes;Bacilli;Bacillales;Paenibacillaceae;Paenibacillus;Paenibacillus glacialis	1	1	2	5	0	0	1	0	10
Bacteria;Bacteria_none;Firmicutes;Clostridia;Eubacteriales;Lachnospiraceae;Faecalimonas;Faecalimonas umbilicata	2	1	2	1	2	2	0	0	10
Bacteria;Bacteria_none;Bacteroidota;Flavobacteriia;Flavobacteriales;Flavobacteriaceae;Salegentibacter;Salegentibacter echinorum	2	2	0	6	0	0	0	0	10
Bacteria;Bacteria_none;Firmicutes;Bacilli;Lactobacillales;Lactobacillaceae;Lactobacillus;Lactobacillus johnsonii	8	2	0	0	0	0	0	0	10
Bacteria;Bacteria_none;Proteobacteria;Alphaproteobacteria;Sphingomonadales;Sphingosinicellaceae;Polymorphobacter;Polymorphobacter fuscus	2	1	2	2	1	1	1	0	10
Bacteria;Bacteria_none;Firmicutes;Clostridia;Eubacteriales;Proteinivoraceae;Proteinivorax;Proteinivorax hydrogeniformans	0	0	4	0	0	6	0	0	10
Bacteria;Bacteria_none;Proteobacteria;Deltaproteobacteria;Desulfovibrionales;Desulfovibrionaceae;Desulfovibrio;Desulfovibrio psychrotolerans	0	3	4	1	2	0	0	0	10
Bacteria;Bacteria_none;Firmicutes;Clostridia;Thermoanaerobacterales;Thermoanaerobacteraceae;Thermoanaerobacter;Thermoanaerobacter kivui	1	1	2	1	0	5	0	0	10
Bacteria;Bacteria_none;Firmicutes;Clostridia;Eubacteriales;Clostridiaceae;Hathewaya;Hathewaya limosa	2	1	0	6	0	1	0	0	10
Bacteria;Bacteria_none;Proteobacteria;Oligoflexia;Bdellovibrionales;Bdellovibrionaceae;Pseudobdellovibrio;Pseudobdellovibrio exovorus	3	1	2	4	0	0	0	0	10
Bacteria;Bacteria_none;Firmicutes;Clostridia;Eubacteriales;Clostridiaceae;Hungatella;Hungatella effluvii	0	5	1	2	0	1	0	1	10
Bacteria;Bacteria_none;Actinobacteria;Actinomycetia;Actinomycetales;Actinomycetaceae;Actinomyces;Actinomyces lilanjuaniae	4	6	0	0	0	0	0	0	10
Bacteria;Bacteria_none;Proteobacteria;Alphaproteobacteria;Hyphomicrobiales;Parvibaculaceae;Rhodoligotrophos;Rhodoligotrophos jinshengii	1	7	2	0	0	0	0	0	10
Bacteria;Bacteria_none;Firmicutes;Clostridia;Eubacteriales;Clostridiaceae;Maledivibacter;Maledivibacter halophilus	0	0	4	1	0	5	0	0	10
Bacteria;Bacteria_none;Actinobacteria;Actinomycetia;Streptosporangiales;Nocardiopsaceae;Spiractinospora;Spiractinospora alimapuensis	0	2	2	2	0	1	0	3	10
Bacteria;Bacteria_none;Proteobacteria;Deltaproteobacteria;Desulfuromonadales;Desulfuromonadaceae;Pelobacter;Pelobacter acidigallici	7	1	2	0	0	0	0	0	10
Bacteria;Bacteria_none;Actinobacteria;Actinomycetia;Streptosporangiales;Streptosporangiaceae;Sphaerimonospora;Sphaerimonospora triticiradicis	0	1	1	6	1	0	0	1	10
Bacteria;Bacteria_none;Proteobacteria;Gammaproteobacteria;Xanthomonadales;Xanthomonadaceae;Arenimonas;Arenimonas soli	3	3	0	2	1	0	0	1	10
Bacteria;Bacteria_none;Proteobacteria;Alphaproteobacteria;Rhodobacterales;Rhodobacteraceae;Paracoccus;Paracoccus stylophorae	2	4	2	1	1	0	0	0	10
Bacteria;Bacteria_none;Firmicutes;Clostridia;Eubacteriales;Clostridiaceae;Oceanirhabdus;Oceanirhabdus sediminicola	2	0	2	2	3	0	1	0	10
Bacteria;Bacteria_none;Proteobacteria;Alphaproteobacteria;Sphingomonadales;Sphingomonadaceae;Novosphingobium;Novosphingobium aquiterrae	8	0	2	0	0	0	0	0	10
Bacteria;Bacteria_none;Firmicutes;Clostridia;Eubacteriales;Yeguiaceae;Yeguia;Yeguia hominis	1	4	1	3	0	1	0	0	10
Bacteria;Bacteria_none;Proteobacteria;Alphaproteobacteria;Hyphomicrobiales;Parvibaculaceae;Anderseniella;Anderseniella baltica	2	1	2	3	1	1	0	0	10
Bacteria;Bacteria_none;Proteobacteria;Alphaproteobacteria;Rhodobacterales;Roseobacteraceae;Roseibacterium;Roseibacterium beibuensis	0	0	4	5	0	0	0	1	10
Bacteria;Bacteria_none;Proteobacteria;Alphaproteobacteria;Hyphomicrobiales;Methylobacteriaceae;Microvirga;Microvirga guangxiensis	5	0	0	0	0	5	0	0	10
Bacteria;Bacteria_none;Proteobacteria;Betaproteobacteria;Rhodocyclales;Zoogloeaceae;Zoogloea;Zoogloea caeni	10	0	0	0	0	0	0	0	10
Bacteria;Bacteria_none;Proteobacteria;Alphaproteobacteria;Hyphomicrobiales;Phyllobacteriaceae;Aquamicrobium;Aquamicrobium defluvii	0	0	5	5	0	0	0	0	10
Bacteria;Bacteria_none;Chloroflexi;Ktedonobacteria;Ktedonobacterales;Thermosporotrichaceae;Thermosporothrix;Thermosporothrix narukonensis	3	2	1	4	0	0	0	0	10
Bacteria;Bacteria_none;Actinobacteria;Actinomycetia;Micrococcales;Intrasporangiaceae;Ornithinicoccus;Ornithinicoccus soli	1	3	1	4	0	1	0	0	10
Bacteria;Bacteria_none;Proteobacteria;Deltaproteobacteria;Desulfovibrionales;Desulfovibrionaceae;Maridesulfovibrio;Maridesulfovibrio frigidus	0	0	5	0	5	0	0	0	10
Bacteria;Bacteria_none;Proteobacteria;Alphaproteobacteria;Rhodospirillales;Acetobacteraceae;Falsiroseomonas;Falsiroseomonas terricola	2	6	1	1	0	0	0	0	10
Bacteria;Bacteria_none;Firmicutes;Clostridia;Thermoanaerobacterales;Thermoanaerobacteraceae;Desulfothermobacter;Desulfothermobacter acidiphilus	0	2	6	2	0	0	0	0	10
Bacteria;Bacteria_none;Actinobacteria;Actinomycetia;Micrococcales;Dermabacteraceae;Brachybacterium;Brachybacterium saurashtrense	0	6	3	1	0	0	0	0	10
Bacteria;Bacteria_none;Actinobacteria;Actinomycetia;Micrococcales;Dermabacteraceae;Brachybacterium;Brachybacterium muris	0	2	0	7	0	0	1	0	10
Bacteria;Bacteria_none;Actinobacteria;Actinomycetia;Micromonosporales;Micromonosporaceae;Actinoplanes;Actinoplanes ianthinogenes	0	6	0	0	4	0	0	0	10
Bacteria;Bacteria_none;Bacteroidota;Flavobacteriia;Flavobacteriales;Weeksellaceae;Chryseobacterium;Chryseobacterium cucumeris	1	2	7	0	0	0	0	0	10
Bacteria;Bacteria_none;Actinobacteria;Actinomycetia;Micrococcales;Dermacoccaceae;Branchiibius;Branchiibius hedensis	10	0	0	0	0	0	0	0	10
Bacteria;Bacteria_none;Bacteroidota;Cytophagia;Cytophagales;Cyclobacteriaceae;Algoriphagus;Algoriphagus trabzonensis	0	0	0	10	0	0	0	0	10
Bacteria;Bacteria_none;Actinobacteria;Actinomycetia;Micrococcales;Microbacteriaceae;Rhodoglobus;Rhodoglobus aureus	2	1	3	4	0	0	0	0	10
Bacteria;Bacteria_none;Proteobacteria;Alphaproteobacteria;Rhodobacterales;Rhodobacteraceae;Paracoccus;Paracoccus jeotgali	5	0	1	2	0	1	1	0	10
Bacteria;Bacteria_none;Proteobacteria;Betaproteobacteria;Rhodocyclales;Zoogloeaceae;Thauera;Thauera linaloolentis	3	4	1	0	1	1	0	0	10
Bacteria;Bacteria_none;Proteobacteria;Gammaproteobacteria;Pseudomonadales;Pseudomonadaceae;Pseudomonas;Pseudomonas viridiflava	1	0	3	6	0	0	0	0	10
Bacteria;Bacteria_none;Proteobacteria;Alphaproteobacteria;Hyphomicrobiales;Devosiaceae;Devosia;Devosia indica	6	3	1	0	0	0	0	0	10
Bacteria;Bacteria_none;Proteobacteria;Gammaproteobacteria;Moraxellales;Moraxellaceae;Moraxella;Moraxella lacunata	2	3	0	5	0	0	0	0	10
Bacteria;Bacteria_none;Proteobacteria;Gammaproteobacteria;Xanthomonadales;Xanthomonadaceae;Thermomonas;Thermomonas brevis	3	3	3	0	0	0	1	0	10
Bacteria;Bacteria_none;Proteobacteria;Gammaproteobacteria;Xanthomonadales;Xanthomonadaceae;Lysobacter;Lysobacter solisilvae	6	1	1	2	0	0	0	0	10
Bacteria;Bacteria_none;Proteobacteria;Gammaproteobacteria;Moraxellales;Moraxellaceae;Acinetobacter;Acinetobacter rongchengensis	5	0	0	5	0	0	0	0	10
Bacteria;Bacteria_none;Firmicutes;Bacilli;Lactobacillales;Lactobacillaceae;Lactobacillus;Lactobacillus paragasseri	8	0	0	0	0	2	0	0	10
Bacteria;Bacteria_none;Actinobacteria;Actinomycetia;Streptosporangiales;Thermomonosporaceae;Actinomadura;Actinomadura rayongensis	1	2	4	2	0	0	0	1	10
Bacteria;Bacteria_none;Firmicutes;Bacilli;Lactobacillales;Streptococcaceae;Streptococcus;Streptococcus caviae	8	1	0	0	0	0	0	1	10
Bacteria;Bacteria_none;Proteobacteria;Alphaproteobacteria;Hyphomicrobiales;Amorphaceae;Amorphus;Amorphus suaedae	1	3	1	5	0	0	0	0	10
Bacteria;Bacteria_none;Firmicutes;Bacilli;Lactobacillales;Lactobacillaceae;Weissella;Weissella confusa	4	5	0	1	0	0	0	0	10
Bacteria;Bacteria_none;Proteobacteria;Alphaproteobacteria;Sphingomonadales;Sphingomonadaceae;Sphingomonas;Sphingomonas lacunae	4	3	0	2	0	1	0	0	10
Bacteria;Bacteria_none;Proteobacteria;Gammaproteobacteria;Moraxellales;Moraxellaceae;Acinetobacter;Acinetobacter soli	3	0	0	7	0	0	0	0	10
Bacteria;Bacteria_none;Actinobacteria;Coriobacteriia;Coriobacteriales;Atopobiaceae;Olsenella;Olsenella timonensis	1	3	6	0	0	0	0	0	10
Bacteria;Bacteria_none;Firmicutes;Clostridia;Eubacteriales;Clostridiales Family XVI. Incertae Sedis;Carboxydocella;Carboxydocella thermautotrophica	1	4	5	0	0	0	0	0	10
Bacteria;Bacteria_none;Actinobacteria;Actinomycetia;Propionibacteriales;Actinopolymorphaceae;Actinopolymorpha;Actinopolymorpha alba	3	2	2	1	0	0	2	0	10
Bacteria;Bacteria_none;Proteobacteria;Gammaproteobacteria;Xanthomonadales;Xanthomonadaceae;Lysobacter;Lysobacter korlensis	4	2	1	1	0	0	1	1	10
Bacteria;Bacteria_none;Spirochaetes;Spirochaetia;Spirochaetales;Sphaerochaetaceae;Sphaerochaeta;Sphaerochaeta associata	0	9	1	0	0	0	0	0	10
Bacteria;Bacteria_none;Proteobacteria;Deltaproteobacteria;Desulfovibrionales;Desulfohalobiaceae;Desulfonatronospira;Desulfonatronospira thiodismutans	0	3	4	0	3	0	0	0	10
Bacteria;Bacteria_none;Firmicutes;Clostridia;Eubacteriales;Clostridiaceae;Clostridium;Clostridium arbusti	0	1	4	3	0	1	1	0	10
Bacteria;Bacteria_none;Actinobacteria;Actinomycetia;Streptosporangiales;Streptosporangiaceae;Nonomuraea;Nonomuraea ceibae	0	1	5	4	0	0	0	0	10
Bacteria;Bacteria_none;Proteobacteria;Gammaproteobacteria;Pseudomonadales;Pseudomonadaceae;Pseudomonas;Pseudomonas yangmingensis	0	0	7	1	1	0	0	0	9
Bacteria;Bacteria_none;Firmicutes;Clostridia;Eubacteriales;Lachnospiraceae;Niameybacter;Niameybacter massiliensis	0	1	1	3	0	3	1	0	9
Bacteria;Bacteria_none;Tenericutes;Mollicutes;Entomoplasmatales;Entomoplasmataceae;Entomoplasma;Entomoplasma ellychniae	0	1	8	0	0	0	0	0	9
Bacteria;Bacteria_none;Proteobacteria;Betaproteobacteria;Burkholderiales;Oxalobacteraceae;Massilia;Massilia chloroacetimidivorans	5	2	0	2	0	0	0	0	9
Bacteria;Bacteria_none;Proteobacteria;Alphaproteobacteria;Parvularculales;Parvularculaceae;Parvularcula;Parvularcula marina	2	7	0	0	0	0	0	0	9
Bacteria;Bacteria_none;Actinobacteria;Actinomycetia;Streptomycetales;Streptomycetaceae;Streptomyces;Streptomyces yerevanensis	1	1	1	5	0	0	0	1	9
Bacteria;Bacteria_none;Proteobacteria;Alphaproteobacteria;Rhodobacterales;Roseobacteraceae;Rubellimicrobium;Rubellimicrobium rubrum	3	4	1	0	0	0	1	0	9
Bacteria;Bacteria_none;Proteobacteria;Betaproteobacteria;Burkholderiales;Comamonadaceae;Lampropedia;Lampropedia aestuarii	6	3	0	0	0	0	0	0	9
Bacteria;Bacteria_none;Proteobacteria;Alphaproteobacteria;Hyphomicrobiales;Rhizobiaceae;Ensifer;Ensifer collicola	4	0	0	3	0	2	0	0	9
Bacteria;Bacteria_none;Proteobacteria;Gammaproteobacteria;Chromatiales;Chromatiaceae;Nitrosococcus;Nitrosococcus oceani	5	1	0	2	1	0	0	0	9
Bacteria;Bacteria_none;Firmicutes;Bacilli;Lactobacillales;Streptococcaceae;Lactococcus;Lactococcus paracarnosus	9	0	0	0	0	0	0	0	9
Bacteria;Bacteria_none;Proteobacteria;Epsilonproteobacteria;Nautiliales;Nautiliaceae;Nautilia;Nautilia abyssi	0	0	4	4	0	0	1	0	9
Bacteria;Bacteria_none;Proteobacteria;Alphaproteobacteria;Hyphomicrobiales;Pseudoxanthobacteraceae;Pseudoxanthobacter;Pseudoxanthobacter liyangensis	2	2	0	3	0	1	0	1	9
Bacteria;Bacteria_none;Actinobacteria;Actinomycetia;Micrococcales;Micrococcaceae;Garicola;Garicola koreensis	0	4	2	3	0	0	0	0	9
Bacteria;Bacteria_none;Bacteroidota;Flavobacteriia;Flavobacteriales;Flavobacteriaceae;Nonlabens;Nonlabens arenilitoris	0	0	0	9	0	0	0	0	9
Bacteria;Bacteria_none;Actinobacteria;Actinomycetia;Actinomycetales;Actinomycetaceae;Schaalia;Schaalia canis	2	3	2	2	0	0	0	0	9
Bacteria;Bacteria_none;Firmicutes;Bacilli;Bacillales;Bacillaceae;Halalkalibacterium (ex Joshi et al. 2022);Halalkalibacterium halodurans	1	0	8	0	0	0	0	0	9
Bacteria;Bacteria_none;Proteobacteria;Betaproteobacteria;Burkholderiales;Oxalobacteraceae;Massilia;Massilia glaciei	6	1	1	0	1	0	0	0	9
Bacteria;Bacteria_none;Firmicutes;Clostridia;Eubacteriales;Lachnospiraceae;Blautia;Blautia hansenii	7	0	0	0	0	2	0	0	9
Bacteria;Bacteria_none;Bacteroidota;Bacteroidia;Bacteroidales;Prevotellaceae;Prevotella;Prevotella enoeca	4	4	0	0	0	0	0	1	9
Bacteria;Bacteria_none;Firmicutes;Bacilli;Bacillales;Bacillaceae;Salimicrobium;Salimicrobium halophilum	0	0	5	0	0	4	0	0	9
Bacteria;Bacteria_none;Proteobacteria;Alphaproteobacteria;Rhodospirillales;Acetobacteraceae;Granulibacter;Granulibacter bethesdensis	2	5	1	0	0	1	0	0	9
Bacteria;Bacteria_none;Firmicutes;Clostridia;Eubacteriales;Lachnospiraceae;Blautia;Blautia phocaeensis	4	4	0	1	0	0	0	0	9
Bacteria;Bacteria_none;Proteobacteria;Gammaproteobacteria;Pseudomonadales;Pseudomonadaceae;Pseudomonas;Pseudomonas oleovorans	1	0	0	7	0	0	0	1	9
Bacteria;Bacteria_none;Synergistetes;Synergistia;Synergistales;Synergistaceae;Thermanaerovibrio;Thermanaerovibrio velox	3	3	0	3	0	0	0	0	9
Bacteria;Bacteria_none;Proteobacteria;Alphaproteobacteria;Rhodobacterales;Rhodobacteraceae;Paracoccus;Paracoccus xiamenensis	4	1	2	2	0	0	0	0	9
Bacteria;Bacteria_none;Actinobacteria;Actinomycetia;Streptomycetales;Streptomycetaceae;Streptomyces;Streptomyces antimycoticus	0	0	0	9	0	0	0	0	9
Bacteria;Bacteria_none;Actinobacteria;Actinomycetia;Propionibacteriales;Propionibacteriaceae;Tessaracoccus;Tessaracoccus aquimaris	2	5	0	1	0	1	0	0	9
Bacteria;Bacteria_none;Proteobacteria;Alphaproteobacteria;Rhodobacterales;Rhodobacteraceae;Acidimangrovimonas;Acidimangrovimonas pyrenivorans	2	2	2	1	1	0	1	0	9
Bacteria;Bacteria_none;Bacteroidota;Bacteroidia;Bacteroidales;Prevotellaceae;Prevotella;Prevotella copri	3	2	1	2	0	1	0	0	9
Bacteria;Bacteria_none;Proteobacteria;Alphaproteobacteria;Rhodospirillales;Acetobacteraceae;Falsiroseomonas;Falsiroseomonas riguiloci	4	3	1	1	0	0	0	0	9
Bacteria;Bacteria_none;Proteobacteria;Epsilonproteobacteria;Campylobacterales;Sulfurovaceae;Sulfurovum;Sulfurovum indicum	4	0	0	1	0	0	4	0	9
Bacteria;Bacteria_none;Actinobacteria;Actinomycetia;Pseudonocardiales;Pseudonocardiaceae;Pseudonocardia;Pseudonocardia alaniniphila	0	2	0	7	0	0	0	0	9
Bacteria;Bacteria_none;Actinobacteria;Actinomycetia;Actinomycetales;Actinomycetaceae;Actinotignum;Actinotignum schaalii	1	0	3	2	1	2	0	0	9
Bacteria;Bacteria_none;Bacteroidota;Sphingobacteriia;Sphingobacteriales;Sphingobacteriaceae;Sphingobacterium;Sphingobacterium caeni	0	1	0	2	1	0	0	5	9
Bacteria;Bacteria_none;Proteobacteria;Alphaproteobacteria;Rhodobacterales;Rhodobacteraceae;Rhodovulum;Rhodovulum bhavnagarense	3	2	0	3	0	0	0	1	9
Bacteria;Bacteria_none;Proteobacteria;Betaproteobacteria;Burkholderiales;Oxalobacteraceae;Massilia;Massilia phosphatilytica	7	0	1	0	0	1	0	0	9
Bacteria;Bacteria_none;Actinobacteria;Actinomycetia;Corynebacteriales;Mycobacteriaceae;Mycobacterium;Mycobacterium celatum	0	3	4	0	1	1	0	0	9
Bacteria;Bacteria_none;Proteobacteria;Gammaproteobacteria;Xanthomonadales;Xanthomonadaceae;Lysobacter;Lysobacter novalis	7	1	0	1	0	0	0	0	9
Bacteria;Bacteria_none;Proteobacteria;Betaproteobacteria;Burkholderiales;Comamonadaceae;Ramlibacter;Ramlibacter humi	9	0	0	0	0	0	0	0	9
Bacteria;Bacteria_none;Proteobacteria;Betaproteobacteria;Burkholderiales;Oxalobacteraceae;Massilia;Massilia pinisoli	7	0	1	0	0	0	0	1	9
Bacteria;Bacteria_none;Firmicutes;Clostridia;Eubacteriales;Clostridiaceae;Caloramator;Caloramator indicus	0	0	7	0	0	2	0	0	9
Bacteria;Bacteria_none;Proteobacteria;Gammaproteobacteria;Xanthomonadales;Xanthomonadaceae;Luteimonas;Luteimonas salinisoli	3	3	1	2	0	0	0	0	9
Bacteria;Bacteria_none;Proteobacteria;Gammaproteobacteria;Chromatiales;Ectothiorhodospiraceae;Thiohalospira;Thiohalospira halophila	4	1	0	4	0	0	0	0	9
Bacteria;Bacteria_none;Proteobacteria;Betaproteobacteria;Burkholderiales;Oxalobacteraceae;Noviherbaspirillum;Noviherbaspirillum humi	4	3	1	0	0	1	0	0	9
Bacteria;Bacteria_none;Proteobacteria;Betaproteobacteria;Burkholderiales;Oxalobacteraceae;Massilia;Massilia haematophila	7	1	0	0	0	1	0	0	9
Bacteria;Bacteria_none;Proteobacteria;Gammaproteobacteria;Chromatiales;Ectothiorhodospiraceae;Spiribacter;Spiribacter salinus	1	1	1	5	0	0	0	1	9
Bacteria;Bacteria_none;Verrucomicrobia;Opitutae;Puniceicoccales;Puniceicoccaceae;Puniceicoccus;Puniceicoccus vermicola	1	5	2	1	0	0	0	0	9
Bacteria;Bacteria_none;Bacteroidota;Bacteroidia;Bacteroidales;Dysgonomonadaceae;Dysgonomonas;Dysgonomonas macrotermitis	0	0	0	0	9	0	0	0	9
Bacteria;Bacteria_none;Firmicutes;Clostridia;Eubacteriales;Clostridiaceae;Caloramator;Caloramator proteoclasticus	0	2	4	0	0	3	0	0	9
Bacteria;Bacteria_none;Proteobacteria;Alphaproteobacteria;Hyphomicrobiales;Nitrobacteraceae;Bradyrhizobium;Bradyrhizobium diazoefficiens	3	1	1	3	1	0	0	0	9
Bacteria;Bacteria_none;Firmicutes;Clostridia;Eubacteriales;Lachnospiraceae;Lacrimispora;Lacrimispora aerotolerans	8	0	0	0	0	1	0	0	9
Bacteria;Bacteria_none;Firmicutes;Bacilli;Bacillales;Paenibacillaceae;Paenibacillus;Paenibacillus bouchesdurhonensis	0	2	5	0	0	0	2	0	9
Bacteria;Bacteria_none;Actinobacteria;Actinomycetia;Streptomycetales;Streptomycetaceae;Kitasatospora;Kitasatospora kifunensis	0	0	4	5	0	0	0	0	9
Bacteria;Bacteria_none;Proteobacteria;Betaproteobacteria;Burkholderiales;Comamonadaceae;Variovorax;Variovorax defluvii	7	1	1	0	0	0	0	0	9
Bacteria;Bacteria_none;Proteobacteria;Alphaproteobacteria;Rhodobacterales;Rhodobacteraceae;Paracoccus;Paracoccus seriniphilus	2	3	0	3	1	0	0	0	9
Bacteria;Bacteria_none;Proteobacteria;Alphaproteobacteria;Rhodospirillales;Acetobacteraceae;Roseomonas;Roseomonas elaeocarpi	4	0	1	3	0	1	0	0	9
Bacteria;Bacteria_none;Proteobacteria;Gammaproteobacteria;Enterobacterales;Bruguierivoracaceae;Bruguierivorax;Bruguierivorax albus	7	1	0	1	0	0	0	0	9
Bacteria;Bacteria_none;Firmicutes;Clostridia;Eubacteriales;Clostridiaceae;Clostridium;Clostridium kluyveri	2	0	0	6	0	1	0	0	9
Bacteria;Bacteria_none;Proteobacteria;Gammaproteobacteria;Chromatiales;Ectothiorhodospiraceae;Ectothiorhodospira;Ectothiorhodospira magna	5	2	2	0	0	0	0	0	9
Bacteria;Bacteria_none;Proteobacteria;Gammaproteobacteria;Aeromonadales;Aeromonadaceae;Tolumonas;Tolumonas osonensis	2	3	0	2	1	1	0	0	9
Bacteria;Bacteria_none;Proteobacteria;Alphaproteobacteria;Hyphomicrobiales;Nitrobacteraceae;Bradyrhizobium;Bradyrhizobium tropiciagri	5	2	2	0	0	0	0	0	9
Bacteria;Bacteria_none;Chloroflexi;Chloroflexia;Chloroflexales;Chloroflexaceae;Chloroflexus;Chloroflexus aggregans	0	0	0	0	0	0	0	9	9
Bacteria;Bacteria_none;Proteobacteria;Alphaproteobacteria;Hyphomicrobiales;Rhizobiaceae;Sinorhizobium;Sinorhizobium kummerowiae	4	1	0	2	2	0	0	0	9
Bacteria;Bacteria_none;Firmicutes;Bacilli;Lactobacillales;Streptococcaceae;Streptococcus;Streptococcus dysgalactiae	8	1	0	0	0	0	0	0	9
Bacteria;Bacteria_none;Firmicutes;Bacilli;Bacillales;Paenibacillaceae;Paenibacillus;Paenibacillus glucanolyticus	0	1	8	0	0	0	0	0	9
Bacteria;Bacteria_none;Firmicutes;Clostridia;Halanaerobiales;Halobacteroidaceae;Halanaerobacter;Halanaerobacter lacunarum	7	2	0	0	0	0	0	0	9
Bacteria;Bacteria_none;Proteobacteria;Gammaproteobacteria;Vibrionales;Vibrionaceae;Photobacterium;Photobacterium profundum	2	2	1	3	1	0	0	0	9
Bacteria;Bacteria_none;Actinobacteria;Actinomycetia;Corynebacteriales;Corynebacteriaceae;Corynebacterium;Corynebacterium kroppenstedtii	0	1	1	6	1	0	0	0	9
Bacteria;Bacteria_none;Bacteroidota;Cytophagia;Cytophagales;Hymenobacteraceae;Pontibacter;Pontibacter rhizosphera	0	0	3	6	0	0	0	0	9
Bacteria;Bacteria_none;Proteobacteria;Gammaproteobacteria;Vibrionales;Vibrionaceae;Vibrio;Vibrio neocaledonicus	3	2	0	1	0	0	3	0	9
Bacteria;Bacteria_none;Firmicutes;Clostridia;Eubacteriales;Clostridiaceae;Clostridium;Clostridium grantii	2	0	1	3	0	1	1	1	9
Bacteria;Bacteria_none;Proteobacteria;Gammaproteobacteria;Vibrionales;Vibrionaceae;Vibrio;Vibrio sinensis	5	0	2	2	0	0	0	0	9
Bacteria;Bacteria_none;Firmicutes;Bacilli;Bacillales;Bacillaceae;Lentibacillus;Lentibacillus sediminis	2	2	4	1	0	0	0	0	9
Bacteria;Bacteria_none;Proteobacteria;Gammaproteobacteria;Enterobacterales;Budviciaceae;Leminorella;Leminorella richardii	5	0	0	2	0	1	1	0	9
Bacteria;Bacteria_none;Firmicutes;Bacilli;Bacillales;Paenibacillaceae;Paenibacillus;Paenibacillus phyllosphaerae	0	0	7	1	0	0	0	1	9
Bacteria;Bacteria_none;Proteobacteria;Alphaproteobacteria;Hyphomicrobiales;Phyllobacteriaceae;Nitratireductor;Nitratireductor lacus	5	2	0	1	0	1	0	0	9
Bacteria;Bacteria_none;Actinobacteria;Actinomycetia;Micrococcales;Microbacteriaceae;Agrococcus;Agrococcus terreus	0	1	2	4	2	0	0	0	9
Bacteria;Bacteria_none;Actinobacteria;Actinomycetia;Micromonosporales;Micromonosporaceae;Micromonospora;Micromonospora lutea	1	0	2	3	0	3	0	0	9
Bacteria;Bacteria_none;Bacteroidota;Bacteroidota_Incertae_sedis;Bacteroidetes Order II. Incertae sedis;Rhodothermaceae;Rhodothermus;Rhodothermus marinus	0	0	2	4	1	0	0	2	9
Bacteria;Bacteria_none;Proteobacteria;Gammaproteobacteria;Gammaproteobacteria_Incertae_sedis;Gammaproteobacteria_Incertae_sedis;Thiohalorhabdus;Thiohalorhabdus denitrificans	9	0	0	0	0	0	0	0	9
Bacteria;Bacteria_none;Proteobacteria;Alphaproteobacteria;Sphingomonadales;Sphingomonadaceae;Novosphingobium;Novosphingobium fontis	1	1	5	2	0	0	0	0	9
Bacteria;Bacteria_none;Firmicutes;Bacilli;Bacillales;Planococcaceae;Sporosarcina;Sporosarcina jiandibaonis	0	1	1	2	1	1	2	1	9
Bacteria;Bacteria_none;Proteobacteria;Gammaproteobacteria;Enterobacterales;Yersiniaceae;Yersinia;Yersinia ruckeri	7	1	0	0	0	0	0	1	9
Bacteria;Bacteria_none;Proteobacteria;Gammaproteobacteria;Nevskiales;Sinobacteraceae;Nevskia;Nevskia aquatilis	2	2	2	2	1	0	0	0	9
Bacteria;Bacteria_none;Proteobacteria;Deltaproteobacteria;Desulfuromonadales;Geobacteraceae;Geoalkalibacter;Geoalkalibacter subterraneus	1	2	2	4	0	0	0	0	9
Bacteria;Bacteria_none;Proteobacteria;Deltaproteobacteria;Desulfuromonadales;Desulfuromonadaceae;Pelobacter;Pelobacter propionicus	0	0	0	7	0	0	2	0	9
Bacteria;Bacteria_none;Cyanobacteria;Cyanobacteria_Incertae_sedis;Nostocales;Scytonemataceae;Ewamiania;Ewamiania thermalis	0	3	2	0	3	0	1	0	9
Bacteria;Bacteria_none;Bacteroidota;Bacteroidia;Marinilabiliales;Prolixibacteraceae;Draconibacterium;Draconibacterium filum	0	9	0	0	0	0	0	0	9
Bacteria;Bacteria_none;Proteobacteria;Alphaproteobacteria;Rickettsiales;Rickettsiaceae;Rickettsia;Rickettsia hoogstraalii	4	0	5	0	0	0	0	0	9
Bacteria;Bacteria_none;Proteobacteria;Betaproteobacteria;Neisseriales;Chromobacteriaceae;Gulbenkiania;Gulbenkiania mobilis	4	0	0	4	0	0	1	0	9
Bacteria;Bacteria_none;Proteobacteria;Alphaproteobacteria;Sphingomonadales;Erythrobacteraceae;Pontixanthobacter;Pontixanthobacter aestiaquae	1	8	0	0	0	0	0	0	9
Bacteria;Bacteria_none;Proteobacteria;Alphaproteobacteria;Hyphomicrobiales;Rhizobiaceae;Rhizobium;Rhizobium viscosum	1	1	3	1	0	2	1	0	9
Bacteria;Bacteria_none;Proteobacteria;Betaproteobacteria;Burkholderiales;Burkholderiaceae;Paraburkholderia;Paraburkholderia pallidirosea	4	4	1	0	0	0	0	0	9
Bacteria;Bacteria_none;Actinobacteria;Actinomycetia;Micrococcales;Microbacteriaceae;Microbacterium;Microbacterium ureisolvens	0	1	6	2	0	0	0	0	9
Bacteria;Bacteria_none;Firmicutes;Bacilli;Bacillales;Planococcaceae;Caryophanon;Caryophanon latum	0	2	6	1	0	0	0	0	9
Bacteria;Bacteria_none;Firmicutes;Bacilli;Bacillales;Paenibacillaceae;Xylanibacillus;Xylanibacillus composti	0	0	8	1	0	0	0	0	9
Bacteria;Bacteria_none;Actinobacteria;Coriobacteriia;Eggerthellales;Eggerthellaceae;Phoenicibacter;Phoenicibacter congonensis	1	0	3	2	0	3	0	0	9
Bacteria;Bacteria_none;Firmicutes;Bacilli;Bacillales;Bacillaceae;Bacillus;Bacillus pumilus	0	0	2	5	0	0	1	1	9
Bacteria;Bacteria_none;Actinobacteria;Actinomycetia;Micrococcales;Microbacteriaceae;Microbacterium;Microbacterium maritypicum	0	3	0	3	3	0	0	0	9
Bacteria;Bacteria_none;Actinobacteria;Actinomycetia;Actinomycetales;Actinomycetaceae;Actinomyces;Actinomyces marmotae	2	6	0	0	0	0	1	0	9
Bacteria;Bacteria_none;Firmicutes;Clostridia;Eubacteriales;Eubacteriales Family XII. Incertae Sedis;Fusibacter;Fusibacter bizertensis	0	4	2	2	1	0	0	0	9
Bacteria;Bacteria_none;Proteobacteria;Deltaproteobacteria;Desulfuromonadales;Geobacteraceae;Geomesophilobacter;Geomesophilobacter sediminis	0	0	0	0	0	9	0	0	9
Bacteria;Bacteria_none;Firmicutes;Clostridia;Eubacteriales;Desulfitobacteriaceae;Desulfosporosinus;Desulfosporosinus youngiae	0	0	2	3	0	4	0	0	9
Bacteria;Bacteria_none;Firmicutes;Bacilli;Bacillales;Bacillaceae;Ornithinibacillus;Ornithinibacillus bavariensis	0	1	3	3	1	0	0	1	9
Bacteria;Bacteria_none;Firmicutes;Erysipelotrichia;Erysipelotrichales;Erysipelotrichaceae;Absicoccus;Absicoccus porci	0	1	6	2	0	0	0	0	9
Bacteria;Bacteria_none;Proteobacteria;Deltaproteobacteria;Myxococcales;Polyangiaceae;Chondromyces;Chondromyces lanuginosus	0	0	6	1	0	0	2	0	9
Bacteria;Bacteria_none;Proteobacteria;Deltaproteobacteria;Myxococcales;Archangiaceae;Cystobacter;Cystobacter armeniaca	7	0	1	1	0	0	0	0	9
Bacteria;Bacteria_none;Proteobacteria;Betaproteobacteria;Nitrosomonadales;Nitrosomonadaceae;Nitrosomonas;Nitrosomonas europaea	8	0	0	1	0	0	0	0	9
Bacteria;Bacteria_none;Firmicutes;Bacilli;Bacillales;Bacillaceae;Paraliobacillus;Paraliobacillus zengyii	4	0	4	1	0	0	0	0	9
Bacteria;Bacteria_none;Firmicutes;Bacilli;Bacillales;Bacillaceae;Pelagirhabdus;Pelagirhabdus alkalitolerans	0	1	6	0	2	0	0	0	9
Bacteria;Bacteria_none;Bacteroidota;Chitinophagia;Chitinophagales;Chitinophagaceae;Flavihumibacter;Flavihumibacter solisilvae	1	2	5	0	0	1	0	0	9
Bacteria;Bacteria_none;Proteobacteria;Deltaproteobacteria;Desulfuromonadales;Geobacteraceae;Trichlorobacter;Trichlorobacter lovleyi	1	2	0	6	0	0	0	0	9
Bacteria;Bacteria_none;Actinobacteria;Actinomycetia;Propionibacteriales;Kribbellaceae;Kribbella;Kribbella lupini	3	5	0	0	0	0	0	1	9
Bacteria;Bacteria_none;Proteobacteria;Gammaproteobacteria;Moraxellales;Moraxellaceae;Acinetobacter;Acinetobacter qingfengensis	7	0	0	2	0	0	0	0	9
Bacteria;Bacteria_none;Proteobacteria;Alphaproteobacteria;Hyphomicrobiales;Phyllobacteriaceae;Hoeflea;Hoeflea halophila	3	4	1	0	1	0	0	0	9
Bacteria;Bacteria_none;Proteobacteria;Betaproteobacteria;Burkholderiales;Alcaligenaceae;Pelistega;Pelistega europaea	3	5	1	0	0	0	0	0	9
Bacteria;Bacteria_none;Bacteroidota;Chitinophagia;Chitinophagales;Chitinophagaceae;Chitinophaga;Chitinophaga oryziterrae	4	1	1	2	0	1	0	0	9
Bacteria;Bacteria_none;Firmicutes;Clostridia;Eubacteriales;Clostridiales Family XVII. Incertae Sedis;Sulfobacillus;Sulfobacillus benefaciens	0	0	0	0	0	0	0	9	9
Bacteria;Bacteria_none;Firmicutes;Clostridia;Eubacteriales;Peptococcaceae;Desulfofundulus;Desulfofundulus kuznetsovii	0	1	7	0	0	0	1	0	9
Bacteria;Bacteria_none;Proteobacteria;Deltaproteobacteria;Myxococcales;Polyangiaceae;Sorangium;Sorangium reichenbachii	0	0	0	8	0	0	0	1	9
Bacteria;Bacteria_none;Proteobacteria;Alphaproteobacteria;Hyphomicrobiales;Phyllobacteriaceae;Mesorhizobium;Mesorhizobium sangaii	1	6	0	1	0	1	0	0	9
Bacteria;Bacteria_none;Planctomycetota;Planctomycetia;Pirellulales;Lacipirellulaceae;Botrimarina;Botrimarina colliarenosi	0	2	0	7	0	0	0	0	9
Bacteria;Bacteria_none;Firmicutes;Bacilli;Bacillales;Paenibacillaceae;Chengkuizengella;Chengkuizengella sediminis	0	0	6	2	0	0	0	1	9
Bacteria;Bacteria_none;Firmicutes;Clostridia;Eubacteriales;Peptostreptococcaceae;Filifactor;Filifactor alocis	2	2	3	0	0	1	0	1	9
Bacteria;Bacteria_none;Firmicutes;Bacilli;Bacillales;Paenibacillaceae;Paenibacillus;Paenibacillus typhae	1	5	0	3	0	0	0	0	9
Bacteria;Bacteria_none;Proteobacteria;Betaproteobacteria;Burkholderiales;Sphaerotilaceae;Sphaerotilus;Sphaerotilus natans	8	1	0	0	0	0	0	0	9
Bacteria;Bacteria_none;Actinobacteria;Thermoleophilia;Miltoncostaeales;Miltoncostaeaceae;Miltoncostaea;Miltoncostaea marina	6	2	0	1	0	0	0	0	9
Bacteria;Bacteria_none;Proteobacteria;Betaproteobacteria;Burkholderiales;Sutterellaceae;Parasutterella;Parasutterella secunda	1	4	0	0	0	4	0	0	9
Bacteria;Bacteria_none;Proteobacteria;Betaproteobacteria;Burkholderiales;Burkholderiales_Incertae_sedis;Rhizobacter;Rhizobacter gummiphilus	6	2	0	0	0	0	0	1	9
Bacteria;Bacteria_none;Proteobacteria;Betaproteobacteria;Burkholderiales;Comamonadaceae;Acidovorax;Acidovorax cattleyae	4	0	0	5	0	0	0	0	9
Bacteria;Bacteria_none;Proteobacteria;Deltaproteobacteria;Desulfovibrionales;Desulfovibrionaceae;Pseudodesulfovibrio;Pseudodesulfovibrio halophilus	0	7	0	0	2	0	0	0	9
Bacteria;Bacteria_none;Proteobacteria;Gammaproteobacteria;Enterobacterales;Erwiniaceae;Pantoea;Pantoea wallisii	6	1	2	0	0	0	0	0	9
Bacteria;Bacteria_none;Proteobacteria;Gammaproteobacteria;Enterobacterales;Morganellaceae;Xenorhabdus;Xenorhabdus griffiniae	7	0	0	2	0	0	0	0	9
Bacteria;Bacteria_none;Bacteroidota;Chitinophagia;Chitinophagales;Chitinophagaceae;Taibaiella;Taibaiella yonginensis	8	1	0	0	0	0	0	0	9
Bacteria;Bacteria_none;Actinobacteria;Actinomycetia;Micrococcales;Microbacteriaceae;Microbacterium;Microbacterium terrae	1	5	1	1	0	0	1	0	9
Bacteria;Bacteria_none;Actinobacteria;Actinomycetia;Actinomycetales;Actinomycetaceae;Scrofimicrobium;Scrofimicrobium canadense	3	4	0	1	1	0	0	0	9
Bacteria;Bacteria_none;Proteobacteria;Epsilonproteobacteria;Campylobacterales;Arcobacteraceae;Arcobacter;Arcobacter defluvii	2	0	0	3	0	0	0	4	9
Bacteria;Bacteria_none;Firmicutes;Bacilli;Bacillales;Bacillaceae;Metabacillus;Metabacillus indicus	0	0	9	0	0	0	0	0	9
Bacteria;Bacteria_none;Proteobacteria;Gammaproteobacteria;Xanthomonadales;Xanthomonadaceae;Xanthomonas;Xanthomonas bonasiae	8	0	0	0	0	1	0	0	9
Bacteria;Bacteria_none;Firmicutes;Bacilli;Lactobacillales;Streptococcaceae;Streptococcus;Streptococcus penaeicida	9	0	0	0	0	0	0	0	9
Bacteria;Bacteria_none;Firmicutes;Bacilli;Lactobacillales;Aerococcaceae;Facklamia;Facklamia miroungae	1	3	2	2	0	1	0	0	9
Bacteria;Bacteria_none;Proteobacteria;Deltaproteobacteria;Desulfovibrionales;Desulfovibrionaceae;Pseudodesulfovibrio;Pseudodesulfovibrio portus	0	9	0	0	0	0	0	0	9
Bacteria;Bacteria_none;Actinobacteria;Actinomycetia;Micrococcales;Intrasporangiaceae;Ornithinibacter;Ornithinibacter aureus	2	4	1	0	0	0	2	0	9
Bacteria;Bacteria_none;Firmicutes;Bacilli;Bacillales;Bacillaceae;Bacillus;Bacillus oleivorans	0	5	3	0	0	0	0	1	9
Bacteria;Bacteria_none;Firmicutes;Clostridia;Eubacteriales;Eubacteriales_Incertae_sedis;Proteiniborus;Proteiniborus ethanoligenes	0	1	0	2	2	4	0	0	9
Bacteria;Bacteria_none;Actinobacteria;Actinomycetia;Streptomycetales;Streptomycetaceae;Streptomyces;Streptomyces omiyaensis	3	0	4	2	0	0	0	0	9
Bacteria;Bacteria_none;Firmicutes;Clostridia;Eubacteriales;Lachnospiraceae;Anaerotignum;Anaerotignum faecicola	1	2	3	1	0	1	0	1	9
Bacteria;Bacteria_none;Bacteroidota;Flavobacteriia;Flavobacteriales;Flavobacteriaceae;Psychroflexus;Psychroflexus tropicus	1	4	2	0	1	0	0	0	8
Bacteria;Bacteria_none;Firmicutes;Bacilli;Bacillales;Bacillaceae;Caldalkalibacillus;Caldalkalibacillus thermarum	0	2	4	1	0	0	0	1	8
Bacteria;Bacteria_none;Proteobacteria;Epsilonproteobacteria;Campylobacterales;Sulfurospirillaceae;Sulfurospirillum;Sulfurospirillum arsenophilum	0	0	3	2	0	2	0	1	8
Bacteria;Bacteria_none;Actinobacteria;Actinomycetia;Micrococcales;Intrasporangiaceae;Phycicoccus;Phycicoccus endophyticus	0	5	0	3	0	0	0	0	8
Bacteria;Bacteria_none;Proteobacteria;Deltaproteobacteria;Myxococcales;Myxococcaceae;Corallococcus;Corallococcus silvisoli	0	0	7	0	0	1	0	0	8
Bacteria;Bacteria_none;Proteobacteria;Alphaproteobacteria;Hyphomicrobiales;Rhizobiaceae;Rhizobium;Rhizobium aquaticum	0	4	0	4	0	0	0	0	8
Bacteria;Bacteria_none;Proteobacteria;Alphaproteobacteria;Hyphomicrobiales;Rhizobiaceae;Mycoplana;Mycoplana dimorpha	1	5	1	1	0	0	0	0	8
Bacteria;Bacteria_none;Proteobacteria;Gammaproteobacteria;Cellvibrionales;Microbulbiferaceae;Microbulbifer;Microbulbifer hainanensis	2	5	0	1	0	0	0	0	8
Bacteria;Bacteria_none;Actinobacteria;Actinomycetia;Streptosporangiales;Streptosporangiaceae;Streptosporangium;Streptosporangium pseudovulgare	0	3	0	5	0	0	0	0	8
Bacteria;Bacteria_none;Actinobacteria;Actinomycetia;Micrococcales;Microbacteriaceae;Microbacterium;Microbacterium helvum	0	1	0	1	0	5	1	0	8
Bacteria;Bacteria_none;Proteobacteria;Betaproteobacteria;Burkholderiales;Sphaerotilaceae;Piscinibacter;Piscinibacter caeni	5	3	0	0	0	0	0	0	8
Bacteria;Bacteria_none;Proteobacteria;Alphaproteobacteria;Hyphomicrobiales;Rhizobiaceae;Rhizobium;Rhizobium pusense	1	3	1	0	2	0	0	1	8
Bacteria;Bacteria_none;Firmicutes;Bacilli;Bacillales;Bacillaceae;Peribacillus;Peribacillus acanthi	0	2	3	0	0	3	0	0	8
Bacteria;Bacteria_none;Firmicutes;Clostridia;Thermosediminibacterales;Thermosediminibacteraceae;Thermosediminibacter;Thermosediminibacter litoriperuensis	0	1	5	2	0	0	0	0	8
Bacteria;Bacteria_none;Firmicutes;Clostridia;Eubacteriales;Symbiobacteriaceae;Symbiobacterium;Symbiobacterium turbinis	0	1	3	0	1	3	0	0	8
Bacteria;Bacteria_none;Firmicutes;Bacilli;Bacillales;Bacillaceae;Halobacillus;Halobacillus kuroshimensis	2	0	3	2	1	0	0	0	8
Bacteria;Bacteria_none;Actinobacteria;Actinomycetia;Corynebacteriales;Mycobacteriaceae;Mycobacterium;Mycobacterium terramassiliense	2	4	0	1	0	1	0	0	8
Bacteria;Bacteria_none;Firmicutes;Clostridia;Thermoanaerobacterales;Thermoanaerobacteraceae;Caldanaerobius;Caldanaerobius fijiensis	0	5	2	1	0	0	0	0	8
Bacteria;Bacteria_none;Actinobacteria;Actinomycetia;Micrococcales;Microbacteriaceae;Microbacterium;Microbacterium hydrothermale	1	5	1	0	1	0	0	0	8
Bacteria;Bacteria_none;Firmicutes;Bacilli;Bacillales;Bacillaceae;Bacillus;Bacillus glycinifermentans	0	0	0	5	0	0	0	3	8
Bacteria;Bacteria_none;Proteobacteria;Gammaproteobacteria;Cellvibrionales;Halieaceae;Seongchinamella;Seongchinamella sediminis	1	1	5	0	0	1	0	0	8
Bacteria;Bacteria_none;Actinobacteria;Actinomycetia;Micrococcales;Microbacteriaceae;Microbacterium;Microbacterium aerolatum	0	7	1	0	0	0	0	0	8
Bacteria;Bacteria_none;Firmicutes;Negativicutes;Selenomonadales;Sporomusaceae;Pelosinus;Pelosinus defluvii	0	3	0	1	1	0	0	3	8
Bacteria;Bacteria_none;Proteobacteria;Gammaproteobacteria;Cellvibrionales;Halieaceae;Haliea;Haliea atlantica	5	0	0	3	0	0	0	0	8
Bacteria;Bacteria_none;Firmicutes;Clostridia;Halanaerobiales;Halobacteroidaceae;Halobacteroides;Halobacteroides halobius	3	1	3	1	0	0	0	0	8
Bacteria;Bacteria_none;Firmicutes;Clostridia;Eubacteriales;Peptococcaceae;Desulfofundulus;Desulfofundulus thermocisternus	0	0	4	4	0	0	0	0	8
Bacteria;Bacteria_none;Proteobacteria;Betaproteobacteria;Neisseriales;Chromobacteriaceae;Deefgea;Deefgea salmonis	5	2	0	0	0	0	1	0	8
Bacteria;Bacteria_none;Proteobacteria;Betaproteobacteria;Rhodocyclales;Zoogloeaceae;Nitrogeniibacter;Nitrogeniibacter mangrovi	4	1	1	0	1	0	1	0	8
Bacteria;Bacteria_none;Proteobacteria;Betaproteobacteria;Rhodocyclales;Rhodocyclaceae;Oryzomicrobium;Oryzomicrobium terrae	2	0	2	1	0	2	0	1	8
Bacteria;Bacteria_none;Verrucomicrobia;Verrucomicrobiae;Verrucomicrobiales;Rubritaleaceae;Rubritalea;Rubritalea profundi	0	8	0	0	0	0	0	0	8
Bacteria;Bacteria_none;Firmicutes;Negativicutes;Selenomonadales;Sporomusaceae;Dendrosporobacter;Dendrosporobacter quercicolus	5	2	1	0	0	0	0	0	8
Bacteria;Bacteria_none;Proteobacteria;Alphaproteobacteria;Hyphomicrobiales;Rhizobiaceae;Rhizobium;Rhizobium multihospitium	0	8	0	0	0	0	0	0	8
Bacteria;Bacteria_none;Proteobacteria;Deltaproteobacteria;Desulfobacterales;Desulfobacteraceae;Desulfatiferula;Desulfatiferula olefinivorans	0	3	1	2	2	0	0	0	8
Bacteria;Bacteria_none;Proteobacteria;Deltaproteobacteria;Desulfovibrionales;Desulfovibrionaceae;Desulfovibrio;Desulfovibrio aminophilus	0	2	2	2	0	0	0	2	8
Bacteria;Bacteria_none;Firmicutes;Clostridia;Eubacteriales;Peptostreptococcaceae;Paeniclostridium;Paeniclostridium ghonii	2	1	2	2	0	0	1	0	8
Bacteria;Bacteria_none;Actinobacteria;Actinomycetia;Streptomycetales;Streptomycetaceae;Streptomyces;Streptomyces luridiscabiei	0	4	4	0	0	0	0	0	8
Bacteria;Bacteria_none;Proteobacteria;Deltaproteobacteria;Desulfovibrionales;Desulfovibrionaceae;Solidesulfovibrio;Solidesulfovibrio carbinoliphilus	0	6	0	2	0	0	0	0	8
Bacteria;Bacteria_none;Proteobacteria;Alphaproteobacteria;Hyphomicrobiales;Rhizobiaceae;Peteryoungia;Peteryoungia aggregata	0	3	1	2	1	1	0	0	8
Bacteria;Bacteria_none;Proteobacteria;Gammaproteobacteria;Aeromonadales;Aeromonadaceae;Zobellella;Zobellella denitrificans	8	0	0	0	0	0	0	0	8
Bacteria;Bacteria_none;Firmicutes;Clostridia;Thermoanaerobacterales;Thermoanaerobacteraceae;Thermoanaerobacter;Thermoanaerobacter italicus	0	1	3	1	0	0	2	1	8
Bacteria;Bacteria_none;Proteobacteria;Betaproteobacteria;Rhodocyclales;Rhodocyclaceae;Rhodocyclus;Rhodocyclus tenuis	1	2	2	1	0	1	0	1	8
Bacteria;Bacteria_none;Actinobacteria;Actinomycetia;Corynebacteriales;Mycobacteriaceae;Mycobacterium;Mycobacterium tuberculosis	0	1	1	4	0	2	0	0	8
Bacteria;Bacteria_none;Firmicutes;Bacilli;Bacillales;Bacillaceae;Mesobacillus;Mesobacillus aurantius	1	1	1	4	0	0	0	1	8
Bacteria;Bacteria_none;Proteobacteria;Betaproteobacteria;Rhodocyclales;Zoogloeaceae;Uliginosibacterium;Uliginosibacterium paludis	6	0	0	2	0	0	0	0	8
Bacteria;Bacteria_none;Firmicutes;Bacilli;Lactobacillales;Streptococcaceae;Lactococcus;Lactococcus insecticola	7	0	1	0	0	0	0	0	8
Bacteria;Bacteria_none;Actinobacteria;Actinomycetia;Streptomycetales;Streptomycetaceae;Streptomyces;Streptomyces carminius	2	0	0	5	0	0	1	0	8
Bacteria;Bacteria_none;Proteobacteria;Deltaproteobacteria;Desulfobacterales;Desulfobacteraceae;Desulfocicer;Desulfocicer niacini	0	8	0	0	0	0	0	0	8
Bacteria;Bacteria_none;Proteobacteria;Betaproteobacteria;Burkholderiales;Sphaerotilaceae;Ideonella;Ideonella paludis	5	0	1	0	0	0	0	2	8
Bacteria;Bacteria_none;Actinobacteria;Actinomycetia;Corynebacteriales;Mycobacteriaceae;Mycobacterium;Mycobacterium parmense	0	3	1	3	0	1	0	0	8
Bacteria;Bacteria_none;Proteobacteria;Alphaproteobacteria;Hyphomicrobiales;Rhizobiaceae;Rhizobium;Rhizobium oryzicola	3	4	0	1	0	0	0	0	8
Bacteria;Bacteria_none;Firmicutes;Clostridia;Eubacteriales;Peptococcaceae;Desulfonispora;Desulfonispora thiosulfatigenes	2	0	2	2	1	1	0	0	8
Bacteria;Bacteria_none;Actinobacteria;Coriobacteriia;Eggerthellales;Eggerthellaceae;Slackia;Slackia heliotrinireducens	0	0	1	7	0	0	0	0	8
Bacteria;Bacteria_none;Bacteroidota;Flavobacteriia;Flavobacteriales;Flavobacteriaceae;Winogradskyella;Winogradskyella pulchriflava	0	0	0	2	0	6	0	0	8
Bacteria;Bacteria_none;Proteobacteria;Deltaproteobacteria;Desulfovibrionales;Desulfovibrionaceae;Bilophila;Bilophila wadsworthia	0	5	3	0	0	0	0	0	8
Bacteria;Bacteria_none;Proteobacteria;Deltaproteobacteria;Desulfovibrionales;Desulfovibrionaceae;Desulfovibrio;Desulfovibrio piger	3	2	0	3	0	0	0	0	8
Bacteria;Bacteria_none;Firmicutes;Clostridia;Eubacteriales;Peptococcaceae;Desulfohalotomaculum;Desulfohalotomaculum halophilum	0	0	1	2	0	5	0	0	8
Bacteria;Bacteria_none;Actinobacteria;Actinomycetia;Streptosporangiales;Thermomonosporaceae;Actinocorallia;Actinocorallia cavernae	2	3	2	0	0	0	1	0	8
Bacteria;Bacteria_none;Firmicutes;Clostridia;Eubacteriales;Syntrophomonadaceae;Thermosyntropha;Thermosyntropha tengcongensis	0	0	3	0	3	2	0	0	8
Bacteria;Bacteria_none;Proteobacteria;Deltaproteobacteria;Desulfobacterales;Desulfobacteraceae;Desulfatiglans;Desulfatiglans anilini	8	0	0	0	0	0	0	0	8
Bacteria;Bacteria_none;Actinobacteria;Actinomycetia;Propionibacteriales;Propionibacteriaceae;Acidipropionibacterium;Acidipropionibacterium timonense	0	5	3	0	0	0	0	0	8
Bacteria;Bacteria_none;Firmicutes;Bacilli;Lactobacillales;Streptococcaceae;Streptococcus;Streptococcus hyointestinalis	7	1	0	0	0	0	0	0	8
Bacteria;Bacteria_none;Cyanobacteria;Cyanobacteria_Incertae_sedis;Pseudanabaenales;Leptolyngbyaceae;Thainema;Thainema salinarum	1	1	1	2	0	2	1	0	8
Bacteria;Bacteria_none;Bacteroidota;Chitinophagia;Chitinophagales;Chitinophagaceae;Arachidicoccus;Arachidicoccus soli	7	0	1	0	0	0	0	0	8
Bacteria;Bacteria_none;Firmicutes;Bacilli;Bacillales;Planococcaceae;Sporosarcina;Sporosarcina soli	0	0	3	5	0	0	0	0	8
Bacteria;Bacteria_none;Proteobacteria;Alphaproteobacteria;Rhodobacterales;Rhodobacteraceae;Gemmobacter;Gemmobacter nectariphilus	1	1	3	2	1	0	0	0	8
Bacteria;Bacteria_none;Proteobacteria;Gammaproteobacteria;Legionellales;Legionellaceae;Legionella;Legionella fairfieldensis	2	0	2	3	1	0	0	0	8
Bacteria;Bacteria_none;Proteobacteria;Betaproteobacteria;Burkholderiales;Alcaligenaceae;Pusillimonas;Pusillimonas noertemannii	0	0	1	1	1	5	0	0	8
Bacteria;Bacteria_none;Proteobacteria;Alphaproteobacteria;Rhodospirillales;Acetobacteraceae;Acidiphilium;Acidiphilium cryptum	6	0	0	2	0	0	0	0	8
Bacteria;Bacteria_none;Actinobacteria;Actinomycetia;Propionibacteriales;Nocardioidaceae;Nocardioides;Nocardioides donggukensis	1	2	3	2	0	0	0	0	8
Bacteria;Bacteria_none;Proteobacteria;Gammaproteobacteria;Thiotrichales;Piscirickettsiaceae;Methylophaga;Methylophaga muralis	3	2	0	1	1	0	0	1	8
Bacteria;Bacteria_none;Proteobacteria;Gammaproteobacteria;Legionellales;Legionellaceae;Legionella;Legionella quinlivanii	2	2	1	2	0	0	0	1	8
Bacteria;Bacteria_none;Firmicutes;Bacilli;Lactobacillales;Streptococcaceae;Streptococcus;Streptococcus troglodytae	6	1	0	1	0	0	0	0	8
Bacteria;Bacteria_none;Proteobacteria;Alphaproteobacteria;Hyphomicrobiales;Phyllobacteriaceae;Mesorhizobium;Mesorhizobium loti	1	4	3	0	0	0	0	0	8
Bacteria;Bacteria_none;Bacteroidota;Flavobacteriia;Flavobacteriales;Flavobacteriaceae;Flavobacterium;Flavobacterium johnsoniae	0	3	5	0	0	0	0	0	8
Bacteria;Bacteria_none;Chloroflexi;Thermoflexia;Thermoflexales;Thermoflexaceae;Thermoflexus;Thermoflexus hugenholtzii	1	4	2	1	0	0	0	0	8
Bacteria;Bacteria_none;Firmicutes;Bacilli;Bacillales;Paenibacillaceae;Cohnella;Cohnella suwonensis	0	0	4	4	0	0	0	0	8
Bacteria;Bacteria_none;Cyanobacteria;Cyanobacteria_Incertae_sedis;Pseudanabaenales;Prochlorotrichaceae;Haloleptolyngbya;Haloleptolyngbya elongata	0	0	3	5	0	0	0	0	8
Bacteria;Bacteria_none;Actinobacteria;Actinomycetia;Micrococcales;Microbacteriaceae;Microbacterium;Microbacterium wangchenii	0	1	2	0	0	0	4	1	8
Bacteria;Bacteria_none;Cyanobacteria;Cyanobacteria_Incertae_sedis;Pseudanabaenales;Prochlorotrichaceae;Prochlorothrix;Prochlorothrix hollandica	1	7	0	0	0	0	0	0	8
Bacteria;Bacteria_none;Actinobacteria;Actinomycetia;Micrococcales;Microbacteriaceae;Cryobacterium;Cryobacterium psychrophilum	0	5	0	3	0	0	0	0	8
Bacteria;Bacteria_none;Cyanobacteria;Cyanobacteria_Incertae_sedis;Synechococcales;Prochlorococcaceae;Prochlorococcus;Prochlorococcus marinus	3	2	2	0	0	0	1	0	8
Bacteria;Bacteria_none;Firmicutes;Bacilli;Lactobacillales;Enterococcaceae;Enterococcus;Enterococcus raffinosus	6	2	0	0	0	0	0	0	8
Bacteria;Bacteria_none;Bacteroidota;Bacteroidia;Marinilabiliales;Marinilabiliaceae;Carboxylicivirga;Carboxylicivirga sediminis	0	8	0	0	0	0	0	0	8
Bacteria;Bacteria_none;Actinobacteria;Actinomycetia;Corynebacteriales;Gordoniaceae;Gordonia;Gordonia alkanivorans	2	3	3	0	0	0	0	0	8
Bacteria;Bacteria_none;Bacteroidota;Bacteroidia;Marinilabiliales;Marinifilaceae;Ancylomarina;Ancylomarina longa	3	4	0	1	0	0	0	0	8
Bacteria;Bacteria_none;Firmicutes;Bacilli;Lactobacillales;Streptococcaceae;Streptococcus;Streptococcus pyogenes	7	0	0	1	0	0	0	0	8
Bacteria;Bacteria_none;Proteobacteria;Gammaproteobacteria;Enterobacterales;Pectobacteriaceae;Pectobacterium;Pectobacterium cacticida	2	0	0	0	0	0	2	4	8
Bacteria;Bacteria_none;Acidobacteria;Acidobacteriia;Acidobacteriales;Acidobacteriaceae;Terriglobus;Terriglobus saanensis	2	4	0	1	0	0	1	0	8
Bacteria;Bacteria_none;Proteobacteria;Gammaproteobacteria;Oceanospirillales;Oceanospirillaceae;Neptunomonas;Neptunomonas naphthovorans	4	0	1	2	1	0	0	0	8
Bacteria;Bacteria_none;Chloroflexi;Dehalococcoidia;Dehalococcoidales;Dehalococcoidaceae;Dehalococcoides;Dehalococcoides mccartyi	1	2	1	1	1	0	0	2	8
Bacteria;Bacteria_none;Proteobacteria;Alphaproteobacteria;Rhodobacterales;Rhodobacteraceae;Cochlodiniinecator;Cochlodiniinecator piscidefendens	4	0	2	1	0	1	0	0	8
Bacteria;Bacteria_none;Bacteroidota;Bacteroidia;Bacteroidales;Tannerellaceae;Tannerella;Tannerella serpentiformis	2	2	4	0	0	0	0	0	8
Bacteria;Bacteria_none;Proteobacteria;Gammaproteobacteria;Enterobacterales;Morganellaceae;Xenorhabdus;Xenorhabdus stockiae	6	2	0	0	0	0	0	0	8
Bacteria;Bacteria_none;Bacteroidota;Chitinophagia;Chitinophagales;Chitinophagaceae;Flavisolibacter;Flavisolibacter swuensis	5	3	0	0	0	0	0	0	8
Bacteria;Bacteria_none;Proteobacteria;Gammaproteobacteria;Pseudomonadales;Pseudomonadaceae;Pseudomonas;Pseudomonas caricapapayae	0	0	6	0	0	0	2	0	8
Bacteria;Bacteria_none;Proteobacteria;Gammaproteobacteria;Methylococcales;Methylococcaceae;Methylomagnum;Methylomagnum ishizawai	5	1	2	0	0	0	0	0	8
Bacteria;Bacteria_none;Spirochaetes;Spirochaetia;Spirochaetales;Breznakiellaceae;Helmutkoenigia;Helmutkoenigia isoptericolens	0	1	0	4	0	1	0	2	8
Bacteria;Bacteria_none;Proteobacteria;Gammaproteobacteria;Pasteurellales;Pasteurellaceae;Actinobacillus;Actinobacillus equuli	6	0	1	1	0	0	0	0	8
Bacteria;Bacteria_none;Proteobacteria;Oligoflexia;Bacteriovoracales;Halobacteriovoraceae;Halobacteriovorax;Halobacteriovorax vibrionivorans	2	3	1	0	2	0	0	0	8
Bacteria;Bacteria_none;Proteobacteria;Oligoflexia;Oligoflexales;Oligoflexaceae;Oligoflexus;Oligoflexus tunisiensis	1	1	3	3	0	0	0	0	8
Bacteria;Bacteria_none;Firmicutes;Clostridia;Eubacteriales;Clostridiaceae;Isachenkonia;Isachenkonia alkalipeptolytica	4	1	0	1	0	2	0	0	8
Bacteria;Bacteria_none;Proteobacteria;Alphaproteobacteria;Hyphomicrobiales;Brucellaceae;Brucella;Brucella vulpis	0	6	0	0	0	2	0	0	8
Bacteria;Bacteria_none;Firmicutes;Clostridia;Eubacteriales;Clostridiaceae;Alkaliphilus;Alkaliphilus flagellatus	0	0	4	4	0	0	0	0	8
Bacteria;Bacteria_none;Proteobacteria;Gammaproteobacteria;Nevskiales;Sinobacteraceae;Solimonas;Solimonas variicoloris	0	0	0	8	0	0	0	0	8
Bacteria;Bacteria_none;Proteobacteria;Alphaproteobacteria;Rhodobacterales;Rhodobacteraceae;Paracoccus;Paracoccus denitrificans	3	1	0	4	0	0	0	0	8
Bacteria;Bacteria_none;Proteobacteria;Alphaproteobacteria;Sphingomonadales;Sphingomonadaceae;Novosphingobium;Novosphingobium capsulatum	2	2	3	1	0	0	0	0	8
Bacteria;Bacteria_none;Firmicutes;Clostridia;Eubacteriales;Clostridiaceae;Proteiniclasticum;Proteiniclasticum sediminis	5	2	0	1	0	0	0	0	8
Bacteria;Bacteria_none;Bacteroidota;Chitinophagia;Chitinophagales;Chitinophagaceae;Parasegetibacter;Parasegetibacter luojiensis	6	0	1	0	0	1	0	0	8
Bacteria;Bacteria_none;Proteobacteria;Gammaproteobacteria;Moraxellales;Moraxellaceae;Acinetobacter;Acinetobacter wuhouensis	3	0	0	5	0	0	0	0	8
Bacteria;Bacteria_none;Proteobacteria;Alphaproteobacteria;Rhodospirillales;Rhodospirillaceae;Roseospirillum;Roseospirillum parvum	2	4	0	2	0	0	0	0	8
Bacteria;Bacteria_none;Proteobacteria;Alphaproteobacteria;Sphingomonadales;Sphingomonadaceae;Sphingobium;Sphingobium tyrosinilyticum	3	3	1	1	0	0	0	0	8
Bacteria;Bacteria_none;Acidobacteria;Blastocatellia;Blastocatellales;Pyrinomonadaceae;Arenimicrobium;Arenimicrobium luteum	7	1	0	0	0	0	0	0	8
Bacteria;Bacteria_none;Proteobacteria;Alphaproteobacteria;Caulobacterales;Caulobacteraceae;Phenylobacterium;Phenylobacterium mobile	0	0	0	8	0	0	0	0	8
Bacteria;Bacteria_none;Proteobacteria;Alphaproteobacteria;Rhodospirillales;Rhodospirillaceae;Dongia;Dongia soli	1	3	0	2	0	1	0	1	8
Bacteria;Bacteria_none;Bacteroidota;Chitinophagia;Chitinophagales;Chitinophagaceae;Niabella;Niabella aquatica	5	3	0	0	0	0	0	0	8
Bacteria;Bacteria_none;Proteobacteria;Alphaproteobacteria;Rhodospirillales;Azospirillaceae;Skermanella;Skermanella stibiiresistens	0	7	0	0	1	0	0	0	8
Bacteria;Bacteria_none;Cyanobacteria;Cyanobacteria_Incertae_sedis;Nostocales;Calotrichaceae;Dulcicalothrix;Dulcicalothrix desertica	0	6	2	0	0	0	0	0	8
Bacteria;Bacteria_none;Proteobacteria;Alphaproteobacteria;Sphingomonadales;Sphingomonadaceae;Sphingomonas;Sphingomonas panacis	1	2	0	3	0	0	2	0	8
Bacteria;Bacteria_none;Proteobacteria;Alphaproteobacteria;Sphingomonadales;Sphingomonadaceae;Sphingomonas;Sphingomonas paucimobilis	2	1	1	4	0	0	0	0	8
Bacteria;Bacteria_none;Proteobacteria;Gammaproteobacteria;Pseudomonadales;Pseudomonadaceae;Permianibacter;Permianibacter fluminis	4	1	0	1	0	2	0	0	8
Bacteria;Bacteria_none;Proteobacteria;Alphaproteobacteria;Rhodospirillales;Acetobacteraceae;Siccirubricoccus;Siccirubricoccus deserti	1	3	1	3	0	0	0	0	8
Bacteria;Bacteria_none;Bacteroidota;Cytophagia;Cytophagales;Cytophagaceae;Rhodonellum;Rhodonellum psychrophilum	0	1	4	2	1	0	0	0	8
Bacteria;Bacteria_none;Actinobacteria;Actinomycetia;Corynebacteriales;Corynebacteriaceae;Corynebacterium;Corynebacterium minutissimum	0	0	3	3	0	2	0	0	8
Bacteria;Bacteria_none;Bacteroidota;Chitinophagia;Chitinophagales;Chitinophagaceae;Flavitalea;Flavitalea populi	6	1	1	0	0	0	0	0	8
Bacteria;Bacteria_none;Proteobacteria;Alphaproteobacteria;Sphingomonadales;Sphingosinicellaceae;Polymorphobacter;Polymorphobacter arshaanensis	0	0	5	2	0	1	0	0	8
Bacteria;Bacteria_none;Proteobacteria;Gammaproteobacteria;Methylococcales;Methylothermaceae;Methylomarinovum;Methylomarinovum caldicuralii	4	1	1	1	0	1	0	0	8
Bacteria;Bacteria_none;Firmicutes;Bacilli;Lactobacillales;Lactobacillaceae;Leuconostoc;Leuconostoc kimchii	2	4	0	1	0	0	1	0	8
Bacteria;Bacteria_none;Firmicutes;Clostridia;Eubacteriales;Heliobacteriaceae;Heliobacterium;Heliobacterium mobile	0	0	5	0	0	2	1	0	8
Bacteria;Bacteria_none;Firmicutes;Clostridia;Eubacteriales;Eubacteriales_Incertae_sedis;Flintibacter;Flintibacter butyricus	1	0	5	0	1	1	0	0	8
Bacteria;Bacteria_none;Proteobacteria;Gammaproteobacteria;Enterobacterales;Morganellaceae;Providencia;Providencia heimbachae	4	0	0	4	0	0	0	0	8
Bacteria;Bacteria_none;Proteobacteria;Gammaproteobacteria;Chromatiales;Halothiobacillaceae;Halothiobacillus;Halothiobacillus kellyi	3	0	1	3	1	0	0	0	8
Bacteria;Bacteria_none;Proteobacteria;Alphaproteobacteria;Hyphomicrobiales;Phyllobacteriaceae;Pseudaminobacter;Pseudaminobacter defluvii	1	3	2	1	1	0	0	0	8
Bacteria;Bacteria_none;Proteobacteria;Alphaproteobacteria;Rhodobacterales;Rhodobacteraceae;Rhodobacter;Rhodobacter capsulatus	2	2	1	3	0	0	0	0	8
Bacteria;Bacteria_none;Bacteroidota;Cytophagia;Cytophagales;Spirosomaceae;Dyadobacter;Dyadobacter fermentans	0	3	0	2	0	0	0	3	8
Bacteria;Bacteria_none;Firmicutes;Tissierellia;Tissierellales;Thermohalobacteraceae;Brassicibacter;Brassicibacter mesophilus	1	2	4	0	0	1	0	0	8
Bacteria;Bacteria_none;Firmicutes;Clostridia;Eubacteriales;Lachnospiraceae;Enterocloster;Enterocloster clostridioformis	4	2	0	2	0	0	0	0	8
Bacteria;Bacteria_none;Proteobacteria;Gammaproteobacteria;Enterobacterales;Enterobacteriaceae;Enterobacter;Enterobacter cloacae	5	3	0	0	0	0	0	0	8
Bacteria;Bacteria_none;Actinobacteria;Actinomycetia;Micrococcales;Microbacteriaceae;Leucobacter;Leucobacter aridicollis	0	0	8	0	0	0	0	0	8
Bacteria;Bacteria_none;Proteobacteria;Gammaproteobacteria;Xanthomonadales;Xanthomonadaceae;Lysobacter;Lysobacter antibioticus	3	1	1	1	0	1	1	0	8
Bacteria;Bacteria_none;Proteobacteria;Gammaproteobacteria;Enterobacterales;Enterobacteriaceae;Enterobacter;Enterobacter chengduensis	8	0	0	0	0	0	0	0	8
Bacteria;Bacteria_none;Bacteroidota;Sphingobacteriia;Sphingobacteriales;Sphingobacteriaceae;Sphingobacterium;Sphingobacterium psychroaquaticum	7	1	0	0	0	0	0	0	8
Bacteria;Bacteria_none;Proteobacteria;Gammaproteobacteria;Xanthomonadales;Xanthomonadaceae;Lysobacter;Lysobacter lycopersici	5	0	0	3	0	0	0	0	8
Bacteria;Bacteria_none;Bacteroidota;Bacteroidia;Bacteroidales;Muribaculaceae;Duncaniella;Duncaniella muris	0	6	1	1	0	0	0	0	8
Bacteria;Bacteria_none;Tenericutes;Tenericutes_Incertae_sedis;Mycoplasmoidales;Metamycoplasmataceae;Mycoplasmoides;Mycoplasma amphoriforme	0	3	2	0	0	0	1	2	8
Bacteria;Bacteria_none;Firmicutes;Clostridia;Eubacteriales;Lachnospiraceae;Lachnoclostridium;Lachnoclostridium phytofermentans	4	0	2	0	2	0	0	0	8
Bacteria;Bacteria_none;Proteobacteria;Alphaproteobacteria;Hyphomonadales;Hyphomonadaceae;Vitreimonas;Vitreimonas flagellata	3	3	1	1	0	0	0	0	8
Bacteria;Bacteria_none;Firmicutes;Tissierellia;Tissierellales;Peptoniphilaceae;Lagierella;Lagierella massiliensis	2	1	2	1	0	1	1	0	8
Bacteria;Bacteria_none;Firmicutes;Bacilli;Lactobacillales;Streptococcaceae;Streptococcus;Streptococcus macacae	7	0	1	0	0	0	0	0	8
Bacteria;Bacteria_none;Proteobacteria;Gammaproteobacteria;Chromatiales;Ectothiorhodospiraceae;Inmirania;Inmirania thermothiophila	6	2	0	0	0	0	0	0	8
Bacteria;Bacteria_none;Proteobacteria;Alphaproteobacteria;Hyphomicrobiales;Xanthobacteraceae;Ancylobacter;Ancylobacter defluvii	4	1	0	3	0	0	0	0	8
Bacteria;Bacteria_none;Firmicutes;Clostridia;Eubacteriales;Clostridiaceae;Clostridium;Clostridium bowmanii	2	0	2	3	0	0	0	1	8
Bacteria;Bacteria_none;Firmicutes;Clostridia;Eubacteriales;Lachnospiraceae;Lacrimispora;Lacrimispora algidixylanolytica	4	0	1	0	1	2	0	0	8
Bacteria;Bacteria_none;Firmicutes;Bacilli;Bacillales;Bacillaceae;Allobacillus;Allobacillus halotolerans	0	0	7	0	0	1	0	0	8
Bacteria;Bacteria_none;Bacteroidota;Bacteroidia;Bacteroidales;Bacteroidaceae;Phocaeicola;Phocaeicola coprophilus	0	1	0	6	0	0	0	1	8
Bacteria;Bacteria_none;Proteobacteria;Gammaproteobacteria;Xanthomonadales;Xanthomonadaceae;Stenotrophomonas;Stenotrophomonas koreensis	0	0	7	0	0	1	0	0	8
Bacteria;Bacteria_none;Verrucomicrobia;Opitutae;Opitutales;Opitutaceae;Alterococcus;Alterococcus agarolyticus	0	8	0	0	0	0	0	0	8
Bacteria;Bacteria_none;Proteobacteria;Betaproteobacteria;Burkholderiales;Oxalobacteraceae;Herbaspirillum;Herbaspirillum chlorophenolicum	5	3	0	0	0	0	0	0	8
Bacteria;Bacteria_none;Proteobacteria;Betaproteobacteria;Burkholderiales;Oxalobacteraceae;Herbaspirillum;Herbaspirillum rubrisubalbicans	7	0	0	0	1	0	0	0	8
Bacteria;Bacteria_none;Proteobacteria;Gammaproteobacteria;Chromatiales;Chromatiaceae;Pararheinheimera;Pararheinheimera chironomi	0	2	2	2	0	0	1	1	8
Bacteria;Bacteria_none;Firmicutes;Bacilli;Bacillales;Alicyclobacillaceae;Tumebacillus;Tumebacillus permanentifrigoris	2	0	1	2	1	1	0	1	8
Bacteria;Bacteria_none;Firmicutes;Tissierellia;Tissierellales;Peptoniphilaceae;Peptoniphilus;Peptoniphilus vaginalis	4	4	0	0	0	0	0	0	8
Bacteria;Bacteria_none;Proteobacteria;Gammaproteobacteria;Enterobacterales;Enterobacteriaceae;Kosakonia;Kosakonia cowanii	5	0	1	2	0	0	0	0	8
Bacteria;Bacteria_none;Actinobacteria;Actinomycetia;Propionibacteriales;Propionibacteriaceae;Propioniferax;Propioniferax innocua	1	1	0	4	0	1	1	0	8
Bacteria;Bacteria_none;Firmicutes;Bacilli;Bacillales;Paenibacillaceae;Paenibacillus;Paenibacillus thermoaerophilus	0	0	6	0	0	2	0	0	8
Bacteria;Bacteria_none;Proteobacteria;Gammaproteobacteria;Thiotrichales;Thiotrichaceae;Leucothrix;Leucothrix mucor	0	7	1	0	0	0	0	0	8
Bacteria;Bacteria_none;Actinobacteria;Actinomycetia;Bifidobacteriales;Bifidobacteriaceae;Aeriscardovia;Aeriscardovia aeriphila	0	1	2	2	1	1	0	1	8
Bacteria;Bacteria_none;Actinobacteria;Actinomycetia;Corynebacteriales;Gordoniaceae;Gordonia;Gordonia lacunae	0	1	2	1	2	0	2	0	8
Bacteria;Bacteria_none;Firmicutes;Bacilli;Lactobacillales;Streptococcaceae;Streptococcus;Streptococcus parauberis	5	0	0	1	0	0	2	0	8
Bacteria;Bacteria_none;Actinobacteria;Actinomycetia;Actinopolysporales;Actinopolysporaceae;Actinopolyspora;Actinopolyspora alba	1	4	3	0	0	0	0	0	8
Bacteria;Bacteria_none;Synergistetes;Synergistia;Synergistales;Synergistaceae;Aminobacterium;Aminobacterium thunnarium	1	5	0	2	0	0	0	0	8
Bacteria;Bacteria_none;Bacteroidota;Bacteroidia;Bacteroidales;Prevotellaceae;Prevotella;Prevotella timonensis	1	6	0	1	0	0	0	0	8
Bacteria;Bacteria_none;Fusobacteria;Fusobacteriia;Fusobacteriales;Leptotrichiaceae;Streptobacillus;Streptobacillus moniliformis	6	0	1	0	0	1	0	0	8
Bacteria;Bacteria_none;Actinobacteria;Actinomycetia;Micrococcales;Beutenbergiaceae;Salana;Salana multivorans	1	2	2	2	0	0	1	0	8
Bacteria;Bacteria_none;Firmicutes;Clostridia;Eubacteriales;Clostridiaceae;Clostridium;Clostridium guangxiense	2	2	0	1	0	2	1	0	8
Bacteria;Bacteria_none;Proteobacteria;Gammaproteobacteria;Vibrionales;Vibrionaceae;Photobacterium;Photobacterium ganghwense	7	1	0	0	0	0	0	0	8
Bacteria;Bacteria_none;Firmicutes;Clostridia;Eubacteriales;Clostridiaceae;Geosporobacter;Geosporobacter ferrireducens	0	0	5	0	0	3	0	0	8
Bacteria;Bacteria_none;Actinobacteria;Actinomycetia;Pseudonocardiales;Pseudonocardiaceae;Actinorectispora;Actinorectispora indica	1	3	2	0	0	0	2	0	8
Bacteria;Bacteria_none;Actinobacteria;Actinomycetia;Micrococcales;Micrococcaceae;Sinomonas;Sinomonas notoginsengisoli	1	1	2	0	0	2	2	0	8
Bacteria;Bacteria_none;Bacteroidota;Bacteroidia;Bacteroidales;Prevotellaceae;Prevotella;Prevotella bergensis	0	2	2	0	1	3	0	0	8
Bacteria;Bacteria_none;Proteobacteria;Alphaproteobacteria;Rhodobacterales;Rhodobacteraceae;Tabrizicola;Tabrizicola algicola	0	8	0	0	0	0	0	0	8
Bacteria;Bacteria_none;Firmicutes;Bacilli;Bacillales;Paenibacillaceae;Paenibacillus;Paenibacillus limicola	0	0	6	0	0	2	0	0	8
Bacteria;Bacteria_none;Actinobacteria;Actinomycetia;Micrococcales;Microbacteriaceae;Agromyces;Agromyces cerinus	0	3	1	4	0	0	0	0	8
Bacteria;Bacteria_none;Proteobacteria;Betaproteobacteria;Burkholderiales;Comamonadaceae;Delftia;Delftia rhizosphaerae	8	0	0	0	0	0	0	0	8
Bacteria;Bacteria_none;Proteobacteria;Alphaproteobacteria;Hyphomicrobiales;Nitrobacteraceae;Rhodopseudomonas;Rhodopseudomonas parapalustris	0	5	1	0	0	1	0	0	7
Bacteria;Bacteria_none;Bacteroidota;Cytophagia;Cytophagales;Hymenobacteraceae;Pontibacter;Pontibacter locisalis	0	0	0	5	1	0	1	0	7
Bacteria;Bacteria_none;Bacteroidota;Sphingobacteriia;Sphingobacteriales;Sphingobacteriaceae;Solitalea;Solitalea canadensis	5	1	0	1	0	0	0	0	7
Bacteria;Bacteria_none;Proteobacteria;Alphaproteobacteria;Hyphomicrobiales;Methylobacteriaceae;Methylobacterium;Methylobacterium trifolii	0	0	0	3	4	0	0	0	7
Bacteria;Bacteria_none;Proteobacteria;Alphaproteobacteria;Rhodospirillales;Acetobacteraceae;Rhodovarius;Rhodovarius crocodyli	4	0	1	2	0	0	0	0	7
Bacteria;Bacteria_none;Proteobacteria;Alphaproteobacteria;Rhodobacterales;Rhodobacteraceae;Rhodovulum;Rhodovulum robiginosum	2	3	2	0	0	0	0	0	7
Bacteria;Bacteria_none;Firmicutes;Clostridia;Thermoanaerobacterales;Thermoanaerobacteraceae;Thermoanaerobacter;Thermoanaerobacter acetoethylicus	2	2	2	1	0	0	0	0	7
Bacteria;Bacteria_none;Proteobacteria;Alphaproteobacteria;Rhodobacterales;Rhodobacteraceae;Pelagovum;Pelagovum pacificum	0	2	2	0	0	3	0	0	7
Bacteria;Bacteria_none;Proteobacteria;Alphaproteobacteria;Hyphomicrobiales;Rhizobiaceae;Rhizobium;Rhizobium borbori	2	2	2	0	0	1	0	0	7
Bacteria;Bacteria_none;Bacteroidota;Cytophagia;Cytophagales;Hymenobacteraceae;Parahymenobacter;Parahymenobacter ocellatus	0	0	2	4	0	0	0	1	7
Bacteria;Bacteria_none;Proteobacteria;Alphaproteobacteria;Rickettsiales;Rickettsiaceae;Orientia;Orientia chuto	0	4	0	3	0	0	0	0	7
Bacteria;Bacteria_none;Proteobacteria;Alphaproteobacteria;Rhodobacterales;Rhodobacteraceae;Paracoccus;Paracoccus hibisci	5	0	1	1	0	0	0	0	7
Bacteria;Bacteria_none;Actinobacteria;Actinomycetia;Actinomycetales;Actinomycetaceae;Actinomyces;Actinomyces haliotis	0	2	5	0	0	0	0	0	7
Bacteria;Bacteria_none;Proteobacteria;Alphaproteobacteria;Rhodospirillales;Acetobacteraceae;Roseomonas;Roseomonas suffusca	7	0	0	0	0	0	0	0	7
Bacteria;Bacteria_none;Proteobacteria;Alphaproteobacteria;Rhodospirillales;Acetobacteraceae;Acetobacter;Acetobacter peroxydans	7	0	0	0	0	0	0	0	7
Bacteria;Bacteria_none;Proteobacteria;Deltaproteobacteria;Desulfobacterales;Desulfobacteraceae;Desulfosarcina;Desulfosarcina alkanivorans	0	5	0	0	2	0	0	0	7
Bacteria;Bacteria_none;Proteobacteria;Alphaproteobacteria;Rhodospirillales;Acetobacteraceae;Roseomonas;Roseomonas arctica	1	2	0	1	1	2	0	0	7
Bacteria;Bacteria_none;Proteobacteria;Alphaproteobacteria;Hyphomicrobiales;Nitrobacteraceae;Tardiphaga;Tardiphaga robiniae	2	0	0	4	0	1	0	0	7
Bacteria;Bacteria_none;Proteobacteria;Alphaproteobacteria;Hyphomicrobiales;Devosiaceae;Maritalea;Maritalea mobilis	3	1	1	0	0	1	1	0	7
Bacteria;Bacteria_none;Proteobacteria;Alphaproteobacteria;Rhodobacterales;Rhodobacteraceae;Paracoccus;Paracoccus kondratievae	1	3	2	1	0	0	0	0	7
Bacteria;Bacteria_none;Proteobacteria;Alphaproteobacteria;Hyphomicrobiales;Methylobacteriaceae;Methylobacterium;Methylobacterium hispanicum	3	4	0	0	0	0	0	0	7
Bacteria;Bacteria_none;Proteobacteria;Alphaproteobacteria;Hyphomicrobiales;Hyphomicrobiaceae;Hyphomicrobium;Hyphomicrobium hollandicum	0	3	1	1	0	2	0	0	7
Bacteria;Bacteria_none;Proteobacteria;Alphaproteobacteria;Hyphomicrobiales;Methylobacteriaceae;Microvirga;Microvirga lotononidis	0	0	7	0	0	0	0	0	7
Bacteria;Bacteria_none;Bacteroidota;Flavobacteriia;Flavobacteriales;Flavobacteriaceae;Aequorivita;Aequorivita sublithincola	1	1	2	2	0	0	1	0	7
Bacteria;Bacteria_none;Proteobacteria;Alphaproteobacteria;Rhodobacterales;Rhodobacteraceae;Pseudogemmobacter;Pseudogemmobacter bohemicus	3	4	0	0	0	0	0	0	7
Bacteria;Bacteria_none;Proteobacteria;Alphaproteobacteria;Rhodospirillales;Acetobacteraceae;Sabulicella;Sabulicella rubraurantiaca	1	1	2	1	1	1	0	0	7
Bacteria;Bacteria_none;Proteobacteria;Alphaproteobacteria;Hyphomicrobiales;Methylocystaceae;Methylocystis;Methylocystis bryophila	1	1	2	2	1	0	0	0	7
Bacteria;Bacteria_none;Proteobacteria;Alphaproteobacteria;Rhodospirillales;Rhodospirillaceae;Novispirillum;Novispirillum itersonii	2	1	0	2	1	1	0	0	7
Bacteria;Bacteria_none;Proteobacteria;Alphaproteobacteria;Caulobacterales;Caulobacteraceae;Phenylobacterium;Phenylobacterium aquaticum	4	0	0	3	0	0	0	0	7
Bacteria;Bacteria_none;Firmicutes;Clostridia;Thermoanaerobacterales;Thermoanaerobacteraceae;Thermoanaerobacter;Thermoanaerobacter ethanolicus	0	2	1	4	0	0	0	0	7
Bacteria;Bacteria_none;Bacteroidota;Flavobacteriia;Flavobacteriales;Flavobacteriaceae;Flavobacterium;Flavobacterium tistrianum	0	0	0	0	0	7	0	0	7
Bacteria;Bacteria_none;Proteobacteria;Betaproteobacteria;Burkholderiales;Burkholderiales_Incertae_sedis;Aquabacterium;Aquabacterium terrae	6	1	0	0	0	0	0	0	7
Bacteria;Bacteria_none;Actinobacteria;Actinomycetia;Corynebacteriales;Mycobacteriaceae;Mycobacterium;Mycobacterium hodleri	1	2	1	3	0	0	0	0	7
Bacteria;Bacteria_none;Proteobacteria;Betaproteobacteria;Burkholderiales;Burkholderiales_Incertae_sedis;Rivibacter;Rivibacter subsaxonicus	7	0	0	0	0	0	0	0	7
Bacteria;Bacteria_none;Elusimicrobia;Endomicrobia;Endomicrobiales;Endomicrobiaceae;Endomicrobium;Endomicrobium proavitum	4	3	0	0	0	0	0	0	7
Bacteria;Bacteria_none;Proteobacteria;Betaproteobacteria;Burkholderiales;Sphaerotilaceae;Schlegelella;Schlegelella aquatica	7	0	0	0	0	0	0	0	7
Bacteria;Bacteria_none;Firmicutes;Bacilli;Bacillales;Bacillaceae;Bacillus;Bacillus fengqiuensis	0	2	0	0	5	0	0	0	7
Bacteria;Bacteria_none;Firmicutes;Negativicutes;Selenomonadales;Sporomusaceae;Methylomusa;Methylomusa anaerophila	0	2	2	2	1	0	0	0	7
Bacteria;Bacteria_none;Proteobacteria;Betaproteobacteria;Burkholderiales;Comamonadaceae;Comamonas;Comamonas humi	7	0	0	0	0	0	0	0	7
Bacteria;Bacteria_none;Bacteroidota;Bacteroidia;Bacteroidales;Prevotellaceae;Prevotella;Prevotella illustrans	0	2	0	0	0	0	0	5	7
Bacteria;Bacteria_none;Fusobacteria;Fusobacteriia;Fusobacteriales;Fusobacteriaceae;Cetobacterium;Cetobacterium somerae	5	1	0	1	0	0	0	0	7
Bacteria;Bacteria_none;Bacteroidota;Bacteroidia;Bacteroidales;Prevotellaceae;Prevotella;Prevotella buccalis	0	3	0	3	0	0	1	0	7
Bacteria;Bacteria_none;Proteobacteria;Betaproteobacteria;Burkholderiales;Comamonadaceae;Hydrogenophaga;Hydrogenophaga aquatica	4	0	0	2	0	1	0	0	7
Bacteria;Bacteria_none;Bacteroidota;Bacteroidia;Bacteroidales;Porphyromonadaceae;Porphyromonas;Porphyromonas somerae	0	7	0	0	0	0	0	0	7
Bacteria;Bacteria_none;Proteobacteria;Betaproteobacteria;Burkholderiales;Comamonadaceae;Malikia;Malikia granosa	7	0	0	0	0	0	0	0	7
Bacteria;Bacteria_none;Proteobacteria;Betaproteobacteria;Burkholderiales;Sphaerotilaceae;Aquincola;Aquincola tertiaricarbonis	3	1	1	0	0	2	0	0	7
Bacteria;Bacteria_none;Firmicutes;Negativicutes;Veillonellales;Veillonellaceae;Colibacter;Colibacter massiliensis	1	0	1	3	0	0	2	0	7
Bacteria;Bacteria_none;Proteobacteria;Betaproteobacteria;Burkholderiales;Oxalobacteraceae;Pseudoduganella;Pseudoduganella violacea	5	0	1	0	1	0	0	0	7
Bacteria;Bacteria_none;Proteobacteria;Alphaproteobacteria;Hyphomicrobiales;Phyllobacteriaceae;Zhengella;Zhengella mangrovi	5	0	0	1	0	1	0	0	7
Bacteria;Bacteria_none;Bacteroidota;Bacteroidia;Bacteroidales;Odoribacteraceae;Odoribacter;Odoribacter laneus	0	0	0	7	0	0	0	0	7
Bacteria;Bacteria_none;Bacteroidota;Flavobacteriia;Flavobacteriales;Weeksellaceae;Empedobacter;Empedobacter falsenii	7	0	0	0	0	0	0	0	7
Bacteria;Bacteria_none;Proteobacteria;Alphaproteobacteria;Hyphomicrobiales;Rhizobiaceae;Endobacterium;Endobacterium yantingense	0	0	1	4	1	0	0	1	7
Bacteria;Bacteria_none;Proteobacteria;Betaproteobacteria;Burkholderiales;Comamonadaceae;Ramlibacter;Ramlibacter rhizophilus	4	3	0	0	0	0	0	0	7
Bacteria;Bacteria_none;Bacteroidota;Bacteroidia;Bacteroidales;Bacteroidaceae;Bacteroides;Bacteroides zoogleoformans	0	0	0	4	0	1	1	1	7
Bacteria;Bacteria_none;Bacteroidota;Bacteroidia;Bacteroidales;Bacteroidaceae;Bacteroides;Bacteroides stercoris	0	0	0	6	0	0	0	1	7
Bacteria;Bacteria_none;Proteobacteria;Betaproteobacteria;Burkholderiales;Comamonadaceae;Variovorax;Variovorax ureilyticus	5	1	0	1	0	0	0	0	7
Bacteria;Bacteria_none;Proteobacteria;Alphaproteobacteria;Hyphomicrobiales;Rhodovibrionaceae;Rhodovibrio;Rhodovibrio sodomensis	0	0	3	3	0	1	0	0	7
Bacteria;Bacteria_none;Proteobacteria;Betaproteobacteria;Burkholderiales;Oxalobacteraceae;Janthinobacterium;Janthinobacterium rivuli	5	2	0	0	0	0	0	0	7
Bacteria;Bacteria_none;Actinobacteria;Actinomycetia;Corynebacteriales;Gordoniaceae;Gordonia;Gordonia crocea	0	3	0	4	0	0	0	0	7
Bacteria;Bacteria_none;Actinobacteria;Coriobacteriia;Eggerthellales;Eggerthellaceae;Raoultibacter;Raoultibacter massiliensis	0	0	3	1	0	0	0	3	7
Bacteria;Bacteria_none;Proteobacteria;Alphaproteobacteria;Hyphomicrobiales;Chelatococcaceae;Chelatococcus;Chelatococcus composti	2	0	5	0	0	0	0	0	7
Bacteria;Bacteria_none;Proteobacteria;Alphaproteobacteria;Hyphomicrobiales;Phyllobacteriaceae;Nitratireductor;Nitratireductor aestuarii	1	0	1	4	1	0	0	0	7
Bacteria;Bacteria_none;Bacteroidota;Chitinophagia;Chitinophagales;Chitinophagaceae;Parafilimonas;Parafilimonas terrae	6	0	1	0	0	0	0	0	7
Bacteria;Bacteria_none;Proteobacteria;Alphaproteobacteria;Sphingomonadales;Erythrobacteraceae;Croceicoccus;Croceicoccus estronivorus	0	1	2	3	1	0	0	0	7
Bacteria;Bacteria_none;Proteobacteria;Alphaproteobacteria;Sphingomonadales;Sphingomonadaceae;Novosphingobium;Novosphingobium fluoreni	2	1	2	2	0	0	0	0	7
Bacteria;Bacteria_none;Proteobacteria;Alphaproteobacteria;Sphingomonadales;Sphingomonadaceae;Novosphingobium;Novosphingobium umbonatum	0	5	1	1	0	0	0	0	7
Bacteria;Bacteria_none;Proteobacteria;Alphaproteobacteria;Hyphomicrobiales;Beijerinckiaceae;Pseudochelatococcus;Pseudochelatococcus lubricantis	0	5	0	1	0	0	1	0	7
Bacteria;Bacteria_none;Actinobacteria;Actinomycetia;Actinomycetales;Actinomycetaceae;Actinomyces;Actinomyces marseillensis	0	0	0	7	0	0	0	0	7
Bacteria;Bacteria_none;Proteobacteria;Alphaproteobacteria;Sphingomonadales;Sphingomonadaceae;Rhizorhabdus;Rhizorhabdus wittichii	4	1	0	2	0	0	0	0	7
Bacteria;Bacteria_none;Proteobacteria;Alphaproteobacteria;Rhodobacterales;Rhodobacteraceae;Paracoccus;Paracoccus aquimaris	4	0	0	1	0	0	2	0	7
Bacteria;Bacteria_none;Firmicutes;Bacilli;Bacillales;Bacillaceae;Evansella;Evansella clarkii	0	0	7	0	0	0	0	0	7
Bacteria;Bacteria_none;Proteobacteria;Alphaproteobacteria;Hyphomicrobiales;Bartonellaceae;Bartonella;Bartonella bacilliformis	3	2	0	2	0	0	0	0	7
Bacteria;Bacteria_none;Proteobacteria;Alphaproteobacteria;Sphingomonadales;Sphingomonadaceae;Sphingomonas;Sphingomonas daechungensis	1	5	0	1	0	0	0	0	7
Bacteria;Bacteria_none;Actinobacteria;Actinomycetia;Streptosporangiales;Thermomonosporaceae;Actinomadura;Actinomadura rugatobispora	1	4	1	0	1	0	0	0	7
Bacteria;Bacteria_none;Proteobacteria;Alphaproteobacteria;Hyphomicrobiales;Aurantimonadaceae;Aureimonas;Aureimonas mangrovi	1	3	0	3	0	0	0	0	7
Bacteria;Bacteria_none;Cyanobacteria;Cyanobacteria_Incertae_sedis;Oscillatoriales;Oscillatoriales_Incertae_sedis;Ancylothrix;Ancylothrix rivularis	1	2	2	2	0	0	0	0	7
Bacteria;Bacteria_none;Proteobacteria;Betaproteobacteria;Nitrosomonadales;Sterolibacteriaceae;Methyloversatilis;Methyloversatilis universalis	7	0	0	0	0	0	0	0	7
Bacteria;Bacteria_none;Actinobacteria;Actinomycetia;Corynebacteriales;Corynebacteriaceae;Corynebacterium;Corynebacterium urealyticum	2	2	0	1	1	0	0	1	7
Bacteria;Bacteria_none;Bacteroidota;Chitinophagia;Chitinophagales;Chitinophagaceae;Ginsengibacter;Ginsengibacter hankyongi	1	2	0	2	0	0	0	2	7
Bacteria;Bacteria_none;Actinobacteria;Actinomycetia;Corynebacteriales;Corynebacteriaceae;Corynebacterium;Corynebacterium ureicelerivorans	0	0	3	4	0	0	0	0	7
Bacteria;Bacteria_none;Proteobacteria;Alphaproteobacteria;Caulobacterales;Caulobacteraceae;Phenylobacterium;Phenylobacterium terrae	2	1	0	2	0	2	0	0	7
Bacteria;Bacteria_none;Actinobacteria;Coriobacteriia;Coriobacteriales;Atopobiaceae;Parafannyhessea;Parafannyhessea umbonata	1	6	0	0	0	0	0	0	7
Bacteria;Bacteria_none;Cyanobacteria;Cyanobacteria_Incertae_sedis;Pseudanabaenales;Leptolyngbyaceae;Chroakolemma;Chroakolemma opaca	0	4	3	0	0	0	0	0	7
Bacteria;Bacteria_none;Proteobacteria;Alphaproteobacteria;Hyphomicrobiales;Phyllobacteriaceae;Mesorhizobium;Mesorhizobium huakuii	7	0	0	0	0	0	0	0	7
Bacteria;Bacteria_none;Proteobacteria;Betaproteobacteria;Burkholderiales;Alcaligenaceae;Bordetella;Bordetella holmesii	3	0	2	0	0	0	2	0	7
Bacteria;Bacteria_none;Proteobacteria;Betaproteobacteria;Burkholderiales;Alcaligenaceae;Parapusillimonas;Parapusillimonas granuli	0	0	1	4	0	1	1	0	7
Bacteria;Bacteria_none;Firmicutes;Erysipelotrichia;Erysipelotrichales;Erysipelotrichaceae;Massilicoli;Massilicoli timonensis	0	0	0	4	0	1	2	0	7
Bacteria;Bacteria_none;Planctomycetota;Planctomycetia;Pirellulales;Pirellulaceae;Rosistilla;Rosistilla oblonga	0	7	0	0	0	0	0	0	7
Bacteria;Bacteria_none;Proteobacteria;Betaproteobacteria;Burkholderiales;Burkholderiaceae;Paraburkholderia;Paraburkholderia sartisoli	4	1	1	0	0	1	0	0	7
Bacteria;Bacteria_none;Proteobacteria;Betaproteobacteria;Burkholderiales;Comamonadaceae;Comamonas;Comamonas aquatilis	3	3	0	0	0	0	0	1	7
Bacteria;Bacteria_none;Actinobacteria;Actinomycetia;Streptosporangiales;Streptosporangiaceae;Nonomuraea;Nonomuraea roseola	0	2	4	0	0	0	0	1	7
Bacteria;Bacteria_none;Firmicutes;Bacilli;Lactobacillales;Lactobacillaceae;Lentilactobacillus;Lentilactobacillus parabuchneri	3	4	0	0	0	0	0	0	7
Bacteria;Bacteria_none;Acidobacteria;Acidobacteriia;Acidobacteriales;Acidobacteriaceae;Silvibacterium;Silvibacterium dinghuense	0	1	1	3	0	0	0	2	7
Bacteria;Bacteria_none;Firmicutes;Clostridia;Eubacteriales;Eubacteriales Family XIII. Incertae Sedis;Mogibacterium;Mogibacterium pumilum	1	1	0	3	1	0	1	0	7
Bacteria;Bacteria_none;Actinobacteria;Actinomycetia;Streptomycetales;Streptomycetaceae;Streptomyces;Streptomyces gardneri	0	0	0	6	0	1	0	0	7
Bacteria;Bacteria_none;Firmicutes;Bacilli;Lactobacillales;Streptococcaceae;Streptococcus;Streptococcus ruminantium	7	0	0	0	0	0	0	0	7
Bacteria;Bacteria_none;Proteobacteria;Gammaproteobacteria;Xanthomonadales;Xanthomonadaceae;Lysobacter;Lysobacter zhanggongensis	4	2	0	1	0	0	0	0	7
Bacteria;Bacteria_none;Proteobacteria;Gammaproteobacteria;Oceanospirillales;Halomonadaceae;Halomonas;Halomonas tabrizica	3	3	1	0	0	0	0	0	7
Bacteria;Bacteria_none;Actinobacteria;Actinomycetia;Streptomycetales;Streptomycetaceae;Streptomyces;Streptomyces polyasparticus	0	0	0	7	0	0	0	0	7
Bacteria;Bacteria_none;Actinobacteria;Actinomycetia;Corynebacteriales;Mycobacteriaceae;Mycolicibacterium;Mycolicibacterium vinylchloridicum	0	4	3	0	0	0	0	0	7
Bacteria;Bacteria_none;Proteobacteria;Gammaproteobacteria;Pseudomonadales;Pseudomonadaceae;Pseudomonas;Pseudomonas syringae	3	0	2	2	0	0	0	0	7
Bacteria;Bacteria_none;Proteobacteria;Gammaproteobacteria;Xanthomonadales;Xanthomonadaceae;Lysobacter;Lysobacter enzymogenes	4	0	1	2	0	0	0	0	7
Bacteria;Bacteria_none;Proteobacteria;Gammaproteobacteria;Oceanospirillales;Hahellaceae;Allohahella;Allohahella marinimesophila	0	5	0	2	0	0	0	0	7
Bacteria;Bacteria_none;Firmicutes;Clostridia;Eubacteriales;Clostridiaceae;Inconstantimicrobium;Inconstantimicrobium porci	0	2	3	0	0	2	0	0	7
Bacteria;Bacteria_none;Firmicutes;Bacilli;Lactobacillales;Streptococcaceae;Streptococcus;Streptococcus peroris	4	0	0	2	0	1	0	0	7
Bacteria;Bacteria_none;Proteobacteria;Gammaproteobacteria;Aeromonadales;Aeromonadaceae;Aeromonas;Aeromonas aquatilis	3	3	0	1	0	0	0	0	7
Bacteria;Bacteria_none;Proteobacteria;Gammaproteobacteria;Enterobacterales;Pectobacteriaceae;Dickeya;Dickeya solani	3	0	0	4	0	0	0	0	7
Bacteria;Bacteria_none;Firmicutes;Bacilli;Bacillales;Bacillaceae;Oceanobacillus;Oceanobacillus caeni	1	1	5	0	0	0	0	0	7
Bacteria;Bacteria_none;Actinobacteria;Actinomycetia;Streptomycetales;Streptomycetaceae;Streptomyces;Streptomyces scopiformis	0	6	1	0	0	0	0	0	7
Bacteria;Bacteria_none;Firmicutes;Bacilli;Lactobacillales;Lactobacillaceae;Ligilactobacillus;Ligilactobacillus murinus	0	2	2	1	1	1	0	0	7
Bacteria;Bacteria_none;Proteobacteria;Gammaproteobacteria;Xanthomonadales;Xanthomonadaceae;Thermomonas;Thermomonas carbonis	1	4	1	1	0	0	0	0	7
Bacteria;Bacteria_none;Firmicutes;Clostridia;Eubacteriales;Lachnospiraceae;Eisenbergiella;Eisenbergiella porci	0	0	6	1	0	0	0	0	7
Bacteria;Bacteria_none;Proteobacteria;Gammaproteobacteria;Xanthomonadales;Xanthomonadaceae;Lysobacter;Lysobacter agri	4	0	2	0	0	0	1	0	7
Bacteria;Bacteria_none;Proteobacteria;Gammaproteobacteria;Aeromonadales;Aeromonadaceae;Pseudaeromonas;Pseudaeromonas paramecii	1	0	3	2	0	1	0	0	7
Bacteria;Bacteria_none;Actinobacteria;Actinomycetia;Micromonosporales;Micromonosporaceae;Micromonospora;Micromonospora violae	0	2	1	2	0	0	0	2	7
Bacteria;Bacteria_none;Actinobacteria;Actinomycetia;Pseudonocardiales;Pseudonocardiaceae;Pseudonocardia;Pseudonocardia cytotoxica	0	1	0	0	0	0	0	6	7
Bacteria;Bacteria_none;Firmicutes;Bacilli;Bacillales;Bacillaceae;Neobacillus;Neobacillus fumarioli	0	0	0	4	0	0	3	0	7
Bacteria;Bacteria_none;Firmicutes;Clostridia;Eubacteriales;Clostridiaceae;Clostridium;Clostridium chrysemydis	3	1	0	2	0	1	0	0	7
Bacteria;Bacteria_none;Proteobacteria;Gammaproteobacteria;Enterobacterales;Yersiniaceae;Serratia;Serratia symbiotica	6	1	0	0	0	0	0	0	7
Bacteria;Bacteria_none;Actinobacteria;Actinomycetia;Propionibacteriales;Propionibacteriaceae;Auraticoccus;Auraticoccus monumenti	1	1	1	2	1	0	1	0	7
Bacteria;Bacteria_none;Firmicutes;Bacilli;Bacillales;Bacillaceae;Salimicrobium;Salimicrobium album	0	1	6	0	0	0	0	0	7
Bacteria;Bacteria_none;Firmicutes;Bacilli;Bacillales;Thermoactinomycetaceae;Salinithrix;Salinithrix halophila	0	0	1	1	1	4	0	0	7
Bacteria;Bacteria_none;Proteobacteria;Oligoflexia;Oligoflexales;Pseudobacteriovoracaceae;Pseudobacteriovorax;Pseudobacteriovorax antillogorgiicola	3	4	0	0	0	0	0	0	7
Bacteria;Bacteria_none;Proteobacteria;Deltaproteobacteria;Syntrophobacterales;Syntrophobacteraceae;Syntrophobacter;Syntrophobacter pfennigii	0	0	4	0	3	0	0	0	7
Bacteria;Bacteria_none;Actinobacteria;Actinomycetia;Streptomycetales;Streptomycetaceae;Streptomyces;Streptomyces lavendulocolor	1	4	1	1	0	0	0	0	7
Bacteria;Bacteria_none;Proteobacteria;Gammaproteobacteria;Enterobacterales;Erwiniaceae;Tatumella;Tatumella citrea	6	0	0	0	0	0	1	0	7
Bacteria;Bacteria_none;Firmicutes;Clostridia;Eubacteriales;Clostridiaceae;Clostridium;Clostridium swellfunianum	1	2	1	3	0	0	0	0	7
Bacteria;Bacteria_none;Actinobacteria;Actinomycetia;Micrococcales;Micrococcaceae;Arthrobacter;Arthrobacter roseus	0	3	0	0	1	1	1	1	7
Bacteria;Bacteria_none;Firmicutes;Bacilli;Bacillales;Bacillaceae;Peribacillus;Peribacillus simplex	0	0	0	0	0	7	0	0	7
Bacteria;Bacteria_none;Firmicutes;Bacilli;Lactobacillales;Carnobacteriaceae;Granulicatella;Granulicatella balaenopterae	2	1	1	2	0	0	0	1	7
Bacteria;Bacteria_none;Proteobacteria;Epsilonproteobacteria;Campylobacterales;Arcobacteraceae;Aliarcobacter;[Arcobacter] porcinus	1	0	3	1	0	1	1	0	7
Bacteria;Bacteria_none;Actinobacteria;Actinomycetia;Streptomycetales;Streptomycetaceae;Streptomyces;Streptomyces narbonensis	0	1	3	3	0	0	0	0	7
Bacteria;Bacteria_none;Proteobacteria;Gammaproteobacteria;Enterobacterales;Morganellaceae;Proteus;Proteus penneri	5	0	0	0	0	0	0	2	7
Bacteria;Bacteria_none;Firmicutes;Bacilli;Lactobacillales;Lactobacillaceae;Lactobacillus;Lactobacillus kitasatonis	5	0	0	0	1	1	0	0	7
Bacteria;Bacteria_none;Firmicutes;Bacilli;Lactobacillales;Enterococcaceae;Enterococcus;Enterococcus alcedinis	5	1	1	0	0	0	0	0	7
Bacteria;Bacteria_none;Firmicutes;Clostridia;Eubacteriales;Heliobacteriaceae;Heliorestis;Heliorestis acidaminivorans	0	0	0	4	0	3	0	0	7
Bacteria;Bacteria_none;Proteobacteria;Gammaproteobacteria;Enterobacterales;Pectobacteriaceae;Dickeya;Dickeya chrysanthemi	6	0	0	0	0	0	1	0	7
Bacteria;Bacteria_none;Actinobacteria;Actinomycetia;Propionibacteriales;Propionibacteriaceae;Tessaracoccus;Tessaracoccus lapidicaptus	1	1	3	2	0	0	0	0	7
Bacteria;Bacteria_none;Firmicutes;Bacilli;Lactobacillales;Carnobacteriaceae;Allofustis;Allofustis seminis	3	1	0	0	1	0	0	2	7
Bacteria;Bacteria_none;Proteobacteria;Gammaproteobacteria;Xanthomonadales;Xanthomonadaceae;Pseudoxanthomonas;Pseudoxanthomonas koreensis	1	0	2	2	0	0	0	2	7
Bacteria;Bacteria_none;Proteobacteria;Gammaproteobacteria;Xanthomonadales;Xanthomonadaceae;Pseudoxanthomonas;Pseudoxanthomonas kalamensis	4	0	0	2	0	0	1	0	7
Bacteria;Bacteria_none;Proteobacteria;Gammaproteobacteria;Xanthomonadales;Xanthomonadaceae;Pseudoxanthomonas;Pseudoxanthomonas icgebensis	3	1	0	3	0	0	0	0	7
Bacteria;Bacteria_none;Firmicutes;Bacilli;Bacillales;Paenibacillaceae;Paenibacillus;Paenibacillus naphthalenovorans	0	1	3	0	3	0	0	0	7
Bacteria;Bacteria_none;Proteobacteria;Deltaproteobacteria;Myxococcales;Polyangiaceae;Polyangium;Polyangium aurulentum	5	2	0	0	0	0	0	0	7
Bacteria;Bacteria_none;Spirochaetes;Spirochaetia;Spirochaetales;Spirochaetaceae;Sediminispirochaeta;Sediminispirochaeta sinaica	0	4	2	0	0	0	0	1	7
Bacteria;Bacteria_none;Firmicutes;Bacilli;Lactobacillales;Streptococcaceae;Streptococcus;Streptococcus vaginalis	6	1	0	0	0	0	0	0	7
Bacteria;Bacteria_none;Spirochaetes;Spirochaetia;Spirochaetales;Spirochaetaceae;Spirochaeta;Spirochaeta aurantia	1	4	1	0	0	0	1	0	7
Bacteria;Bacteria_none;Firmicutes;Bacilli;Bacillales;Paenibacillaceae;Paenibacillus;Paenibacillus lactis	0	0	0	0	2	5	0	0	7
Bacteria;Bacteria_none;Proteobacteria;Gammaproteobacteria;Pasteurellales;Pasteurellaceae;Gallibacterium;Gallibacterium salpingitidis	7	0	0	0	0	0	0	0	7
Bacteria;Bacteria_none;Actinobacteria;Actinomycetia;Micrococcales;Microbacteriaceae;Microbacterium;Microbacterium sediminis	0	0	1	6	0	0	0	0	7
Bacteria;Bacteria_none;Firmicutes;Bacilli;Bacillales;Bacillaceae;Pseudogracilibacillus;Pseudogracilibacillus auburnensis	0	0	2	0	0	5	0	0	7
Bacteria;Bacteria_none;Verrucomicrobia;Verrucomicrobiae;Verrucomicrobiales;Verrucomicrobiaceae;Fucophilus;Fucophilus fucoidanolyticus	1	6	0	0	0	0	0	0	7
Bacteria;Bacteria_none;Firmicutes;Bacilli;Bacillales;Bacillaceae;Mesobacillus;Mesobacillus jeotgali	0	7	0	0	0	0	0	0	7
Bacteria;Bacteria_none;Firmicutes;Clostridia;Eubacteriales;Eubacteriaceae;Eubacterium;Eubacterium ventriosum	1	1	0	2	3	0	0	0	7
Bacteria;Bacteria_none;Firmicutes;Clostridia;Eubacteriales;Clostridiaceae;Clostridium;Clostridium indicum	0	3	3	0	0	1	0	0	7
Bacteria;Bacteria_none;Firmicutes;Clostridia;Eubacteriales;Clostridiaceae;Clostridium;Clostridium minihomine	0	4	1	0	1	0	1	0	7
Bacteria;Bacteria_none;Firmicutes;Clostridia;Eubacteriales;Clostridiaceae;Clostridium;Clostridium haemolyticum	0	1	1	2	1	0	2	0	7
Bacteria;Bacteria_none;Actinobacteria;Actinomycetia;Micrococcales;Cellulomonadaceae;Cellulomonas;Cellulomonas phragmiteti	2	2	1	0	2	0	0	0	7
Bacteria;Bacteria_none;Verrucomicrobia;Opitutae;Opitutales;Opitutaceae;Ereboglobus;Ereboglobus luteus	0	3	3	0	1	0	0	0	7
Bacteria;Bacteria_none;Firmicutes;Bacilli;Lactobacillales;Lactobacillaceae;Acetilactobacillus;Acetilactobacillus jinshanensis	2	0	0	1	1	2	0	1	7
Bacteria;Bacteria_none;Proteobacteria;Deltaproteobacteria;Desulfovibrionales;Desulfovibrionaceae;Desulfovibrio;Desulfovibrio sulfodismutans	0	5	2	0	0	0	0	0	7
Bacteria;Bacteria_none;Firmicutes;Bacilli;Bacillales;Paenibacillaceae;Cohnella;Cohnella nanjingensis	0	0	7	0	0	0	0	0	7
Bacteria;Bacteria_none;Actinobacteria;Actinomycetia;Micrococcales;Microbacteriaceae;Microbacterium;Microbacterium ginsengisoli	0	0	0	7	0	0	0	0	7
Bacteria;Bacteria_none;Firmicutes;Clostridia;Eubacteriales;Eubacteriaceae;Eubacterium;Eubacterium maltosivorans	0	4	1	0	2	0	0	0	7
Bacteria;Bacteria_none;Proteobacteria;Gammaproteobacteria;Legionellales;Legionellaceae;Legionella;Legionella massiliensis	0	1	4	2	0	0	0	0	7
Bacteria;Bacteria_none;Firmicutes;Bacilli;Lactobacillales;Lactobacillaceae;Paucilactobacillus;Paucilactobacillus suebicus	2	4	0	1	0	0	0	0	7
Bacteria;Bacteria_none;Actinobacteria;Actinomycetia;Streptosporangiales;Nocardiopsaceae;Streptomonospora;Streptomonospora tuzyakensis	0	4	0	3	0	0	0	0	7
Bacteria;Bacteria_none;Proteobacteria;Gammaproteobacteria;Methylococcales;Methylococcaceae;Methylomicrobium;Methylomicrobium agile	4	1	0	0	0	2	0	0	7
Bacteria;Bacteria_none;Actinobacteria;Actinomycetia;Propionibacteriales;Nocardioidaceae;Aeromicrobium;Aeromicrobium flavum	0	2	0	4	0	0	0	1	7
Bacteria;Bacteria_none;Firmicutes;Clostridia;Eubacteriales;Clostridiales Family XVII. Incertae Sedis;Thermaerobacter;Thermaerobacter nagasakiensis	0	0	5	2	0	0	0	0	7
Bacteria;Bacteria_none;Proteobacteria;Deltaproteobacteria;Desulfovibrionales;Desulfomicrobiaceae;Desulfomicrobium;Desulfomicrobium apsheronum	0	0	5	0	0	0	0	2	7
Bacteria;Bacteria_none;Actinobacteria;Actinomycetia;Propionibacteriales;Nocardioidaceae;Nocardioides;Nocardioides pacificus	0	2	2	2	0	0	1	0	7
Bacteria;Bacteria_none;Proteobacteria;Gammaproteobacteria;Moraxellales;Moraxellaceae;Acinetobacter;Acinetobacter harbinensis	1	1	0	5	0	0	0	0	7
Bacteria;Bacteria_none;Firmicutes;Bacilli;Lactobacillales;Enterococcaceae;Enterococcus;Enterococcus saigonensis	4	1	0	2	0	0	0	0	7
Bacteria;Bacteria_none;Firmicutes;Bacilli;Lactobacillales;Enterococcaceae;Enterococcus;Enterococcus ratti	7	0	0	0	0	0	0	0	7
Bacteria;Bacteria_none;Firmicutes;Clostridia;Eubacteriales;Lachnospiraceae;Mediterraneibacter;Mediterraneibacter massiliensis	1	0	2	1	0	3	0	0	7
Bacteria;Bacteria_none;Proteobacteria;Deltaproteobacteria;Desulfovibrionales;Desulfonatronaceae;Desulfonatronum;Desulfonatronum lacustre	7	0	0	0	0	0	0	0	7
Bacteria;Bacteria_none;Firmicutes;Bacilli;Bacillales;Planococcaceae;Ureibacillus;Ureibacillus acetophenoni	0	1	5	1	0	0	0	0	7
Bacteria;Bacteria_none;Actinobacteria;Actinomycetia;Streptomycetales;Streptomycetaceae;Streptomyces;Streptomyces vastus	0	4	1	1	0	0	0	1	7
Bacteria;Bacteria_none;Actinobacteria;Actinomycetia;Micrococcales;Microbacteriaceae;Microbacterium;Microbacterium saperdae	1	3	3	0	0	0	0	0	7
Bacteria;Bacteria_none;Firmicutes;Bacilli;Bacillales;Bacillaceae;Mesobacillus;Mesobacillus maritimus	0	0	0	0	0	0	7	0	7
Bacteria;Bacteria_none;Proteobacteria;Gammaproteobacteria;Legionellales;Legionellaceae;Legionella;Legionella birminghamensis	2	0	1	2	1	1	0	0	7
Bacteria;Bacteria_none;Firmicutes;Clostridia;Eubacteriales;Clostridiaceae;Clostridium;Clostridium liquoris	3	1	1	1	0	0	0	1	7
Bacteria;Bacteria_none;Proteobacteria;Gammaproteobacteria;Chromatiales;Ectothiorhodospiraceae;Alkalilimnicola;Alkalilimnicola ehrlichii	5	0	2	0	0	0	0	0	7
Bacteria;Bacteria_none;Proteobacteria;Deltaproteobacteria;Desulfovibrionales;Desulfovibrionaceae;Paucidesulfovibrio;Paucidesulfovibrio capillatus	0	0	7	0	0	0	0	0	7
Bacteria;Bacteria_none;Firmicutes;Bacilli;Bacillales;Paenibacillaceae;Paenibacillus;Paenibacillus paridis	0	0	2	0	0	4	0	0	6
Bacteria;Bacteria_none;Cyanobacteria;Cyanobacteria_Incertae_sedis;Chroococcales;Aphanothecaceae;Gloeothece;Gloeothece tepidariorum	0	3	0	3	0	0	0	0	6
Bacteria;Bacteria_none;Actinobacteria;Actinomycetia;Corynebacteriales;Corynebacteriaceae;Corynebacterium;Corynebacterium massiliense	1	2	1	1	1	0	0	0	6
Bacteria;Bacteria_none;Firmicutes;Bacilli;Bacillales;Bacillaceae;Alteribacillus;Alteribacillus bidgolensis	0	0	0	6	0	0	0	0	6
Bacteria;Bacteria_none;Bacteroidota;Cytophagia;Cytophagales;Cytophagaceae;Spirosoma;Spirosoma montaniterrae	2	0	0	4	0	0	0	0	6
Bacteria;Bacteria_none;Firmicutes;Clostridia;Eubacteriales;Lachnospiraceae;Enterocloster;Enterocloster aldenensis	1	0	0	4	0	1	0	0	6
Bacteria;Bacteria_none;Proteobacteria;Alphaproteobacteria;Rhodobacterales;Roseobacteraceae;Roseivivax;Roseivivax isoporae	1	4	0	0	0	1	0	0	6
Bacteria;Bacteria_none;Proteobacteria;Gammaproteobacteria;Chromatiales;Chromatiaceae;Thiorhodococcus;Thiorhodococcus modestalkaliphilus	2	0	2	0	0	2	0	0	6
Bacteria;Bacteria_none;Proteobacteria;Alphaproteobacteria;Rhodospirillales;Acetobacteraceae;Sediminicoccus;Sediminicoccus rosea	0	0	5	1	0	0	0	0	6
Bacteria;Bacteria_none;Proteobacteria;Gammaproteobacteria;Chromatiales;Chromatiaceae;Thiorhodococcus;Thiorhodococcus minor	5	0	0	1	0	0	0	0	6
Bacteria;Bacteria_none;Cyanobacteria;Cyanobacteria_Incertae_sedis;Gloeomargaritales;Gloeomargaritaceae;Gloeomargarita;Gloeomargarita lithophora	1	1	2	2	0	0	0	0	6
Bacteria;Bacteria_none;Proteobacteria;Gammaproteobacteria;Enterobacterales;Erwiniaceae;Erwinia;Erwinia oleae	5	0	1	0	0	0	0	0	6
Bacteria;Bacteria_none;Bacteroidota;Bacteroidia;Bacteroidales;Prevotellaceae;Prevotella;Prevotella pleuritidis	1	0	0	3	0	0	0	2	6
Bacteria;Bacteria_none;Proteobacteria;Gammaproteobacteria;Chromatiales;Chromatiaceae;Thiorhodococcus;Thiorhodococcus mannitoliphagus	3	2	1	0	0	0	0	0	6
Bacteria;Bacteria_none;Firmicutes;Bacilli;Bacillales;Alicyclobacillaceae;Alicyclobacillus;Alicyclobacillus cycloheptanicus	0	0	2	2	0	1	1	0	6
Bacteria;Bacteria_none;Proteobacteria;Betaproteobacteria;Burkholderiales;Comamonadaceae;Caenimonas;Caenimonas soli	2	0	0	3	0	0	1	0	6
Bacteria;Bacteria_none;Bacteroidota;Cytophagia;Cytophagales;Cytophagaceae;Chryseosolibacter;Chryseosolibacter indicus	4	1	0	1	0	0	0	0	6
Bacteria;Bacteria_none;Actinobacteria;Actinomycetia;Micrococcales;Dermacoccaceae;Branchiibius;Branchiibius cervicis	0	6	0	0	0	0	0	0	6
Bacteria;Bacteria_none;Bacteroidota;Bacteroidia;Bacteroidales;Bacteroidaceae;Phocaeicola;Phocaeicola dorei	1	1	0	2	0	0	2	0	6
Bacteria;Bacteria_none;Actinobacteria;Actinomycetia;Pseudonocardiales;Pseudonocardiaceae;Lentzea;Lentzea albidocapillata	0	0	3	0	3	0	0	0	6
Bacteria;Bacteria_none;Firmicutes;Bacilli;Bacillales;Paenibacillaceae;Paenibacillus;Paenibacillus hemerocallicola	3	0	0	0	0	1	1	1	6
Bacteria;Bacteria_none;Firmicutes;Bacilli;Lactobacillales;Enterococcaceae;Enterococcus;Enterococcus pseudoavium	3	2	0	1	0	0	0	0	6
Bacteria;Bacteria_none;Firmicutes;Tissierellia;Tissierellales;Peptoniphilaceae;Peptoniphilus;Peptoniphilus olsenii	3	1	2	0	0	0	0	0	6
Bacteria;Bacteria_none;Proteobacteria;Alphaproteobacteria;Rhodospirillales;Acetobacteraceae;Acetobacter;Acetobacter tropicalis	0	1	4	1	0	0	0	0	6
Bacteria;Bacteria_none;Proteobacteria;Alphaproteobacteria;Rhodospirillales;Acetobacteraceae;Acidocella;Acidocella aquatica	0	0	4	0	2	0	0	0	6
Bacteria;Bacteria_none;Firmicutes;Clostridia;Eubacteriales;Lachnospiraceae;Gluceribacter;Gluceribacter canis	4	0	1	0	0	0	1	0	6
Bacteria;Bacteria_none;Bacteroidota;Bacteroidia;Bacteroidales;Porphyromonadaceae;Porphyromonas;Porphyromonas catoniae	0	0	2	2	0	0	0	2	6
Bacteria;Bacteria_none;Proteobacteria;Alphaproteobacteria;Hyphomicrobiales;Methylobacteriaceae;Methylobacterium;Methylobacterium soli	1	0	3	1	1	0	0	0	6
Bacteria;Bacteria_none;Chloroflexi;Ktedonobacteria;Ktedonobacterales;Dictyobacteraceae;Dictyobacter;Dictyobacter aurantiacus	0	0	6	0	0	0	0	0	6
Bacteria;Bacteria_none;Proteobacteria;Alphaproteobacteria;Rhodospirillales;Acetobacteraceae;Belnapia;Belnapia soli	1	1	2	1	0	0	0	1	6
Bacteria;Bacteria_none;Bacteroidota;Cytophagia;Cytophagales;Hymenobacteraceae;Hymenobacter;Hymenobacter kanuolensis	0	0	3	1	0	2	0	0	6
Bacteria;Bacteria_none;Bacteroidota;Bacteroidia;Bacteroidales;Porphyromonadaceae;Porphyromonas;Porphyromonas macacae	1	5	0	0	0	0	0	0	6
Bacteria;Bacteria_none;Bacteroidota;Bacteroidia;Bacteroidales;Porphyromonadaceae;Porphyromonas;Porphyromonas pogonae	0	6	0	0	0	0	0	0	6
Bacteria;Bacteria_none;Proteobacteria;Gammaproteobacteria;Enterobacterales;Enterobacteriaceae;Plesiomonas;Plesiomonas shigelloides	4	0	0	0	0	1	1	0	6
Bacteria;Bacteria_none;Proteobacteria;Gammaproteobacteria;Chromatiales;Thioalkalibacteraceae;Guyparkeria;Guyparkeria halophila	0	3	0	1	0	2	0	0	6
Bacteria;Bacteria_none;Chloroflexi;Dehalococcoidia;Dehalococcoidia_Incertae_sedis;Dehalococcoidia_Incertae_sedis;Dehalogenimonas;Dehalogenimonas lykanthroporepellens	0	0	6	0	0	0	0	0	6
Bacteria;Bacteria_none;Firmicutes;Tissierellia;Tissierellales;Peptoniphilaceae;Parvimonas;Parvimonas micra	1	4	0	0	0	0	1	0	6
Bacteria;Bacteria_none;Proteobacteria;Alphaproteobacteria;Rhodospirillales;Acetobacteraceae;Commensalibacter;Commensalibacter intestini	1	1	0	4	0	0	0	0	6
Bacteria;Bacteria_none;Proteobacteria;Gammaproteobacteria;Salinisphaerales;Salinisphaeraceae;Salifodinibacter;Salifodinibacter halophilus	0	0	1	4	0	1	0	0	6
Bacteria;Bacteria_none;Firmicutes;Bacilli;Bacillales;Paenibacillaceae;Paenibacillus;Paenibacillus curdlanolyticus	2	0	3	1	0	0	0	0	6
Bacteria;Bacteria_none;Firmicutes;Clostridia;Eubacteriales;Lachnospiraceae;Enterocloster;Enterocloster citroniae	1	4	1	0	0	0	0	0	6
Bacteria;Bacteria_none;Proteobacteria;Alphaproteobacteria;Hyphomicrobiales;Methylobacteriaceae;Microvirga;Microvirga antarctica	1	3	1	1	0	0	0	0	6
Bacteria;Bacteria_none;Firmicutes;Bacilli;Lactobacillales;Enterococcaceae;Pilibacter;Pilibacter termitis	0	2	1	2	0	0	1	0	6
Bacteria;Bacteria_none;Actinobacteria;Actinomycetia;Micromonosporales;Micromonosporaceae;Actinoplanes;Actinoplanes missouriensis	0	6	0	0	0	0	0	0	6
Bacteria;Bacteria_none;Firmicutes;Clostridia;Eubacteriales;Clostridiaceae;Clostridium;Clostridium polyendosporum	1	1	1	1	0	0	1	1	6
Bacteria;Bacteria_none;Proteobacteria;Alphaproteobacteria;Rhodobacterales;Roseobacteraceae;Roseivivax;Roseivivax lentus	1	2	1	0	0	0	2	0	6
Bacteria;Bacteria_none;Firmicutes;Bacilli;Bacillales;Bacillaceae;Alkalihalobacillus;Alkalihalobacillus clausii	0	0	5	1	0	0	0	0	6
Bacteria;Bacteria_none;Actinobacteria;Actinomycetia;Micrococcales;Brevibacteriaceae;Brevibacterium;Brevibacterium siliguriense	2	2	0	2	0	0	0	0	6
Bacteria;Bacteria_none;Proteobacteria;Alphaproteobacteria;Rhodospirillales;Azospirillaceae;Skermanella;Skermanella aerolata	0	0	1	5	0	0	0	0	6
Bacteria;Bacteria_none;Proteobacteria;Gammaproteobacteria;Legionellales;Legionellaceae;Legionella;Legionella indianapolisensis	0	6	0	0	0	0	0	0	6
Bacteria;Bacteria_none;Actinobacteria;Actinomycetia;Micrococcales;Microbacteriaceae;Aquiluna;Candidatus Aquiluna rubra	0	1	2	2	0	0	0	1	6
Bacteria;Bacteria_none;Proteobacteria;Betaproteobacteria;Burkholderiales;Alcaligenaceae;Pusillimonas;Pusillimonas harenae	4	0	2	0	0	0	0	0	6
Bacteria;Bacteria_none;Proteobacteria;Betaproteobacteria;Burkholderiales;Alcaligenaceae;Taylorella;Taylorella asinigenitalis	4	0	1	0	1	0	0	0	6
Bacteria;Bacteria_none;Proteobacteria;Alphaproteobacteria;Sphingomonadales;Sphingomonadaceae;Sphingomonas;Sphingomonas alpina	2	2	1	1	0	0	0	0	6
Bacteria;Bacteria_none;Proteobacteria;Betaproteobacteria;Burkholderiales;Burkholderiaceae;Caballeronia;Caballeronia glathei	4	2	0	0	0	0	0	0	6
Bacteria;Bacteria_none;Firmicutes;Clostridia;Eubacteriales;Eubacteriaceae;Eubacterium;[Eubacterium] cellulosolvens	0	0	1	2	1	0	2	0	6
Bacteria;Bacteria_none;Cyanobacteria;Cyanobacteria_Incertae_sedis;Oscillatoriales;Microcoleaceae;Planktothrix;Planktothrix paucivesiculata	0	6	0	0	0	0	0	0	6
Bacteria;Bacteria_none;Proteobacteria;Gammaproteobacteria;Legionellales;Legionellaceae;Legionella;Legionella erythra	0	0	6	0	0	0	0	0	6
Bacteria;Bacteria_none;Proteobacteria;Alphaproteobacteria;Hyphomicrobiales;Beijerinckiaceae;Methylocella;Methylocella tundrae	3	0	1	1	0	1	0	0	6
Bacteria;Bacteria_none;Bacteroidota;Chitinophagia;Chitinophagales;Chitinophagaceae;Niabella;Niabella yanshanensis	6	0	0	0	0	0	0	0	6
Bacteria;Bacteria_none;Proteobacteria;Betaproteobacteria;Burkholderiales;Burkholderiaceae;Cupriavidus;Cupriavidus pauculus	5	0	0	0	1	0	0	0	6
Bacteria;Bacteria_none;Proteobacteria;Alphaproteobacteria;Sphingomonadales;Sphingomonadaceae;Parasphingopyxis;Parasphingopyxis algicola	2	2	1	0	0	0	0	1	6
Bacteria;Bacteria_none;Proteobacteria;Alphaproteobacteria;Sphingomonadales;Sphingomonadaceae;Parablastomonas;Parablastomonas arctica	1	0	2	1	0	1	0	1	6
Bacteria;Bacteria_none;Proteobacteria;Gammaproteobacteria;Moraxellales;Moraxellaceae;Psychrobacter;Psychrobacter proteolyticus	1	4	1	0	0	0	0	0	6
Bacteria;Bacteria_none;Proteobacteria;Alphaproteobacteria;Sphingomonadales;Sphingomonadaceae;Novosphingobium;Novosphingobium endophyticum	0	1	1	3	0	0	1	0	6
Bacteria;Bacteria_none;Firmicutes;Clostridia;Eubacteriales;Clostridiaceae;Proteiniclasticum;Proteiniclasticum ruminis	2	3	0	0	0	1	0	0	6
Bacteria;Bacteria_none;Proteobacteria;Gammaproteobacteria;Nevskiales;Sinobacteraceae;Solimonas;Solimonas aquatica	4	1	0	0	1	0	0	0	6
Bacteria;Bacteria_none;Proteobacteria;Gammaproteobacteria;Moraxellales;Moraxellaceae;Acinetobacter;Acinetobacter shaoyimingii	4	0	0	2	0	0	0	0	6
Bacteria;Bacteria_none;Proteobacteria;Alphaproteobacteria;Sphingomonadales;Sphingomonadaceae;Sphingomonas;Sphingomonas aurantiaca	1	1	0	3	0	1	0	0	6
Bacteria;Bacteria_none;Firmicutes;Clostridia;Eubacteriales;Clostridiaceae;Natronincola;Natronincola peptidivorans	0	0	2	1	0	2	0	1	6
Bacteria;Bacteria_none;Proteobacteria;Alphaproteobacteria;Sphingomonadales;Sphingomonadaceae;Sphingomonas;Sphingomonas azotifigens	1	2	2	0	0	0	0	1	6
Bacteria;Bacteria_none;Proteobacteria;Alphaproteobacteria;Sphingomonadales;Sphingomonadaceae;Sphingopyxis;Sphingopyxis macrogoltabida	0	6	0	0	0	0	0	0	6
Bacteria;Bacteria_none;Proteobacteria;Gammaproteobacteria;Moraxellales;Moraxellaceae;Acinetobacter;Acinetobacter ihumii	2	0	0	2	1	0	1	0	6
Bacteria;Bacteria_none;Proteobacteria;Alphaproteobacteria;Sphingomonadales;Sphingomonadaceae;Sphingopyxis;Sphingopyxis terrae	6	0	0	0	0	0	0	0	6
Bacteria;Bacteria_none;Proteobacteria;Alphaproteobacteria;Sphingomonadales;Sphingomonadaceae;Sphingomonas;Sphingomonas yabuuchiae	2	0	4	0	0	0	0	0	6
Bacteria;Bacteria_none;Proteobacteria;Gammaproteobacteria;Moraxellales;Moraxellaceae;Acinetobacter;Acinetobacter larvae	2	0	0	3	1	0	0	0	6
Bacteria;Bacteria_none;Proteobacteria;Gammaproteobacteria;Moraxellales;Moraxellaceae;Acinetobacter;Acinetobacter brisouii	6	0	0	0	0	0	0	0	6
Bacteria;Bacteria_none;Proteobacteria;Alphaproteobacteria;Hyphomicrobiales;Aurantimonadaceae;Aureimonas;Aureimonas altamirensis	3	1	0	1	1	0	0	0	6
Bacteria;Bacteria_none;Proteobacteria;Alphaproteobacteria;Caulobacterales;Caulobacteraceae;Phenylobacterium;Phenylobacterium parvum	1	3	1	1	0	0	0	0	6
Bacteria;Bacteria_none;Cyanobacteria;Cyanobacteria_Incertae_sedis;Pseudanabaenales;Leptolyngbyaceae;Alkalinema;Alkalinema pantanalense	1	0	1	3	0	1	0	0	6
Bacteria;Bacteria_none;Bacteroidota;Chitinophagia;Chitinophagales;Chitinophagaceae;Flavitalea;Flavitalea antarctica	4	2	0	0	0	0	0	0	6
Bacteria;Bacteria_none;Proteobacteria;Alphaproteobacteria;Sphingomonadales;Sphingomonadaceae;Sphingomonas;Sphingomonas laterariae	1	0	5	0	0	0	0	0	6
Bacteria;Bacteria_none;Actinobacteria;Actinomycetia;Propionibacteriales;Kribbellaceae;Kribbella;Kribbella yunnanensis	0	1	1	1	1	2	0	0	6
Bacteria;Bacteria_none;Proteobacteria;Betaproteobacteria;Burkholderiales;Alcaligenaceae;Advenella;Advenella incenata	1	1	1	1	0	2	0	0	6
Bacteria;Bacteria_none;Proteobacteria;Alphaproteobacteria;Sphingomonadales;Sphingomonadaceae;Sphingomonas;Sphingomonas difficilis	1	2	0	2	1	0	0	0	6
Bacteria;Bacteria_none;Firmicutes;Clostridia;Eubacteriales;Eubacteriaceae;Alkalibaculum;Alkalibaculum bacchi	0	2	1	0	1	2	0	0	6
Bacteria;Bacteria_none;Proteobacteria;Betaproteobacteria;Burkholderiales;Alcaligenaceae;Castellaniella;Castellaniella hirudinis	2	1	2	1	0	0	0	0	6
Bacteria;Bacteria_none;Firmicutes;Bacilli;Bacillales;Sporolactobacillaceae;Scopulibacillus;Scopulibacillus daqui	0	0	5	0	0	1	0	0	6
Bacteria;Bacteria_none;Actinobacteria;Actinomycetia;Corynebacteriales;Dietziaceae;Dietzia;Dietzia papillomatosis	1	2	1	2	0	0	0	0	6
Bacteria;Bacteria_none;Proteobacteria;Gammaproteobacteria;Nevskiales;Steroidobacteraceae;Steroidobacter;Steroidobacter soli	0	6	0	0	0	0	0	0	6
Bacteria;Bacteria_none;Cyanobacteria;Cyanobacteria_Incertae_sedis;Nostocales;Dapisostemonaceae;Dapisostemon;Dapisostemon apicaliramis	0	0	4	1	0	1	0	0	6
Bacteria;Bacteria_none;Firmicutes;Clostridia;Eubacteriales;Lachnospiraceae;Mediterraneibacter;Mediterraneibacter glycyrrhizinilyticus	5	0	1	0	0	0	0	0	6
Bacteria;Bacteria_none;Proteobacteria;Alphaproteobacteria;Rhodospirillales;Thalassobaculaceae;Nisaea;Nisaea denitrificans	0	2	0	2	2	0	0	0	6
Bacteria;Bacteria_none;Firmicutes;Bacilli;Lactobacillales;Carnobacteriaceae;Alloiococcus;Alloiococcus otitis	2	1	0	1	1	1	0	0	6
Bacteria;Bacteria_none;Proteobacteria;Gammaproteobacteria;Enterobacterales;Morganellaceae;Providencia;Providencia sneebia	6	0	0	0	0	0	0	0	6
Bacteria;Bacteria_none;Firmicutes;Bacilli;Lactobacillales;Carnobacteriaceae;Atopostipes;Atopostipes suicloacalis	3	1	1	0	0	0	1	0	6
Bacteria;Bacteria_none;Proteobacteria;Alphaproteobacteria;Hyphomicrobiales;Devosiaceae;Devosia;Devosia pacifica	3	1	0	1	0	0	1	0	6
Bacteria;Bacteria_none;Firmicutes;Clostridia;Eubacteriales;Heliobacteriaceae;Heliorestis;Heliorestis convoluta	0	0	6	0	0	0	0	0	6
Bacteria;Bacteria_none;Deinococcus-Thermus;Deinococci;Thermales;Thermaceae;Thermus;Thermus amyloliquefaciens	0	4	2	0	0	0	0	0	6
Bacteria;Bacteria_none;Actinobacteria;Actinomycetia;Propionibacteriales;Propionibacteriaceae;Enemella;Enemella evansiae	1	2	1	1	0	1	0	0	6
Bacteria;Bacteria_none;Firmicutes;Bacilli;Bacillales;Paenibacillaceae;Paenibacillus;Paenibacillus terrae	0	1	2	3	0	0	0	0	6
Bacteria;Bacteria_none;Proteobacteria;Betaproteobacteria;Burkholderiales;Burkholderiales_Incertae_sedis;Tepidimonas;Tepidimonas taiwanensis	6	0	0	0	0	0	0	0	6
Bacteria;Bacteria_none;Actinobacteria;Actinomycetia;Bifidobacteriales;Bifidobacteriaceae;Bifidobacterium;Bifidobacterium coryneforme	0	0	0	3	3	0	0	0	6
Bacteria;Bacteria_none;Proteobacteria;Alphaproteobacteria;Hyphomicrobiales;Devosiaceae;Paradevosia;Paradevosia shaoguanensis	2	1	0	3	0	0	0	0	6
Bacteria;Bacteria_none;Actinobacteria;Actinomycetia;Propionibacteriales;Propionibacteriaceae;Microlunatus;Microlunatus endophyticus	2	2	0	0	1	0	1	0	6
Bacteria;Bacteria_none;Planctomycetota;Phycisphaerae;Phycisphaerales;Phycisphaeraceae;Algisphaera;Algisphaera agarilytica	5	0	0	0	0	1	0	0	6
Bacteria;Bacteria_none;Bacteroidota;Chitinophagia;Chitinophagales;Chitinophagaceae;Terrimonas;Terrimonas soli	6	0	0	0	0	0	0	0	6
Bacteria;Bacteria_none;Firmicutes;Clostridia;Eubacteriales;Lachnospiraceae;Anaerostipes;Anaerostipes caccae	0	2	3	0	0	0	1	0	6
Bacteria;Bacteria_none;Proteobacteria;Alphaproteobacteria;Hyphomicrobiales;Hyphomicrobiaceae;Dichotomicrobium;Dichotomicrobium thermohalophilum	1	2	0	1	0	2	0	0	6
Bacteria;Bacteria_none;Proteobacteria;Alphaproteobacteria;Rhodospirillales;Zavarziniaceae;Zavarzinia;Zavarzinia aquatilis	2	2	0	1	1	0	0	0	6
Bacteria;Bacteria_none;Proteobacteria;Alphaproteobacteria;Rickettsiales;Anaplasmataceae;Ehrlichia;Ehrlichia canis	0	0	6	0	0	0	0	0	6
Bacteria;Bacteria_none;Proteobacteria;Betaproteobacteria;Burkholderiales;Burkholderiaceae;Paraburkholderia;Paraburkholderia caffeinitolerans	0	6	0	0	0	0	0	0	6
Bacteria;Bacteria_none;Proteobacteria;Gammaproteobacteria;Enterobacterales;Pectobacteriaceae;Brenneria;Brenneria alni	2	0	1	2	0	0	0	1	6
Bacteria;Bacteria_none;Proteobacteria;Gammaproteobacteria;Oceanospirillales;Alcanivoracaceae;Alcanivorax;Alcanivorax profundi	6	0	0	0	0	0	0	0	6
Bacteria;Bacteria_none;Actinobacteria;Actinomycetia;Micrococcales;Brevibacteriaceae;Brevibacterium;Brevibacterium jeotgali	0	2	1	1	0	1	0	1	6
Bacteria;Bacteria_none;Proteobacteria;Alphaproteobacteria;Sphingomonadales;Erythrobacteraceae;Croceicoccus;Croceicoccus bisphenolivorans	0	6	0	0	0	0	0	0	6
Bacteria;Bacteria_none;Proteobacteria;Gammaproteobacteria;Oceanospirillales;Halomonadaceae;Halomonas;Halomonas campisalis	3	0	1	1	0	0	0	1	6
Bacteria;Bacteria_none;Cyanobacteria;Cyanobacteria_Incertae_sedis;Nostocales;Nostocaceae;Mojavia;Mojavia pulchra	1	3	1	1	0	0	0	0	6
Bacteria;Bacteria_none;Proteobacteria;Gammaproteobacteria;Oceanospirillales;Halomonadaceae;Halomonas;Halomonas cupida	1	1	0	4	0	0	0	0	6
Bacteria;Bacteria_none;Proteobacteria;Gammaproteobacteria;Enterobacterales;Pectobacteriaceae;Pectobacterium;Pectobacterium polaris	1	0	2	2	0	1	0	0	6
Bacteria;Bacteria_none;Proteobacteria;Alphaproteobacteria;Rickettsiales;Rickettsiales_Incertae_sedis;Lyticum;Lyticum flagellatum	1	3	0	2	0	0	0	0	6
Bacteria;Bacteria_none;Proteobacteria;Alphaproteobacteria;Hyphomicrobiales;Devosiaceae;Devosia;Devosia albogilva	1	0	4	1	0	0	0	0	6
Bacteria;Bacteria_none;Proteobacteria;Gammaproteobacteria;Oceanospirillales;Oceanospirillaceae;Oceanobacter;Oceanobacter kriegii	1	3	1	1	0	0	0	0	6
Bacteria;Bacteria_none;Proteobacteria;Gammaproteobacteria;Enterobacterales;Pectobacteriaceae;Dickeya;Dickeya dadantii	4	1	0	0	0	0	0	1	6
Bacteria;Bacteria_none;Proteobacteria;Gammaproteobacteria;Enterobacterales;Pectobacteriaceae;Brenneria;Brenneria salicis	4	0	0	2	0	0	0	0	6
Bacteria;Bacteria_none;Proteobacteria;Alphaproteobacteria;Rickettsiales;Rickettsiaceae;Occidentia;Occidentia massiliensis	3	1	1	0	0	1	0	0	6
Bacteria;Bacteria_none;Proteobacteria;Gammaproteobacteria;Pasteurellales;Pasteurellaceae;Mannheimia;Mannheimia pernigra	1	2	0	0	1	2	0	0	6
Bacteria;Bacteria_none;Actinobacteria;Actinomycetia;Micrococcales;Bogoriellaceae;Georgenia;Georgenia muralis	1	0	2	2	0	1	0	0	6
Bacteria;Bacteria_none;Proteobacteria;Betaproteobacteria;Burkholderiales;Burkholderiaceae;Ralstonia;Ralstonia pseudosolanacearum	4	1	0	1	0	0	0	0	6
Bacteria;Bacteria_none;Actinobacteria;Actinomycetia;Corynebacteriales;Gordoniaceae;Gordonia;Gordonia asplenii	0	3	3	0	0	0	0	0	6
Bacteria;Bacteria_none;Bacteroidota;Bacteroidia;Bacteroidales;Bacteroidaceae;Bacteroides;Bacteroides nordii	6	0	0	0	0	0	0	0	6
Bacteria;Bacteria_none;Firmicutes;Bacilli;Bacillales;Paenibacillaceae;Paenibacillus;Paenibacillus albilobatus	0	2	0	1	0	2	1	0	6
Bacteria;Bacteria_none;Proteobacteria;Alphaproteobacteria;Sphingomonadales;Sphingomonadaceae;Sphingopyxis;Sphingopyxis flava	1	5	0	0	0	0	0	0	6
Bacteria;Bacteria_none;Proteobacteria;Alphaproteobacteria;Rhodobacterales;Rhodobacteraceae;Paracoccus;Paracoccus kocurii	1	1	0	3	0	1	0	0	6
Bacteria;Bacteria_none;Proteobacteria;Deltaproteobacteria;Syntrophobacterales;Syntrophobacteraceae;Desulfosoma;Desulfosoma caldarium	0	0	6	0	0	0	0	0	6
Bacteria;Bacteria_none;Actinobacteria;Actinomycetia;Micrococcales;Microbacteriaceae;Microbacterium;Microbacterium resistens	0	0	2	2	0	0	0	2	6
Bacteria;Bacteria_none;Firmicutes;Bacilli;Bacillales;Bacillaceae;Metabacillus;Metabacillus fastidiosus	1	0	4	1	0	0	0	0	6
Bacteria;Bacteria_none;Actinobacteria;Actinomycetia;Streptomycetales;Streptomycetaceae;Streptomyces;Streptomyces umbrinus	1	0	0	2	0	3	0	0	6
Bacteria;Bacteria_none;Proteobacteria;Betaproteobacteria;Rhodocyclales;Zoogloeaceae;Thauera;Thauera sinica	2	3	0	0	0	1	0	0	6
Bacteria;Bacteria_none;Tenericutes;Mollicutes;Mycoplasmatales;Mycoplasmataceae;Mycoplasma;Mycoplasma vulturii	0	3	0	0	2	0	0	1	6
Bacteria;Bacteria_none;Proteobacteria;Betaproteobacteria;Neisseriales;Chromobacteriaceae;Microvirgula;Microvirgula aerodenitrificans	2	0	0	1	0	2	1	0	6
Bacteria;Bacteria_none;Firmicutes;Bacilli;Bacillales;Bacillaceae;Priestia;Priestia flexa	0	0	0	0	0	6	0	0	6
Bacteria;Bacteria_none;Bacteroidota;Flavobacteriia;Flavobacteriales;Flavobacteriaceae;Myroides;Myroides odoratus	0	1	3	0	1	1	0	0	6
Bacteria;Bacteria_none;Proteobacteria;Gammaproteobacteria;Xanthomonadales;Xanthomonadaceae;Xanthomonas;Xanthomonas fragariae	5	1	0	0	0	0	0	0	6
Bacteria;Bacteria_none;Proteobacteria;Oligoflexia;Bacteriovoracales;Halobacteriovoraceae;Halobacteriovorax;Halobacteriovorax marinus	1	3	0	2	0	0	0	0	6
Bacteria;Bacteria_none;Actinobacteria;Actinomycetia;Micrococcales;Intrasporangiaceae;Janibacter;Janibacter hoylei	3	3	0	0	0	0	0	0	6
Bacteria;Bacteria_none;Firmicutes;Clostridia;Eubacteriales;Clostridiaceae;Alkaliphilus;Alkaliphilus oremlandii	0	2	0	1	3	0	0	0	6
Bacteria;Bacteria_none;Actinobacteria;Coriobacteriia;Eggerthellales;Eggerthellaceae;Denitrobacterium;Denitrobacterium detoxificans	0	6	0	0	0	0	0	0	6
Bacteria;Bacteria_none;Proteobacteria;Betaproteobacteria;Rhodocyclales;Zoogloeaceae;Uliginosibacterium;Uliginosibacterium aquaticum	5	0	1	0	0	0	0	0	6
Bacteria;Bacteria_none;Proteobacteria;Betaproteobacteria;Rhodocyclales;Zoogloeaceae;Uliginosibacterium;Uliginosibacterium flavum	5	1	0	0	0	0	0	0	6
Bacteria;Bacteria_none;Proteobacteria;Epsilonproteobacteria;Campylobacterales;Campylobacteraceae;Campylobacter;Campylobacter curvus	0	6	0	0	0	0	0	0	6
Bacteria;Bacteria_none;Proteobacteria;Deltaproteobacteria;Desulfovibrionales;Desulfovibrionaceae;Desulfovibrio;Desulfovibrio longreachensis	0	0	3	0	3	0	0	0	6
Bacteria;Bacteria_none;Proteobacteria;Gammaproteobacteria;Xanthomonadales;Xanthomonadaceae;Stenotrophomonas;Stenotrophomonas cyclobalanopsidis	6	0	0	0	0	0	0	0	6
Bacteria;Bacteria_none;Verrucomicrobia;Opitutae;Puniceicoccales;Puniceicoccaceae;Cerasicoccus;Cerasicoccus arenae	0	0	3	2	0	0	1	0	6
Bacteria;Bacteria_none;Bacteroidota;Flavobacteriia;Flavobacteriales;Flavobacteriaceae;Polaribacter;Polaribacter butkevichii	0	0	0	0	0	6	0	0	6
Bacteria;Bacteria_none;Actinobacteria;Actinomycetia;Streptosporangiales;Streptosporangiaceae;Streptosporangium;Streptosporangium jomthongense	0	0	1	5	0	0	0	0	6
Bacteria;Bacteria_none;Proteobacteria;Deltaproteobacteria;Desulfovibrionales;Desulfovibrionaceae;Desulfovibrio;Desulfovibrio legallii	0	2	2	2	0	0	0	0	6
Bacteria;Bacteria_none;Proteobacteria;Alphaproteobacteria;Pelagibacterales;Pelagibacteraceae;Candidatus Pelagibacter;Candidatus Pelagibacter ubique	3	1	1	1	0	0	0	0	6
Bacteria;Bacteria_none;Proteobacteria;Betaproteobacteria;Rhodocyclales;Zoogloeaceae;Uliginosibacterium;Uliginosibacterium sediminicola	4	2	0	0	0	0	0	0	6
Bacteria;Bacteria_none;Firmicutes;Bacilli;Bacillales;Bacillaceae;Pseudalkalibacillus;Pseudalkalibacillus caeni	0	0	3	1	0	0	1	1	6
Bacteria;Bacteria_none;Firmicutes;Bacilli;Bacillales;Bacillaceae;Rossellomorea;Rossellomorea arthrocnemi	0	0	0	0	4	0	2	0	6
Bacteria;Bacteria_none;Proteobacteria;Alphaproteobacteria;Rhodobacterales;Rhodobacteraceae;Paracoccus;Paracoccus sphaerophysae	1	2	0	2	0	0	0	1	6
Bacteria;Bacteria_none;Proteobacteria;Betaproteobacteria;Neisseriales;Chromobacteriaceae;Chromobacterium;Chromobacterium amazonense	3	2	1	0	0	0	0	0	6
Bacteria;Bacteria_none;Proteobacteria;Alphaproteobacteria;Rhodobacterales;Rhodobacteraceae;Paracoccus;Paracoccus sediminis	1	0	3	2	0	0	0	0	6
Bacteria;Bacteria_none;Actinobacteria;Actinomycetia;Streptomycetales;Streptomycetaceae;Streptomyces;Streptomyces luteireticuli	0	2	0	4	0	0	0	0	6
Bacteria;Bacteria_none;Proteobacteria;Deltaproteobacteria;Desulfovibrionales;Desulfovibrionaceae;Halodesulfovibrio;Halodesulfovibrio oceani	0	0	0	0	6	0	0	0	6
Bacteria;Bacteria_none;Firmicutes;Clostridia;Eubacteriales;Clostridiaceae;Alkaliphilus;Alkaliphilus crotonatoxidans	0	0	4	0	0	2	0	0	6
Bacteria;Bacteria_none;Proteobacteria;Betaproteobacteria;Neisseriales;Neisseriaceae;Neisseria;Neisseria animalis	6	0	0	0	0	0	0	0	6
Bacteria;Bacteria_none;Firmicutes;Bacilli;Bacillales;Bacillaceae;Peribacillus;Peribacillus frigoritolerans	1	0	0	2	0	3	0	0	6
Bacteria;Bacteria_none;Firmicutes;Bacilli;Bacillales;Bacillaceae;Cytobacillus;Cytobacillus kochii	0	0	6	0	0	0	0	0	6
Bacteria;Bacteria_none;Bacteroidota;Saprospiria;Saprospirales;Saprospiraceae;Membranihabitans;Membranihabitans marinus	4	1	0	0	0	0	0	1	6
Bacteria;Bacteria_none;Actinobacteria;Actinomycetia;Micrococcales;Microbacteriaceae;Mycetocola;Mycetocola zhujimingii	1	1	1	2	0	0	1	0	6
Bacteria;Bacteria_none;Firmicutes;Bacilli;Lactobacillales;Streptococcaceae;Streptococcus;Streptococcus rubneri	3	1	0	1	0	0	1	0	6
Bacteria;Bacteria_none;Firmicutes;Erysipelotrichia;Erysipelotrichales;Erysipelotrichaceae;Anaerorhabdus;Anaerorhabdus furcosa	0	0	2	3	0	0	1	0	6
Bacteria;Bacteria_none;Firmicutes;Bacilli;Lactobacillales;Streptococcaceae;Streptococcus;Streptococcus oralis	1	5	0	0	0	0	0	0	6
Bacteria;Bacteria_none;Proteobacteria;Betaproteobacteria;Nitrosomonadales;Thiobacillaceae;Parasulfuritortus;Parasulfuritortus cantonensis	3	0	0	2	0	1	0	0	6
Bacteria;Bacteria_none;Firmicutes;Bacilli;Lactobacillales;Lactobacillaceae;Limosilactobacillus;Limosilactobacillus frumenti	0	5	0	0	0	0	0	1	6
Bacteria;Bacteria_none;Proteobacteria;Alphaproteobacteria;Rhodobacterales;Rhodobacteraceae;Paracoccus;Paracoccus bogoriensis	4	1	0	1	0	0	0	0	6
Bacteria;Bacteria_none;Bacteroidota;Flavobacteriia;Flavobacteriales;Flavobacteriaceae;Flavobacterium;Flavobacterium phocarum	4	0	2	0	0	0	0	0	6
Bacteria;Bacteria_none;Bacteroidota;Flavobacteriia;Flavobacteriales;Flavobacteriaceae;Flavobacterium;Flavobacterium psychrophilum	1	2	3	0	0	0	0	0	6
Bacteria;Bacteria_none;Synergistetes;Synergistia;Synergistales;Synergistaceae;Acetomicrobium;Acetomicrobium thermoterrenum	0	0	1	3	0	2	0	0	6
Bacteria;Bacteria_none;Proteobacteria;Alphaproteobacteria;Hyphomicrobiales;Phyllobacteriaceae;Nitratireductor;Nitratireductor aquimarinus	2	3	1	0	0	0	0	0	6
Bacteria;Bacteria_none;Acidobacteria;Acidobacteriia;Acidobacteriales;Acidobacteriaceae;Granulicella;Granulicella cerasi	0	3	0	3	0	0	0	0	6
Bacteria;Bacteria_none;Bacteroidota;Flavobacteriia;Flavobacteriales;Flavobacteriaceae;Gramella;Gramella marina	0	0	3	2	0	0	0	1	6
Bacteria;Bacteria_none;Proteobacteria;Deltaproteobacteria;Myxococcales;Kofleriaceae;Kofleria;Kofleria flava	1	2	0	2	0	0	0	1	6
Bacteria;Bacteria_none;Spirochaetes;Spirochaetia;Spirochaetales;Treponemataceae;Treponema;Treponema pedis	0	6	0	0	0	0	0	0	6
Bacteria;Bacteria_none;Proteobacteria;Deltaproteobacteria;Myxococcales;Myxococcaceae;Corallococcus;Corallococcus praedator	0	3	3	0	0	0	0	0	6
Bacteria;Bacteria_none;Actinobacteria;Actinomycetia;Micrococcales;Microbacteriaceae;Plantibacter;Plantibacter auratus	0	0	2	4	0	0	0	0	6
Bacteria;Bacteria_none;Proteobacteria;Alphaproteobacteria;Hyphomicrobiales;Phyllobacteriaceae;Mesorhizobium;Mesorhizobium kowhaii	0	2	0	4	0	0	0	0	6
Bacteria;Bacteria_none;Proteobacteria;Deltaproteobacteria;Myxococcales;Polyangiaceae;Jahnella;Jahnella thaxteri	4	0	1	0	0	1	0	0	6
Bacteria;Bacteria_none;Firmicutes;Erysipelotrichia;Erysipelotrichales;Erysipelotrichaceae;Faecalibacillus;Faecalibacillus intestinalis	3	0	2	0	0	1	0	0	6
Bacteria;Bacteria_none;Firmicutes;Bacilli;Lactobacillales;Lactobacillaceae;Leuconostoc;Leuconostoc carnosum	4	2	0	0	0	0	0	0	6
Bacteria;Bacteria_none;Proteobacteria;Betaproteobacteria;Nitrosomonadales;Methylophilaceae;Methylotenera;Methylotenera mobilis	6	0	0	0	0	0	0	0	6
Bacteria;Bacteria_none;Bacteroidota;Sphingobacteriia;Sphingobacteriales;Sphingobacteriaceae;Daejeonella;Daejeonella rubra	5	1	0	0	0	0	0	0	6
Bacteria;Bacteria_none;Actinobacteria;Actinomycetia;Actinomycetales;Actinomycetaceae;Actinomyces;Actinomyces provencensis	2	4	0	0	0	0	0	0	6
Bacteria;Bacteria_none;Firmicutes;Clostridia;Eubacteriales;Christensenellaceae;Christensenella;Christensenella minuta	6	0	0	0	0	0	0	0	6
Bacteria;Bacteria_none;Firmicutes;Bacilli;Bacillales;Bacillaceae;Caldibacillus;Caldibacillus debilis	0	0	4	0	1	1	0	0	6
Bacteria;Bacteria_none;Proteobacteria;Alphaproteobacteria;Hyphomicrobiales;Phyllobacteriaceae;Thalassocola;Thalassocola ureilytica	1	4	1	0	0	0	0	0	6
Bacteria;Bacteria_none;Proteobacteria;Alphaproteobacteria;Rhodobacterales;Rhodobacteraceae;Paracoccus;Paracoccus binzhouensis	1	1	2	2	0	0	0	0	6
Bacteria;Bacteria_none;Actinobacteria;Actinomycetia;Micrococcales;Dermatophilaceae;Piscicoccus;Piscicoccus intestinalis	0	3	1	2	0	0	0	0	6
Bacteria;Bacteria_none;Proteobacteria;Alphaproteobacteria;Rhodobacterales;Rhodobacteraceae;Xinfangfangia;Xinfangfangia pollutisoli	3	2	0	0	0	0	0	1	6
Bacteria;Bacteria_none;Proteobacteria;Alphaproteobacteria;Hyphomicrobiales;Nitrobacteraceae;Rhodopseudomonas;Rhodopseudomonas pseudopalustris	5	1	0	0	0	0	0	0	6
Bacteria;Bacteria_none;Proteobacteria;Deltaproteobacteria;Desulfuromonadales;Desulfuromonadaceae;Desulfuromonas;Desulfuromonas carbonis	4	2	0	0	0	0	0	0	6
Bacteria;Bacteria_none;Actinobacteria;Actinomycetia;Streptosporangiales;Nocardiopsaceae;Nocardiopsis;Nocardiopsis xinjiangensis	0	3	2	1	0	0	0	0	6
Bacteria;Bacteria_none;Firmicutes;Bacilli;Bacillales;Bacillales Family X. Incertae Sedis;Thermicanus;Thermicanus aegyptius	0	1	3	0	1	1	0	0	6
Bacteria;Bacteria_none;Proteobacteria;Alphaproteobacteria;Hyphomicrobiales;Methylocystaceae;Methylopila;Methylopila oligotropha	6	0	0	0	0	0	0	0	6
Bacteria;Bacteria_none;Proteobacteria;Alphaproteobacteria;Rhodobacterales;Rhodobacteraceae;Roseibacula;Roseibacula alcaliphilum	4	1	0	0	1	0	0	0	6
Bacteria;Bacteria_none;Firmicutes;Bacilli;Lactobacillales;Lactobacillaceae;Companilactobacillus;Companilactobacillus versmoldensis	5	0	0	0	0	0	1	0	6
Bacteria;Bacteria_none;Proteobacteria;Gammaproteobacteria;Xanthomonadales;Xanthomonadaceae;Luteimonas;Luteimonas lumbrici	3	2	1	0	0	0	0	0	6
Bacteria;Bacteria_none;Proteobacteria;Gammaproteobacteria;Xanthomonadales;Xanthomonadaceae;Luteimonas;Luteimonas mephitis	2	1	0	1	0	0	2	0	6
Bacteria;Bacteria_none;Proteobacteria;Alphaproteobacteria;Rhodobacterales;Rhodobacteraceae;Rhodovulum;Rhodovulum marinum	2	1	0	2	0	0	0	1	6
Bacteria;Bacteria_none;Firmicutes;Clostridia;Halanaerobiales;Halanaerobiaceae;Halanaerobium;Halanaerobium salsuginis	0	0	4	0	2	0	0	0	6
Bacteria;Bacteria_none;Actinobacteria;Actinomycetia;Micrococcales;Intrasporangiaceae;Ornithinicoccus;Ornithinicoccus halotolerans	1	1	0	4	0	0	0	0	6
Bacteria;Bacteria_none;Proteobacteria;Alphaproteobacteria;Hyphomicrobiales;Nitrobacteraceae;Bradyrhizobium;Bradyrhizobium altum	0	2	0	4	0	0	0	0	6
Bacteria;Bacteria_none;Proteobacteria;Alphaproteobacteria;Rhodobacterales;Rhodobacteraceae;Rhodosalinus;Rhodosalinus halophilus	3	2	0	1	0	0	0	0	6
Bacteria;Bacteria_none;Proteobacteria;Betaproteobacteria;Burkholderiales;Sphaerotilaceae;Zhizhongheella;Zhizhongheella caldifontis	3	3	0	0	0	0	0	0	6
Bacteria;Bacteria_none;Actinobacteria;Actinomycetia;Micrococcales;Microbacteriaceae;Microbacterium;Microbacterium insulae	3	0	0	3	0	0	0	0	6
Bacteria;Bacteria_none;Proteobacteria;Gammaproteobacteria;Xanthomonadales;Xanthomonadaceae;Luteimonas;Luteimonas vadosa	3	3	0	0	0	0	0	0	6
Bacteria;Bacteria_none;Proteobacteria;Gammaproteobacteria;Alteromonadales;Alteromonadaceae;Catenovulum;Catenovulum maritimum	2	1	2	1	0	0	0	0	6
Bacteria;Bacteria_none;Actinobacteria;Actinomycetia;Streptosporangiales;Nocardiopsaceae;Streptomonospora;Streptomonospora sediminis	1	0	3	2	0	0	0	0	6
Bacteria;Bacteria_none;Proteobacteria;Gammaproteobacteria;Cellvibrionales;Cellvibrionaceae;Marinimicrobium;Marinimicrobium agarilyticum	2	1	0	2	0	1	0	0	6
Bacteria;Bacteria_none;Bacteroidota;Cytophagia;Cytophagales;Spirosomaceae;Dyadobacter;Dyadobacter luteus	3	1	0	0	0	0	0	2	6
Bacteria;Bacteria_none;Firmicutes;Clostridia;Eubacteriales;Vallitaleaceae;Petrocella;Petrocella atlantisensis	0	2	4	0	0	0	0	0	6
Bacteria;Bacteria_none;Proteobacteria;Deltaproteobacteria;Desulfovibrionales;Desulfohalobiaceae;Desulfohalobium;Desulfohalobium retbaense	0	4	0	0	0	2	0	0	6
Bacteria;Bacteria_none;Proteobacteria;Gammaproteobacteria;Vibrionales;Vibrionaceae;Grimontia;Grimontia hollisae	1	1	3	0	0	0	0	1	6
Bacteria;Bacteria_none;Firmicutes;Bacilli;Bacillales;Bacillaceae;Lysinibacillus;Lysinibacillus sphaericus	0	0	0	4	0	2	0	0	6
Bacteria;Bacteria_none;Bacteroidota;Bacteroidia;Bacteroidales;Bacteroidaceae;Bacteroides;Bacteroides faecichinchillae	0	0	0	0	0	6	0	0	6
Bacteria;Bacteria_none;Firmicutes;Bacilli;Lactobacillales;Streptococcaceae;Lactococcus;Lactococcus protaetiae	3	1	1	0	0	0	1	0	6
Bacteria;Bacteria_none;Actinobacteria;Actinomycetia;Streptosporangiales;Streptosporangiaceae;Nonomuraea;Nonomuraea terrae	0	1	3	1	0	0	0	1	6
Bacteria;Bacteria_none;Bacteroidota;Bacteroidia;Bacteroidales;Bacteroidaceae;Bacteroides;Bacteroides congonensis	1	3	0	0	0	0	0	2	6
Bacteria;Bacteria_none;Proteobacteria;Deltaproteobacteria;Desulfobacterales;Desulfobacteraceae;Desulfofrigus;Desulfofrigus fragile	1	2	0	3	0	0	0	0	6
Bacteria;Bacteria_none;Chloroflexi;Ardenticatenia;Ardenticatenales;Ardenticatenaceae;Ardenticatena;Ardenticatena maritima	1	1	1	0	2	0	1	0	6
Bacteria;Bacteria_none;Proteobacteria;Betaproteobacteria;Burkholderiales;Oxalobacteraceae;Janthinobacterium;Janthinobacterium lividum	6	0	0	0	0	0	0	0	6
Bacteria;Bacteria_none;Firmicutes;Bacilli;Lactobacillales;Streptococcaceae;Lactococcus;Lactococcus taiwanensis	5	0	0	1	0	0	0	0	6
Bacteria;Bacteria_none;Proteobacteria;Gammaproteobacteria;Vibrionales;Vibrionaceae;Vibrio;Vibrio zhugei	0	0	0	6	0	0	0	0	6
Bacteria;Bacteria_none;Bacteroidota;Flavobacteriia;Flavobacteriales;Salibacteraceae;Salibacter;Salibacter halophilus	0	0	1	2	0	2	0	1	6
Bacteria;Bacteria_none;Proteobacteria;Gammaproteobacteria;Xanthomonadales;Rhodanobacteraceae;Luteibacter;Luteibacter jiangsuensis	6	0	0	0	0	0	0	0	6
Bacteria;Bacteria_none;Proteobacteria;Gammaproteobacteria;Xanthomonadales;Xanthomonadaceae;Lysobacter;'Lysobacter humi' Akter et al. 2016	2	2	0	1	0	0	0	1	6
Bacteria;Bacteria_none;Actinobacteria;Actinomycetia;Glycomycetales;Glycomycetaceae;Glycomyces;Glycomyces albus	0	2	2	2	0	0	0	0	6
Bacteria;Bacteria_none;Proteobacteria;Gammaproteobacteria;Xanthomonadales;Xanthomonadaceae;Pseudomarimonas;Pseudomarimonas arenosa	2	1	2	1	0	0	0	0	6
Bacteria;Bacteria_none;Actinobacteria;Actinomycetia;Actinomycetales;Actinomycetaceae;Actinomyces;Actinomyces graevenitzii	2	0	1	2	0	1	0	0	6
Bacteria;Bacteria_none;Actinobacteria;Actinomycetia;Streptomycetales;Streptomycetaceae;Streptomyces;Streptomyces hiroshimensis	0	2	2	2	0	0	0	0	6
Bacteria;Bacteria_none;Proteobacteria;Betaproteobacteria;Burkholderiales;Sphaerotilaceae;Rubrivivax;Rubrivivax albus	4	0	1	0	0	1	0	0	6
Bacteria;Bacteria_none;Firmicutes;Bacilli;Lactobacillales;Lactobacillaceae;Secundilactobacillus;Secundilactobacillus collinoides	1	1	1	0	0	2	0	1	6
Bacteria;Bacteria_none;Firmicutes;Bacilli;Lactobacillales;Streptococcaceae;Streptococcus;Streptococcus dentirousetti	6	0	0	0	0	0	0	0	6
Bacteria;Bacteria_none;Actinobacteria;Actinomycetia;Streptomycetales;Streptomycetaceae;Streptomyces;Streptomyces griseocarneus	0	0	2	2	0	2	0	0	6
Bacteria;Bacteria_none;Firmicutes;Bacilli;Lactobacillales;Lactobacillaceae;Pediococcus;Pediococcus siamensis	1	2	1	1	0	0	1	0	6
Bacteria;Bacteria_none;Proteobacteria;Betaproteobacteria;Burkholderiales;Sphaerotilaceae;Methylibium;Methylibium petroleiphilum	4	2	0	0	0	0	0	0	6
Bacteria;Bacteria_none;Bacteroidota;Cytophagia;Cytophagales;Spirosomaceae;Flectobacillus;Flectobacillus fontis	6	0	0	0	0	0	0	0	6
Bacteria;Bacteria_none;Proteobacteria;Deltaproteobacteria;Desulfobacterales;Desulfobacteraceae;Desulfatiglans;Desulfatiglans parachlorophenolica	0	4	2	0	0	0	0	0	6
Bacteria;Bacteria_none;Proteobacteria;Deltaproteobacteria;Desulfobacterales;Desulfobacteraceae;Desulfobacter;Desulfobacter hydrogenophilus	0	2	0	0	4	0	0	0	6
Bacteria;Bacteria_none;Firmicutes;Bacilli;Bacillales;Bacillaceae;Salirhabdus;Salirhabdus euzebyi	0	1	1	3	0	0	0	1	6
Bacteria;Bacteria_none;Proteobacteria;Alphaproteobacteria;Rhodobacterales;Rhodobacteraceae;Pararhodobacter;Pararhodobacter oceanensis	1	1	1	1	0	2	0	0	6
Bacteria;Bacteria_none;Proteobacteria;Gammaproteobacteria;Aeromonadales;Aeromonadaceae;Aeromonas;Aeromonas salmonicida	5	1	0	0	0	0	0	0	6
Bacteria;Bacteria_none;Bacteroidota;Sphingobacteriia;Sphingobacteriales;Sphingobacteriaceae;Sphingobacterium;Sphingobacterium phlebotomi	2	2	0	0	0	0	0	2	6
Bacteria;Bacteria_none;Proteobacteria;Gammaproteobacteria;Moraxellales;Moraxellaceae;Acinetobacter;Acinetobacter populi	5	0	0	0	0	0	0	0	5
Bacteria;Bacteria_none;Bacteroidota;Flavobacteriia;Flavobacteriales;Flavobacteriaceae;Lacinutrix;Lacinutrix gracilariae	1	0	4	0	0	0	0	0	5
Bacteria;Bacteria_none;Bacteroidota;Flavobacteriia;Flavobacteriales;Weeksellaceae;Epilithonimonas;Epilithonimonas hispanica	2	0	0	3	0	0	0	0	5
Bacteria;Bacteria_none;Verrucomicrobia;Opitutae;Opitutales;Opitutaceae;Cephaloticoccus;Cephaloticoccus primus	0	5	0	0	0	0	0	0	5
Bacteria;Bacteria_none;Proteobacteria;Alphaproteobacteria;Hyphomicrobiales;Rhizobiaceae;Pseudorhizobium;Pseudorhizobium flavum	0	3	0	1	0	0	0	1	5
Bacteria;Bacteria_none;Firmicutes;Bacilli;Bacillales;Staphylococcaceae;Staphylococcus;Staphylococcus hominis	2	3	0	0	0	0	0	0	5
Bacteria;Bacteria_none;Proteobacteria;Alphaproteobacteria;Sphingomonadales;Sphingomonadaceae;Sphingomonas;Sphingomonas bisphenolicum	0	0	1	4	0	0	0	0	5
Bacteria;Bacteria_none;Firmicutes;Bacilli;Lactobacillales;Lactobacillaceae;Schleiferilactobacillus;Schleiferilactobacillus harbinensis	4	0	0	0	1	0	0	0	5
Bacteria;Bacteria_none;Proteobacteria;Alphaproteobacteria;Sphingomonadales;Sphingomonadaceae;Sphingopyxis;Sphingopyxis alaskensis	0	0	0	3	0	2	0	0	5
Bacteria;Bacteria_none;Proteobacteria;Alphaproteobacteria;Sphingomonadales;Sphingomonadaceae;Hankyongella;Hankyongella ginsenosidimutans	0	0	2	1	0	1	1	0	5
Bacteria;Bacteria_none;Proteobacteria;Gammaproteobacteria;Nevskiales;Sinobacteraceae;Nevskia;Nevskia terrae	1	2	1	1	0	0	0	0	5
Bacteria;Bacteria_none;Actinobacteria;Actinomycetia;Propionibacteriales;Nocardioidaceae;Aeromicrobium;Aeromicrobium halocynthiae	0	1	1	1	0	1	1	0	5
Bacteria;Bacteria_none;Proteobacteria;Alphaproteobacteria;Sphingomonadales;Sphingomonadaceae;Sphingomonas;Sphingomonas carri	2	1	1	0	0	0	1	0	5
Bacteria;Bacteria_none;Proteobacteria;Alphaproteobacteria;Sphingomonadales;Sphingomonadaceae;Sphingomonas;Sphingomonas faucium	1	0	0	4	0	0	0	0	5
Bacteria;Bacteria_none;Tenericutes;Mollicutes;Mycoplasmatales;Mycoplasmataceae;Mycoplasma;Mycoplasma feliminutum	0	1	0	1	1	1	1	0	5
Bacteria;Bacteria_none;Proteobacteria;Alphaproteobacteria;Hyphomicrobiales;Stappiaceae;Stappia;Stappia indica	0	5	0	0	0	0	0	0	5
Bacteria;Bacteria_none;Proteobacteria;Alphaproteobacteria;Sphingomonadales;Sphingomonadaceae;Sphingomonas;Sphingomonas ginsenosidimutans	2	0	1	1	0	1	0	0	5
Bacteria;Bacteria_none;Proteobacteria;Alphaproteobacteria;Hyphomonadales;Hyphomonadaceae;Hyphomonas;Hyphomonas rosenbergii	0	0	0	3	0	2	0	0	5
Bacteria;Bacteria_none;Firmicutes;Bacilli;Bacillales;Thermoactinomycetaceae;Risungbinella;Risungbinella pyongyangensis	0	0	2	0	2	1	0	0	5
Bacteria;Bacteria_none;Proteobacteria;Alphaproteobacteria;Sphingomonadales;Sphingomonadaceae;Sphingomonas;Sphingomonas montis	2	3	0	0	0	0	0	0	5
Bacteria;Bacteria_none;Firmicutes;Bacilli;Lactobacillales;Lactobacillaceae;Weissella;Weissella cibaria	3	1	0	1	0	0	0	0	5
Bacteria;Bacteria_none;Proteobacteria;Alphaproteobacteria;Sphingomonadales;Sphingomonadaceae;Sphingobium;Sphingobium sufflavum	1	1	0	1	0	0	1	1	5
Bacteria;Bacteria_none;Firmicutes;Clostridia;Eubacteriales;Desulfallaceae;Sporotomaculum;Sporotomaculum hydroxybenzoicum	0	4	1	0	0	0	0	0	5
Bacteria;Bacteria_none;Thermotogae;Thermotogae;Petrotogales;Petrotogaceae;Defluviitoga;Defluviitoga tunisiensis	0	1	1	2	0	1	0	0	5
Bacteria;Bacteria_none;Proteobacteria;Alphaproteobacteria;Sphingomonadales;Sphingomonadaceae;Sphingomonas;Sphingomonas koreensis	1	4	0	0	0	0	0	0	5
Bacteria;Bacteria_none;Firmicutes;Bacilli;Lactobacillales;Lactobacillaceae;Limosilactobacillus;Limosilactobacillus oris	1	0	0	4	0	0	0	0	5
Bacteria;Bacteria_none;Proteobacteria;Alphaproteobacteria;Sphingomonadales;Sphingomonadaceae;Sphingomonas;Sphingomonas adhaesiva	0	1	1	1	2	0	0	0	5
Bacteria;Bacteria_none;Proteobacteria;Alphaproteobacteria;Hyphomicrobiales;Pseudoxanthobacteraceae;Pseudoxanthobacter;Pseudoxanthobacter soli	0	1	2	2	0	0	0	0	5
Bacteria;Bacteria_none;Proteobacteria;Alphaproteobacteria;Hyphomonadales;Hyphomonadaceae;Henriciella;Henriciella barbarensis	0	2	3	0	0	0	0	0	5
Bacteria;Bacteria_none;Proteobacteria;Gammaproteobacteria;Moraxellales;Moraxellaceae;Acinetobacter;Acinetobacter marinus	3	0	1	1	0	0	0	0	5
Bacteria;Bacteria_none;Proteobacteria;Alphaproteobacteria;Sphingomonadales;Sphingomonadaceae;Sphingomonas;Sphingomonas hylomeconis	3	0	1	1	0	0	0	0	5
Bacteria;Bacteria_none;Proteobacteria;Gammaproteobacteria;Moraxellales;Moraxellaceae;Acinetobacter;Acinetobacter nectaris	2	0	0	3	0	0	0	0	5
Bacteria;Bacteria_none;Actinobacteria;Actinomycetia;Micromonosporales;Micromonosporaceae;Pseudosporangium;Pseudosporangium ferrugineum	0	0	4	0	0	1	0	0	5
Bacteria;Bacteria_none;Proteobacteria;Alphaproteobacteria;Sphingomonadales;Sphingomonadaceae;Novosphingobium;Novosphingobium piscinae	3	1	0	0	0	1	0	0	5
Bacteria;Bacteria_none;Cyanobacteria;Cyanobacteria_Incertae_sedis;Oscillatoriales;Oscillatoriaceae;Tenebriella;Tenebriella curviceps	0	0	0	0	0	0	0	5	5
Bacteria;Bacteria_none;Firmicutes;Bacilli;Lactobacillales;Lactobacillaceae;Paucilactobacillus;Paucilactobacillus nenjiangensis	5	0	0	0	0	0	0	0	5
Bacteria;Bacteria_none;Proteobacteria;Alphaproteobacteria;Rhodobacterales;Roseobacteraceae;Litoreibacter;Litoreibacter janthinus	0	4	1	0	0	0	0	0	5
Bacteria;Bacteria_none;Proteobacteria;Alphaproteobacteria;Sphingomonadales;Sphingomonadaceae;Aquisediminimonas;Aquisediminimonas sediminicola	5	0	0	0	0	0	0	0	5
Bacteria;Bacteria_none;Actinobacteria;Actinomycetia;Micromonosporales;Micromonosporaceae;Actinoplanes;Actinoplanes teichomyceticus	0	1	3	0	0	1	0	0	5
Bacteria;Bacteria_none;Bacteroidota;Sphingobacteriia;Sphingobacteriales;Sphingobacteriaceae;Sphingobacterium;Sphingobacterium siyangense	0	2	0	2	0	0	0	1	5
Bacteria;Bacteria_none;Firmicutes;Clostridia;Eubacteriales;Clostridiaceae;Clostridium;Clostridium niameyense	0	0	2	2	0	1	0	0	5
Bacteria;Bacteria_none;Bacteroidota;Cytophagia;Cytophagales;Spirosomaceae;Emticicia;Emticicia soli	5	0	0	0	0	0	0	0	5
Bacteria;Bacteria_none;Actinobacteria;Actinomycetia;Micrococcales;Micrococcaceae;Nesterenkonia;Nesterenkonia endophytica	1	3	0	0	0	0	1	0	5
Bacteria;Bacteria_none;Bacteroidota;Cytophagia;Cytophagales;Fulvivirgaceae;Ohtaekwangia;Ohtaekwangia kribbensis	0	4	0	0	1	0	0	0	5
Bacteria;Bacteria_none;Proteobacteria;Gammaproteobacteria;Xanthomonadales;Xanthomonadaceae;Pseudoxanthomonas;Pseudoxanthomonas dokdonensis	1	0	2	0	0	0	0	2	5
Bacteria;Bacteria_none;Proteobacteria;Alphaproteobacteria;Rhodobacterales;Rhodobacteraceae;Paroceanicella;Paroceanicella profunda	1	2	0	1	0	1	0	0	5
Bacteria;Bacteria_none;Chloroflexi;Ktedonobacteria;Ktedonobacterales;Thermosporotrichaceae;Thermosporothrix;Thermosporothrix hazakensis	0	0	5	0	0	0	0	0	5
Bacteria;Bacteria_none;Actinobacteria;Actinomycetia;Corynebacteriales;Corynebacteriaceae;Corynebacterium;Corynebacterium caspium	0	2	1	2	0	0	0	0	5
Bacteria;Bacteria_none;Proteobacteria;Gammaproteobacteria;Pseudomonadales;Pseudomonadaceae;Pseudomonas;Pseudomonas fluorescens	1	0	4	0	0	0	0	0	5
Bacteria;Bacteria_none;Proteobacteria;Gammaproteobacteria;Pseudomonadales;Pseudomonadaceae;Pseudomonas;Pseudomonas delhiensis	1	0	1	1	2	0	0	0	5
Bacteria;Bacteria_none;Firmicutes;Bacilli;Lactobacillales;Enterococcaceae;Enterococcus;Enterococcus canintestini	4	0	0	1	0	0	0	0	5
Bacteria;Bacteria_none;Firmicutes;Bacilli;Lactobacillales;Enterococcaceae;Enterococcus;Enterococcus avium	3	0	0	0	2	0	0	0	5
Bacteria;Bacteria_none;Actinobacteria;Actinomycetia;Corynebacteriales;Corynebacteriaceae;Corynebacterium;Corynebacterium lubricantis	0	5	0	0	0	0	0	0	5
Bacteria;Bacteria_none;Proteobacteria;Alphaproteobacteria;Rhodospirillales;Acetobacteraceae;Roseomonas;Roseomonas gilardii	0	1	0	2	1	0	1	0	5
Bacteria;Bacteria_none;Actinobacteria;Actinomycetia;Micrococcales;Micrococcaceae;Kocuria;Kocuria indica	0	0	3	1	0	1	0	0	5
Bacteria;Bacteria_none;Proteobacteria;Alphaproteobacteria;Rhodobacterales;Rhodobacteraceae;Rhodobaca;Rhodobaca barguzinensis	1	1	1	0	1	0	1	0	5
Bacteria;Bacteria_none;Bacteroidota;Cytophagia;Cytophagales;Fulvivirgaceae;Xanthovirga;Xanthovirga aplysinae	2	3	0	0	0	0	0	0	5
Bacteria;Bacteria_none;Proteobacteria;Alphaproteobacteria;Rhodospirillales;Acetobacteraceae;Acidisoma;Acidisoma tundrae	5	0	0	0	0	0	0	0	5
Bacteria;Bacteria_none;Proteobacteria;Gammaproteobacteria;Xanthomonadales;Xanthomonadaceae;Luteimonas;Luteimonas soli	2	2	0	1	0	0	0	0	5
Bacteria;Bacteria_none;Proteobacteria;Alphaproteobacteria;Hyphomicrobiales;Methylobacteriaceae;Microvirga;Microvirga splendida	0	5	0	0	0	0	0	0	5
Bacteria;Bacteria_none;Proteobacteria;Alphaproteobacteria;Hyphomicrobiales;Methylobacteriaceae;Microvirga;Microvirga rosea	0	3	0	2	0	0	0	0	5
Bacteria;Bacteria_none;Cyanobacteria;Cyanobacteria_Incertae_sedis;Oscillatoriales;Sirenicapillariaceae;Neolyngbya;Neolyngbya arenicola	0	0	2	1	2	0	0	0	5
Bacteria;Bacteria_none;Proteobacteria;Gammaproteobacteria;Vibrionales;Vibrionaceae;Vibrio;Vibrio algicola	0	2	2	0	0	0	0	1	5
Bacteria;Bacteria_none;Proteobacteria;Alphaproteobacteria;Rhodobacterales;Roseobacteraceae;Pacificibacter;Pacificibacter aestuarii	1	4	0	0	0	0	0	0	5
Bacteria;Bacteria_none;Proteobacteria;Alphaproteobacteria;Hyphomicrobiales;Methylobacteriaceae;Microvirga;Microvirga mediterraneensis	0	0	0	0	5	0	0	0	5
Bacteria;Bacteria_none;Proteobacteria;Gammaproteobacteria;Thiotrichales;Fastidiosibacteraceae;Fastidiosibacter;Fastidiosibacter lacustris	1	1	0	1	1	0	0	1	5
Bacteria;Bacteria_none;Proteobacteria;Gammaproteobacteria;Vibrionales;Vibrionaceae;Vibrio;Vibrio hispanicus	2	0	0	2	0	0	0	1	5
Bacteria;Bacteria_none;Actinobacteria;Actinomycetia;Micrococcales;Microbacteriaceae;Agromyces;Agromyces agglutinans	1	1	1	2	0	0	0	0	5
Bacteria;Bacteria_none;Chlorobi;Chlorobia;Chlorobiales;Chloroherpetonaceae;Chloroherpeton;Chloroherpeton thalassium	1	1	2	0	0	1	0	0	5
Bacteria;Bacteria_none;Proteobacteria;Gammaproteobacteria;Salinisphaerales;Salinisphaeraceae;Salinisphaera;Salinisphaera hydrothermalis	1	2	0	2	0	0	0	0	5
Bacteria;Bacteria_none;Proteobacteria;Gammaproteobacteria;Xanthomonadales;Rhodanobacteraceae;Metallibacterium;Metallibacterium scheffleri	4	1	0	0	0	0	0	0	5
Bacteria;Bacteria_none;Proteobacteria;Alphaproteobacteria;Rhodobacterales;Roseobacteraceae;Salipiger;Salipiger aestuarii	2	1	1	1	0	0	0	0	5
Bacteria;Bacteria_none;Proteobacteria;Alphaproteobacteria;Rhodospirillales;Acetobacteraceae;Acetobacter;Acetobacter garciniae	0	2	0	3	0	0	0	0	5
Bacteria;Bacteria_none;Acidobacteria;Blastocatellia;Blastocatellales;Blastocatellaceae;Stenotrophobacter;Stenotrophobacter namibiensis	5	0	0	0	0	0	0	0	5
Bacteria;Bacteria_none;Proteobacteria;Gammaproteobacteria;Xanthomonadales;Xanthomonadaceae;Pseudoxanthomonas;Pseudoxanthomonas yeongjuensis	2	0	0	3	0	0	0	0	5
Bacteria;Bacteria_none;Proteobacteria;Gammaproteobacteria;Pseudomonadales;Pseudomonadaceae;Pseudomonas;Pseudomonas alcaligenes	2	0	1	1	0	1	0	0	5
Bacteria;Bacteria_none;Firmicutes;Bacilli;Lactobacillales;Carnobacteriaceae;Jeotgalibaca;Jeotgalibaca porci	5	0	0	0	0	0	0	0	5
Bacteria;Bacteria_none;Proteobacteria;Alphaproteobacteria;Rhodobacterales;Rhodobacteraceae;Paracoccus;Paracoccus lichenicola	3	0	1	1	0	0	0	0	5
Bacteria;Bacteria_none;Proteobacteria;Gammaproteobacteria;Xanthomonadales;Xanthomonadaceae;Vulcaniibacterium;Vulcaniibacterium tengchongense	4	0	0	0	0	0	1	0	5
Bacteria;Bacteria_none;Firmicutes;Clostridia;Eubacteriales;Clostridiaceae;Clostridium;Clostridium tetanomorphum	2	0	1	1	1	0	0	0	5
Bacteria;Bacteria_none;Proteobacteria;Alphaproteobacteria;Rhodospirillales;Rhodospirillaceae;Marinibaculum;Marinibaculum pumilum	0	0	2	3	0	0	0	0	5
Bacteria;Bacteria_none;Firmicutes;Clostridia;Eubacteriales;Clostridiaceae;Clostridium;Clostridium thermopalmarium	0	1	2	1	0	1	0	0	5
Bacteria;Bacteria_none;Proteobacteria;Alphaproteobacteria;Rhodospirillales;Terasakiellaceae;Terasakiella;Terasakiella pusilla	0	4	0	1	0	0	0	0	5
Bacteria;Bacteria_none;Firmicutes;Clostridia;Eubacteriales;Clostridiaceae;Clostridium;Clostridium uliginosum	0	3	0	2	0	0	0	0	5
Bacteria;Bacteria_none;Firmicutes;Bacilli;Lactobacillales;Lactobacillaceae;Leuconostoc;Leuconostoc gasicomitatum	2	0	0	3	0	0	0	0	5
Bacteria;Bacteria_none;Actinobacteria;Actinomycetia;Micrococcales;Intrasporangiaceae;Aquipuribacter;Aquipuribacter nitratireducens	2	1	1	1	0	0	0	0	5
Bacteria;Bacteria_none;Proteobacteria;Alphaproteobacteria;Rhodobacterales;Rhodobacteraceae;Halodurantibacterium;Halodurantibacterium flavum	0	1	1	2	0	1	0	0	5
Bacteria;Bacteria_none;Proteobacteria;Alphaproteobacteria;Hyphomicrobiales;Phyllobacteriaceae;Mesorhizobium;Mesorhizobium opportunistum	2	0	0	0	0	3	0	0	5
Bacteria;Bacteria_none;Proteobacteria;Gammaproteobacteria;Oceanospirillales;Oceanospirillaceae;Marinobacterium;Marinobacterium alkalitolerans	0	0	0	5	0	0	0	0	5
Bacteria;Bacteria_none;Bacteroidota;Saprospiria;Saprospirales;Lewinellaceae;Neolewinella;Neolewinella antarctica	4	0	0	0	0	1	0	0	5
Bacteria;Bacteria_none;Proteobacteria;Alphaproteobacteria;Sphingomonadales;Erythrobacteraceae;Aurantiacibacter;Aurantiacibacter atlanticus	1	1	2	0	0	1	0	0	5
Bacteria;Bacteria_none;Proteobacteria;Alphaproteobacteria;Rhodobacterales;Rhodobacteraceae;Gemmobacter;Gemmobacter aquatilis	1	0	0	3	0	1	0	0	5
Bacteria;Bacteria_none;Proteobacteria;Alphaproteobacteria;Hyphomicrobiales;Chelatococcaceae;Camelimonas;Camelimonas abortus	0	2	0	1	0	2	0	0	5
Bacteria;Bacteria_none;Proteobacteria;Alphaproteobacteria;Rhodobacterales;Rhodobacteraceae;Paracoccus;Paracoccus koreensis	2	1	1	1	0	0	0	0	5
Bacteria;Bacteria_none;Bacteroidota;Flavobacteriia;Flavobacteriales;Flavobacteriaceae;Aequorivita;Aequorivita viscosa	0	0	0	5	0	0	0	0	5
Bacteria;Bacteria_none;Firmicutes;Bacilli;Lactobacillales;Carnobacteriaceae;Jeotgalibaca;Jeotgalibaca dankookensis	4	1	0	0	0	0	0	0	5
Bacteria;Bacteria_none;Actinobacteria;Actinomycetia;Micrococcales;Micrococcaceae;Arthrobacter;Arthrobacter mobilis	0	4	0	0	1	0	0	0	5
Bacteria;Bacteria_none;Actinobacteria;Actinomycetia;Micrococcales;Microbacteriaceae;Agromyces;Agromyces rhizosphaerae	0	2	0	3	0	0	0	0	5
Bacteria;Bacteria_none;Firmicutes;Clostridia;Eubacteriales;Clostridiaceae;Clostridium;Clostridium scatologenes	0	5	0	0	0	0	0	0	5
Bacteria;Bacteria_none;Cyanobacteria;Cyanobacteria_Incertae_sedis;Chroococcidiopsidales;Chroococcidiopsidales_Incertae_sedis;Compactococcus;Compactococcus sarcinoides	2	1	1	0	0	1	0	0	5
Bacteria;Bacteria_none;Proteobacteria;Alphaproteobacteria;Rhodobacterales;Rhodobacteraceae;Paracoccus;Paracoccus subflavus	2	1	1	0	0	0	0	1	5
Bacteria;Bacteria_none;Proteobacteria;Gammaproteobacteria;Xanthomonadales;Xanthomonadaceae;Stenotrophomonas;Stenotrophomonas nitritireducens	4	0	0	1	0	0	0	0	5
Bacteria;Bacteria_none;Proteobacteria;Alphaproteobacteria;Hyphomicrobiales;Hyphomicrobiaceae;Methyloceanibacter;Methyloceanibacter caenitepidi	0	4	1	0	0	0	0	0	5
Bacteria;Bacteria_none;Firmicutes;Bacilli;Lactobacillales;Carnobacteriaceae;Granulicatella;Granulicatella adiacens	4	0	0	0	0	0	0	1	5
Bacteria;Bacteria_none;Proteobacteria;Alphaproteobacteria;Rhodospirillales;Azospirillaceae;Oleisolibacter;Oleisolibacter albus	1	2	1	1	0	0	0	0	5
Bacteria;Bacteria_none;Bacteroidota;Cytophagia;Cytophagales;Thermonemataceae;Thermonema;Thermonema rossianum	0	5	0	0	0	0	0	0	5
Bacteria;Bacteria_none;Proteobacteria;Alphaproteobacteria;Rhodospirillales;Azospirillaceae;Skermanella;Skermanella pratensis	5	0	0	0	0	0	0	0	5
Bacteria;Bacteria_none;Firmicutes;Bacilli;Lactobacillales;Lactobacillaceae;Lapidilactobacillus;Lapidilactobacillus concavus	0	2	2	0	0	0	0	1	5
Bacteria;Bacteria_none;Proteobacteria;Gammaproteobacteria;Pseudomonadales;Marinobacteraceae;Marinobacter;Marinobacter salinexigens	1	1	1	0	2	0	0	0	5
Bacteria;Bacteria_none;Actinobacteria;Actinomycetia;Micromonosporales;Micromonosporaceae;Catellatospora;Catellatospora tritici	1	2	1	1	0	0	0	0	5
Bacteria;Bacteria_none;Actinobacteria;Actinomycetia;Micromonosporales;Micromonosporaceae;Dactylosporangium;Dactylosporangium fulvum	0	2	1	1	0	0	0	1	5
Bacteria;Bacteria_none;Proteobacteria;Alphaproteobacteria;Rhodospirillales;Rhodospirillaceae;Haematospirillum;Haematospirillum jordaniae	2	0	1	0	2	0	0	0	5
Bacteria;Bacteria_none;Firmicutes;Bacilli;Lactobacillales;Carnobacteriaceae;Atopococcus;Atopococcus tabaci	4	0	0	0	1	0	0	0	5
Bacteria;Bacteria_none;Proteobacteria;Deltaproteobacteria;Desulfobacterales;Desulfobulbaceae;Desulfurivibrio;Desulfurivibrio alkaliphilus	0	3	0	0	1	0	0	1	5
Bacteria;Bacteria_none;Proteobacteria;Alphaproteobacteria;Sphingomonadales;Sphingomonadaceae;Sphingopyxis;Sphingopyxis ginsengisoli	1	0	3	0	0	1	0	0	5
Bacteria;Bacteria_none;Proteobacteria;Gammaproteobacteria;Enterobacterales;Erwiniaceae;Erwinia;Erwinia amylovora	5	0	0	0	0	0	0	0	5
Bacteria;Bacteria_none;Bacteroidota;Bacteroidia;Bacteroidales;Prevotellaceae;Prevotella;Prevotella histicola	0	0	2	3	0	0	0	0	5
Bacteria;Bacteria_none;Actinobacteria;Actinomycetia;Corynebacteriales;Nocardiaceae;Nocardia;Nocardia salmonicida	0	0	4	1	0	0	0	0	5
Bacteria;Bacteria_none;Firmicutes;Bacilli;Bacillales;Alicyclobacillaceae;Tumebacillus;Tumebacillus amylolyticus	0	0	2	1	1	0	0	1	5
Bacteria;Bacteria_none;Actinobacteria;Coriobacteriia;Coriobacteriales;Coriobacteriaceae;Collinsella;Collinsella aerofaciens	1	0	2	1	0	0	0	1	5
Bacteria;Bacteria_none;Proteobacteria;Betaproteobacteria;Nitrosomonadales;Methylophilaceae;Methylotenera;Methylotenera versatilis	5	0	0	0	0	0	0	0	5
Bacteria;Bacteria_none;Actinobacteria;Actinomycetia;Propionibacteriales;Propionibacteriaceae;Tessaracoccus;Tessaracoccus oleiagri	2	3	0	0	0	0	0	0	5
Bacteria;Bacteria_none;Fusobacteria;Fusobacteriia;Fusobacteriales;Fusobacteriaceae;Fusobacterium;Fusobacterium equinum	1	3	0	1	0	0	0	0	5
Bacteria;Bacteria_none;Firmicutes;Erysipelotrichia;Erysipelotrichales;Erysipelotrichaceae;Holdemanella;Holdemanella biformis	5	0	0	0	0	0	0	0	5
Bacteria;Bacteria_none;Actinobacteria;Actinomycetia;Actinomycetales;Actinomycetaceae;Flaviflexus;Flaviflexus massiliensis	0	0	4	0	0	0	0	1	5
Bacteria;Bacteria_none;Proteobacteria;Gammaproteobacteria;Enterobacterales;Enterobacteriaceae;Pseudenterobacter;Pseudenterobacter timonensis	4	0	1	0	0	0	0	0	5
Bacteria;Bacteria_none;Actinobacteria;Actinomycetia;Corynebacteriales;Gordoniaceae;Gordonia;Gordonia terrae	0	0	0	5	0	0	0	0	5
Bacteria;Bacteria_none;Bacteroidota;Bacteroidia;Bacteroidales;Prevotellaceae;Prevotella;Prevotella buccae	0	3	0	0	0	0	0	2	5
Bacteria;Bacteria_none;Proteobacteria;Betaproteobacteria;Nitrosomonadales;Methylophilaceae;Methylophilus;Methylophilus leisingeri	4	1	0	0	0	0	0	0	5
Bacteria;Bacteria_none;Bacteroidota;Bacteroidia;Bacteroidales;Prevotellaceae;Prevotella;Prevotella bivia	0	0	0	0	1	1	0	3	5
Bacteria;Bacteria_none;Actinobacteria;Actinomycetia;Pseudonocardiales;Pseudonocardiaceae;Actinokineospora;Actinokineospora terrae	0	1	0	0	4	0	0	0	5
Bacteria;Bacteria_none;Proteobacteria;Betaproteobacteria;Burkholderiales;Comamonadaceae;Hydrogenophaga;Hydrogenophaga borbori	4	0	0	0	1	0	0	0	5
Bacteria;Bacteria_none;Proteobacteria;Gammaproteobacteria;Enterobacterales;Enterobacteriaceae;Mangrovibacter;Mangrovibacter phragmitis	5	0	0	0	0	0	0	0	5
Bacteria;Bacteria_none;Actinobacteria;Coriobacteriia;Coriobacteriales;Coriobacteriaceae;Senegalimassilia;Senegalimassilia anaerobia	0	2	2	1	0	0	0	0	5
Bacteria;Bacteria_none;Firmicutes;Bacilli;Bacillales;Bacillaceae;Alkalicoccus;Alkalicoccus chagannorensis	2	0	1	2	0	0	0	0	5
Bacteria;Bacteria_none;Actinobacteria;Actinomycetia;Pseudonocardiales;Pseudonocardiaceae;Amycolatopsis;Amycolatopsis tolypomycina	1	0	3	0	0	1	0	0	5
Bacteria;Bacteria_none;Proteobacteria;Gammaproteobacteria;Enterobacterales;Enterobacteriaceae;Klebsiella;Klebsiella oxytoca	4	0	0	1	0	0	0	0	5
Bacteria;Bacteria_none;Bacteroidota;Bacteroidia;Bacteroidales;Prevotellaceae;Prevotella;Prevotella loescheii	0	0	0	3	0	0	0	2	5
Bacteria;Bacteria_none;Proteobacteria;Gammaproteobacteria;Enterobacterales;Erwiniaceae;Erwinia;Erwinia endophytica	4	0	0	1	0	0	0	0	5
Bacteria;Bacteria_none;Firmicutes;Clostridia;Eubacteriales;Peptococcaceae;Desulfitispora;Desulfitispora alkaliphila	0	0	0	0	1	4	0	0	5
Bacteria;Bacteria_none;Fusobacteria;Fusobacteriia;Fusobacteriales;Leptotrichiaceae;Sneathia;Sneathia sanguinegens	5	0	0	0	0	0	0	0	5
Bacteria;Bacteria_none;Proteobacteria;Betaproteobacteria;Burkholderiales;Burkholderiales_Incertae_sedis;Paucibacter;Paucibacter oligotrophus	5	0	0	0	0	0	0	0	5
Bacteria;Bacteria_none;Actinobacteria;Actinomycetia;Micrococcales;Microbacteriaceae;Frigoribacterium;Frigoribacterium salinisoli	1	1	0	2	0	0	0	1	5
Bacteria;Bacteria_none;Deinococcus-Thermus;Deinococci;Thermales;Thermaceae;Thermus;Thermus aquaticus	0	5	0	0	0	0	0	0	5
Bacteria;Bacteria_none;Deinococcus-Thermus;Deinococci;Thermales;Thermaceae;Thermus;Thermus thermamylovorans	0	0	5	0	0	0	0	0	5
Bacteria;Bacteria_none;Firmicutes;Bacilli;Bacillales;Bacillaceae;Oceanobacillus;Oceanobacillus jeddahense	1	1	2	0	1	0	0	0	5
Bacteria;Bacteria_none;Actinobacteria;Actinomycetia;Propionibacteriales;Propionibacteriaceae;Luteococcus;Luteococcus sediminum	0	0	0	2	1	1	0	1	5
Bacteria;Bacteria_none;Firmicutes;Bacilli;Bacillales;Paenibacillaceae;Paenibacillus;Paenibacillus shunpengii	2	3	0	0	0	0	0	0	5
Bacteria;Bacteria_none;Firmicutes;Bacilli;Bacillales;Paenibacillaceae;Paenibacillus;Paenibacillus selenii	0	0	5	0	0	0	0	0	5
Bacteria;Bacteria_none;Proteobacteria;Gammaproteobacteria;Enterobacterales;Erwiniaceae;Phaseolibacter;Phaseolibacter flectens	5	0	0	0	0	0	0	0	5
Bacteria;Bacteria_none;Actinobacteria;Actinomycetia;Streptosporangiales;Treboniaceae;Trebonia;Trebonia kvetii	0	3	0	2	0	0	0	0	5
Bacteria;Bacteria_none;Proteobacteria;Gammaproteobacteria;Enterobacterales;Erwiniaceae;Pantoea;[Erwinia] mediterraneensis	5	0	0	0	0	0	0	0	5
Bacteria;Bacteria_none;Actinobacteria;Actinomycetia;Actinomycetales;Actinomycetaceae;Varibaculum;Varibaculum timonense	3	0	0	0	0	0	0	2	5
Bacteria;Bacteria_none;Bacteroidota;Bacteroidia;Bacteroidales;Prevotellaceae;Pseudoprevotella;Pseudoprevotella muciniphila	1	2	0	0	0	1	0	1	5
Bacteria;Bacteria_none;Firmicutes;Erysipelotrichia;Erysipelotrichales;Erysipelotrichaceae;Breznakia;Breznakia pachnodae	3	0	1	0	0	0	1	0	5
Bacteria;Bacteria_none;Proteobacteria;Betaproteobacteria;Burkholderiales;Comamonadaceae;Alicycliphilus;Alicycliphilus denitrificans	4	0	0	0	0	0	1	0	5
Bacteria;Bacteria_none;Proteobacteria;Gammaproteobacteria;Enterobacterales;Erwiniaceae;Pantoea;Pantoea coffeiphila	4	0	0	1	0	0	0	0	5
Bacteria;Bacteria_none;Firmicutes;Erysipelotrichia;Erysipelotrichales;Erysipelotrichaceae;Dubosiella;Dubosiella newyorkensis	1	1	2	0	0	0	0	1	5
Bacteria;Bacteria_none;Actinobacteria;Coriobacteriia;Coriobacteriales;Atopobiaceae;Olsenella;Olsenella porci	2	0	1	0	0	0	0	2	5
Bacteria;Bacteria_none;Gemmatimonadetes;Gemmatimonadetes;Gemmatimonadales;Gemmatimonadaceae;Gemmatirosa;Gemmatirosa kalamazoonensis	3	0	1	1	0	0	0	0	5
Bacteria;Bacteria_none;Proteobacteria;Gammaproteobacteria;Enterobacterales;Erwiniaceae;Mixta;Mixta mediterraneensis	2	0	0	2	0	0	0	1	5
Bacteria;Bacteria_none;Proteobacteria;Gammaproteobacteria;Enterobacterales;Erwiniaceae;Erwinia;Erwinia tracheiphila	4	0	0	1	0	0	0	0	5
Bacteria;Bacteria_none;Firmicutes;Tissierellia;Tissierellales;Tissierellaceae;Schnuerera;Schnuerera ultunensis	0	4	0	0	0	1	0	0	5
Bacteria;Bacteria_none;Bacteroidota;Bacteroidia;Bacteroidales;Porphyromonadaceae;Porphyromonas;Porphyromonas canoris	0	0	0	4	0	1	0	0	5
Bacteria;Bacteria_none;Firmicutes;Tissierellia;Tissierellales;Peptoniphilaceae;Peptoniphilus;Peptoniphilus phoceensis	5	0	0	0	0	0	0	0	5
Bacteria;Bacteria_none;Actinobacteria;Actinomycetia;Streptomycetales;Streptomycetaceae;Streptomyces;Streptomyces manipurensis	0	0	0	3	2	0	0	0	5
Bacteria;Bacteria_none;Proteobacteria;Betaproteobacteria;Burkholderiales;Oxalobacteraceae;Lacisediminimonas;Lacisediminimonas profundi	3	0	1	0	1	0	0	0	5
Bacteria;Bacteria_none;Firmicutes;Bacilli;Bacillales;Paenibacillaceae;Cohnella;Cohnella massiliensis	0	0	5	0	0	0	0	0	5
Bacteria;Bacteria_none;Actinobacteria;Actinomycetia;Streptomycetales;Streptomycetaceae;Streptomyces;Streptomyces apocyni	0	3	0	2	0	0	0	0	5
Bacteria;Bacteria_none;Actinobacteria;Actinomycetia;Streptomycetales;Streptomycetaceae;Streptomyces;Streptomyces asiaticus	0	1	1	3	0	0	0	0	5
Bacteria;Bacteria_none;Proteobacteria;Gammaproteobacteria;Cellvibrionales;Halieaceae;Sediminihaliea;Sediminihaliea albiluteola	5	0	0	0	0	0	0	0	5
Bacteria;Bacteria_none;Firmicutes;Bacilli;Bacillales;Listeriaceae;Listeria;Listeria grandensis	0	0	2	0	0	3	0	0	5
Bacteria;Bacteria_none;Firmicutes;Bacilli;Bacillales;Listeriaceae;Brochothrix;Brochothrix thermosphacta	0	0	4	0	0	0	1	0	5
Bacteria;Bacteria_none;Firmicutes;Clostridia;Eubacteriales;Lachnospiraceae;Suipraeoptans;Suipraeoptans intestinalis	5	0	0	0	0	0	0	0	5
Bacteria;Bacteria_none;Proteobacteria;Gammaproteobacteria;Alteromonadales;Pseudoalteromonadaceae;Pseudoalteromonas;Pseudoalteromonas tunicata	2	0	0	1	0	2	0	0	5
Bacteria;Bacteria_none;Actinobacteria;Actinomycetia;Micrococcales;Microbacteriaceae;Leucobacter;Leucobacter triazinivorans	0	1	1	3	0	0	0	0	5
Bacteria;Bacteria_none;Firmicutes;Clostridia;Eubacteriales;Lachnospiraceae;Velocimicrobium;Velocimicrobium porci	0	2	2	1	0	0	0	0	5
Bacteria;Bacteria_none;Actinobacteria;Actinomycetia;Corynebacteriales;Nocardiaceae;Williamsia;Williamsia marianensis	0	0	2	3	0	0	0	0	5
Bacteria;Bacteria_none;Proteobacteria;Betaproteobacteria;Burkholderiales;Oxalobacteraceae;Pseudoduganella;Pseudoduganella dura	3	0	0	0	0	0	2	0	5
Bacteria;Bacteria_none;Actinobacteria;Actinomycetia;Streptomycetales;Streptomycetaceae;Streptomyces;Streptomyces humidus	0	0	2	3	0	0	0	0	5
Bacteria;Bacteria_none;Firmicutes;Negativicutes;Veillonellales;Veillonellaceae;Anaeroglobus;Anaeroglobus geminatus	0	4	1	0	0	0	0	0	5
Bacteria;Bacteria_none;Firmicutes;Bacilli;Bacillales;Bacillaceae;Bacillus;Bacillus alkalicellulosilyticus	0	3	0	1	0	1	0	0	5
Bacteria;Bacteria_none;Actinobacteria;Actinomycetia;Streptomycetales;Streptomycetaceae;Streptomyces;Streptomyces griseoviridis	0	0	0	4	0	1	0	0	5
Bacteria;Bacteria_none;Actinobacteria;Actinomycetia;Corynebacteriales;Tsukamurellaceae;Tsukamurella;Tsukamurella pulmonis	2	0	2	1	0	0	0	0	5
Bacteria;Bacteria_none;Firmicutes;Bacilli;Bacillales;Bacillaceae;Bacillus;Bacillus benzoevorans	0	4	0	0	0	1	0	0	5
Bacteria;Bacteria_none;Actinobacteria;Actinomycetia;Streptomycetales;Streptomycetaceae;Streptomyces;Streptomyces fradiae	0	1	1	1	0	1	0	1	5
Bacteria;Bacteria_none;Actinobacteria;Actinomycetia;Actinomycetales;Actinomycetaceae;Actinomyces;Actinomyces ruminicola	3	2	0	0	0	0	0	0	5
Bacteria;Bacteria_none;Firmicutes;Clostridia;Eubacteriales;Lachnospiraceae;Merdimonas;Merdimonas faecis	2	2	0	1	0	0	0	0	5
Bacteria;Bacteria_none;Firmicutes;Bacilli;Bacillales;Bacillaceae;Anoxybacillus;Anoxybacillus eryuanensis	1	1	3	0	0	0	0	0	5
Bacteria;Bacteria_none;Firmicutes;Bacilli;Bacillales;Paenibacillaceae;Paenibacillus;Paenibacillus albidus	0	0	5	0	0	0	0	0	5
Bacteria;Bacteria_none;Firmicutes;Clostridia;Eubacteriales;Lachnospiraceae;Lacrimispora;Lacrimispora amygdalina	0	0	0	5	0	0	0	0	5
Bacteria;Bacteria_none;Proteobacteria;Gammaproteobacteria;Enterobacterales;Enterobacteriaceae;Citrobacter;Citrobacter cronae	4	0	0	0	0	0	1	0	5
Bacteria;Bacteria_none;Firmicutes;Clostridia;Eubacteriales;Lachnospiraceae;Jutongia;Jutongia hominis	0	0	1	1	0	0	2	1	5
Bacteria;Bacteria_none;Bacteroidota;Bacteroidia;Bacteroidales;Muribaculaceae;Heminiphilus;Heminiphilus faecis	0	5	0	0	0	0	0	0	5
Bacteria;Bacteria_none;Actinobacteria;Actinomycetia;Micrococcales;Microbacteriaceae;Microbacterium;Microbacterium atlanticum	0	1	2	2	0	0	0	0	5
Bacteria;Bacteria_none;Firmicutes;Clostridia;Eubacteriales;Oscillospiraceae;Provencibacterium;Provencibacterium massiliense	0	5	0	0	0	0	0	0	5
Bacteria;Bacteria_none;Firmicutes;Tissierellia;Tissierellales;Peptoniphilaceae;Peptoniphilus;Peptoniphilus asaccharolyticus	0	2	3	0	0	0	0	0	5
Bacteria;Bacteria_none;Proteobacteria;Betaproteobacteria;Neisseriales;Chromobacteriaceae;Iodobacter;Iodobacter ciconiae	2	1	1	0	1	0	0	0	5
Bacteria;Bacteria_none;Firmicutes;Bacilli;Bacillales;Paenibacillaceae;Paenibacillus;Paenibacillus cellulositrophicus	2	0	0	1	2	0	0	0	5
Bacteria;Bacteria_none;Proteobacteria;Deltaproteobacteria;Syntrophobacterales;Syntrophobacteraceae;Desulfoglaeba;Desulfoglaeba alkanexedens	0	2	1	0	2	0	0	0	5
Bacteria;Bacteria_none;Proteobacteria;Alphaproteobacteria;Hyphomicrobiales;Afifellaceae;Afifella;Afifella pfennigii	0	3	0	1	0	1	0	0	5
Bacteria;Bacteria_none;Firmicutes;Bacilli;Bacillales;Bacillaceae;Anaerobacillus;Anaerobacillus isosaccharinicus	0	1	4	0	0	0	0	0	5
Bacteria;Bacteria_none;Firmicutes;Bacilli;Bacillales;Bacillaceae;Priestia;Priestia veravalensis	0	0	0	0	5	0	0	0	5
Bacteria;Bacteria_none;Proteobacteria;Gammaproteobacteria;Chromatiales;Chromatiales_Incertae_sedis;Thiohalobacter;Thiohalobacter thiocyanaticus	3	2	0	0	0	0	0	0	5
Bacteria;Bacteria_none;Firmicutes;Bacilli;Bacillales;Bacillaceae;Bacillus;Bacillus rhizoplanae	0	0	5	0	0	0	0	0	5
Bacteria;Bacteria_none;Firmicutes;Bacilli;Bacillales;Bacillaceae;Psychrobacillus;Psychrobacillus vulpis	0	0	0	3	0	2	0	0	5
Bacteria;Bacteria_none;Firmicutes;Tissierellia;Tissierellales;Peptoniphilaceae;Anaerococcus;Anaerococcus senegalensis	0	3	1	0	1	0	0	0	5
Bacteria;Bacteria_none;Firmicutes;Negativicutes;Selenomonadales;Selenomonadaceae;Pectinatus;Pectinatus sottacetonis	0	0	1	3	0	0	1	0	5
Bacteria;Bacteria_none;Firmicutes;Clostridia;Eubacteriales;Lachnospiraceae;Mediterraneibacter;Mediterraneibacter catenae	2	0	3	0	0	0	0	0	5
Bacteria;Bacteria_none;Actinobacteria;Nitriliruptoria;Nitriliruptorales;Nitriliruptoraceae;Nitriliruptor;Nitriliruptor alkaliphilus	0	2	2	0	0	0	1	0	5
Bacteria;Bacteria_none;Firmicutes;Negativicutes;Veillonellales;Veillonellaceae;Veillonella;Veillonella rodentium	5	0	0	0	0	0	0	0	5
Bacteria;Bacteria_none;Firmicutes;Clostridia;Eubacteriales;Heliobacteriaceae;Heliophilum;Heliophilum fasciatum	0	1	3	1	0	0	0	0	5
Bacteria;Bacteria_none;Proteobacteria;Betaproteobacteria;Nitrosomonadales;Sulfuricellaceae;Sulfuriferula;Sulfuriferula plumbiphila	5	0	0	0	0	0	0	0	5
Bacteria;Bacteria_none;Firmicutes;Bacilli;Bacillales;Bacillaceae;Edaphobacillus;Edaphobacillus lindanitolerans	0	0	5	0	0	0	0	0	5
Bacteria;Bacteria_none;Actinobacteria;Actinomycetia;Streptomycetales;Streptomycetaceae;Streptomyces;Streptomyces tunisiensis	0	1	1	3	0	0	0	0	5
Bacteria;Bacteria_none;Actinobacteria;Actinomycetia;Propionibacteriales;Nocardioidaceae;Nocardioides;Nocardioides ginsengagri	0	2	1	2	0	0	0	0	5
Bacteria;Bacteria_none;Proteobacteria;Gammaproteobacteria;Legionellales;Legionellaceae;Legionella;Legionella cherrii	1	0	3	1	0	0	0	0	5
Bacteria;Bacteria_none;Actinobacteria;Actinomycetia;Bifidobacteriales;Bifidobacteriaceae;Bifidobacterium;Bifidobacterium bombi	0	4	0	1	0	0	0	0	5
Bacteria;Bacteria_none;Firmicutes;Clostridia;Eubacteriales;Eubacteriales Family XII. Incertae Sedis;Fusibacter;Fusibacter fontis	1	2	1	0	1	0	0	0	5
Bacteria;Bacteria_none;Firmicutes;Clostridia;Thermoanaerobacterales;Thermoanaerobacteraceae;Ammonifex;Ammonifex thiophilus	0	0	0	5	0	0	0	0	5
Bacteria;Bacteria_none;Proteobacteria;Deltaproteobacteria;Desulfovibrionales;Desulfovibrionaceae;Mailhella;Mailhella massiliensis	0	3	1	0	1	0	0	0	5
Bacteria;Bacteria_none;Proteobacteria;Gammaproteobacteria;Enterobacterales;Yersiniaceae;Yersinia;Yersinia rohdei	2	0	0	2	0	0	0	1	5
Bacteria;Bacteria_none;Firmicutes;Clostridia;Thermoanaerobacterales;Thermoanaerobacteraceae;Carboxydothermus;Carboxydothermus ferrireducens	0	0	3	0	0	2	0	0	5
Bacteria;Bacteria_none;Proteobacteria;Gammaproteobacteria;Enterobacterales;Yersiniaceae;Serratia;Serratia odorifera	4	1	0	0	0	0	0	0	5
Bacteria;Bacteria_none;Firmicutes;Bacilli;Bacillales;Planococcaceae;Kurthia;Kurthia huakuii	5	0	0	0	0	0	0	0	5
Bacteria;Bacteria_none;Proteobacteria;Gammaproteobacteria;Enterobacterales;Yersiniaceae;Serratia;Serratia microhaemolytica	2	0	0	3	0	0	0	0	5
Bacteria;Bacteria_none;Proteobacteria;Betaproteobacteria;Burkholderiales;Burkholderiaceae;Mycetohabitans;Mycetohabitans endofungorum	4	0	1	0	0	0	0	0	5
Bacteria;Bacteria_none;Firmicutes;Bacilli;Bacillales;Bacillaceae;Metabacillus;Metabacillus herbersteinensis	0	0	2	0	0	3	0	0	5
Bacteria;Bacteria_none;Firmicutes;Bacilli;Bacillales;Planococcaceae;Kurthia;Kurthia sibirica	0	0	0	0	0	0	0	5	5
Bacteria;Bacteria_none;Firmicutes;Clostridia;Eubacteriales;Eubacteriales Family XIII. Incertae Sedis;Eubacteriales Family XIII. Incertae Sedis_Incertae_sedis;[Eubacterium] sulci	0	1	0	3	0	1	0	0	5
Bacteria;Bacteria_none;Proteobacteria;Betaproteobacteria;Rhodocyclales;Zoogloeaceae;Pseudothauera;Pseudothauera nasutitermitis	3	0	2	0	0	0	0	0	5
Bacteria;Bacteria_none;Firmicutes;Clostridia;Eubacteriales;Eubacteriales Family XIII. Incertae Sedis;Hornefia;Hornefia porci	0	0	5	0	0	0	0	0	5
Bacteria;Bacteria_none;Planctomycetota;Planctomycetia;Pirellulales;Pirellulaceae;Stieleria;Stieleria varia	0	5	0	0	0	0	0	0	5
Bacteria;Bacteria_none;Firmicutes;Bacilli;Bacillales;Planococcaceae;Ureibacillus;Ureibacillus suwonensis	1	0	1	2	0	0	0	1	5
Bacteria;Bacteria_none;Proteobacteria;Alphaproteobacteria;Caulobacterales;Caulobacteraceae;Brevundimonas;Brevundimonas aveniformis	0	0	0	3	1	1	0	0	5
Bacteria;Bacteria_none;Firmicutes;Bacilli;Bacillales;Bacillaceae;Halobacillus;Halobacillus mangrovi	2	1	1	0	0	1	0	0	5
Bacteria;Bacteria_none;Actinobacteria;Actinomycetia;Propionibacteriales;Nocardioidaceae;Nocardioides;Nocardioides coralli	1	3	0	0	0	0	0	1	5
Bacteria;Bacteria_none;Firmicutes;Clostridia;Eubacteriales;Thermincolaceae;Thermincola;Thermincola carboxydiphila	0	3	0	0	0	2	0	0	5
Bacteria;Bacteria_none;Proteobacteria;Deltaproteobacteria;Desulfovibrionales;Desulfonauticaceae;Desulfonauticus;Desulfonauticus submarinus	0	5	0	0	0	0	0	0	5
Bacteria;Bacteria_none;Proteobacteria;Deltaproteobacteria;Desulfobacterales;Desulfobacteraceae;Desulforegula;Desulforegula conservatrix	0	4	0	1	0	0	0	0	5
Bacteria;Bacteria_none;Actinobacteria;Actinomycetia;Streptosporangiales;Streptosporangiaceae;Nonomuraea;Nonomuraea wenchangensis	0	2	1	2	0	0	0	0	5
Bacteria;Bacteria_none;Proteobacteria;Alphaproteobacteria;Sphingomonadales;Sphingosinicellaceae;Sandaracinobacter;Sandaracinobacter neustonicus	0	1	3	1	0	0	0	0	5
Bacteria;Bacteria_none;Actinobacteria;Actinomycetia;Streptosporangiales;Streptosporangiaceae;Planotetraspora;Planotetraspora mira	0	0	1	2	0	1	0	1	5
Bacteria;Bacteria_none;Firmicutes;Bacilli;Bacillales;Bacillaceae;Heyndrickxia;Heyndrickxia oleronia	0	0	2	1	0	2	0	0	5
Bacteria;Bacteria_none;Actinobacteria;Actinomycetia;Propionibacteriales;Nocardioidaceae;Mumia;Mumia zhuanghuii	0	3	0	0	0	1	0	1	5
Bacteria;Bacteria_none;Firmicutes;Clostridia;Halanaerobiales;Halobacteroidaceae;Fuchsiella;Fuchsiella alkaliacetigena	2	3	0	0	0	0	0	0	5
Bacteria;Bacteria_none;Proteobacteria;Deltaproteobacteria;Desulfovibrionales;Desulfovibrionaceae;Desulfohalovibrio;Desulfohalovibrio reitneri	3	0	0	0	1	1	0	0	5
Bacteria;Bacteria_none;Proteobacteria;Alphaproteobacteria;Caulobacterales;Caulobacteraceae;Phenylobacterium;Phenylobacterium glaciei	2	3	0	0	0	0	0	0	5
Bacteria;Bacteria_none;Actinobacteria;Actinomycetia;Micrococcales;Cellulomonadaceae;Cellulomonas;Cellulomonas carbonis	0	4	1	0	0	0	0	0	5
Bacteria;Bacteria_none;Proteobacteria;Gammaproteobacteria;Legionellales;Legionellaceae;Legionella;Legionella shakespearei	1	1	1	2	0	0	0	0	5
Bacteria;Bacteria_none;Actinobacteria;Actinomycetia;Streptosporangiales;Nocardiopsaceae;Nocardiopsis;Nocardiopsis kunsanensis	0	2	0	2	0	0	0	1	5
Bacteria;Bacteria_none;Proteobacteria;Betaproteobacteria;Burkholderiales;Alcaligenaceae;Corticimicrobacter;Corticimicrobacter populi	2	0	0	1	0	1	1	0	5
Bacteria;Bacteria_none;Firmicutes;Clostridia;Halanaerobiales;Halobacteroidaceae;Orenia;Orenia salinaria	0	0	1	0	0	3	1	0	5
Bacteria;Bacteria_none;Bacteroidota;Chitinophagia;Chitinophagales;Chitinophagaceae;Flavihumibacter;Flavihumibacter soli	5	0	0	0	0	0	0	0	5
Bacteria;Bacteria_none;Firmicutes;Bacilli;Bacillales;Bacillaceae;Gracilibacillus;Gracilibacillus bigeumensis	0	1	3	0	0	1	0	0	5
Bacteria;Bacteria_none;Actinobacteria;Actinomycetia;Streptomycetales;Streptomycetaceae;Streptomyces;Streptomyces filamentosus	0	2	2	1	0	0	0	0	5
Bacteria;Bacteria_none;Actinobacteria;Actinomycetia;Corynebacteriales;Gordoniaceae;Gordonia;Gordonia alkaliphila	0	0	2	3	0	0	0	0	5
Bacteria;Bacteria_none;Actinobacteria;Actinomycetia;Streptomycetales;Streptomycetaceae;Streptomyces;Streptomyces rhizosphaerihabitans	3	2	0	0	0	0	0	0	5
Bacteria;Bacteria_none;Proteobacteria;Deltaproteobacteria;Desulfurellales;Desulfurellaceae;Desulfurella;Desulfurella propionica	1	4	0	0	0	0	0	0	5
Bacteria;Bacteria_none;Proteobacteria;Gammaproteobacteria;Enterobacterales;Pectobacteriaceae;Brenneria;Brenneria nigrifluens	5	0	0	0	0	0	0	0	5
Bacteria;Bacteria_none;Bacteroidota;Bacteroidia;Marinilabiliales;Marinifilaceae;Marinifilum;Marinifilum breve	0	5	0	0	0	0	0	0	5
Bacteria;Bacteria_none;Cyanobacteria;Gloeobacteria;Gloeobacterales;Gloeobacteraceae;Anthocerotibacter;Anthocerotibacter panamensis	0	0	2	0	0	1	2	0	5
Bacteria;Bacteria_none;Firmicutes;Bacilli;Bacillales;Bacillaceae;Neobacillus;Neobacillus cucumis	0	0	0	0	5	0	0	0	5
Bacteria;Bacteria_none;Proteobacteria;Deltaproteobacteria;Desulfuromonadales;Geobacteraceae;Geobacter;Geobacter soli	0	0	0	5	0	0	0	0	5
Bacteria;Bacteria_none;Proteobacteria;Gammaproteobacteria;Enterobacterales;Morganellaceae;Xenorhabdus;Xenorhabdus nematophila	1	0	0	3	1	0	0	0	5
Bacteria;Bacteria_none;Bacteroidota;Bacteroidia;Marinilabiliales;Marinilabiliaceae;Marinilabilia;Marinilabilia nitratireducens	5	0	0	0	0	0	0	0	5
Bacteria;Bacteria_none;Firmicutes;Bacilli;Bacillales;Bacillaceae;Neobacillus;Neobacillus drentensis	0	0	0	5	0	0	0	0	5
Bacteria;Bacteria_none;Proteobacteria;Gammaproteobacteria;Enterobacterales;Morganellaceae;Xenorhabdus;Xenorhabdus indica	5	0	0	0	0	0	0	0	5
Bacteria;Bacteria_none;Bacteroidota;Bacteroidia;Bacteroidales;Tannerellaceae;Parabacteroides;Parabacteroides faecis	0	0	0	0	0	0	0	5	5
Bacteria;Bacteria_none;Cyanobacteria;Cyanobacteria_Incertae_sedis;Synechococcales;Synechococcales_Incertae_sedis;Calenema;Calenema singularis	2	1	2	0	0	0	0	0	5
Bacteria;Bacteria_none;Firmicutes;Bacilli;Bacillales;Bacillaceae;Gottfriedia;Gottfriedia solisilvae	0	3	0	0	0	0	1	1	5
Bacteria;Bacteria_none;Proteobacteria;Betaproteobacteria;Burkholderiales;Burkholderiaceae;Paraburkholderia;Paraburkholderia susongensis	5	0	0	0	0	0	0	0	5
Bacteria;Bacteria_none;Actinobacteria;Actinomycetia;Streptosporangiales;Thermomonosporaceae;Actinomadura;Actinomadura rubrobrunea	0	2	1	0	0	1	0	0	4
Bacteria;Bacteria_none;Actinobacteria;Actinomycetia;Streptomycetales;Streptomycetaceae;Streptomyces;Streptomyces griseoloalbus	0	0	0	4	0	0	0	0	4
Bacteria;Bacteria_none;Proteobacteria;Deltaproteobacteria;Desulfobacterales;Desulfobacteraceae;Desulfococcus;Desulfococcus multivorans	0	1	3	0	0	0	0	0	4
Bacteria;Bacteria_none;Actinobacteria;Actinomycetia;Streptosporangiales;Thermomonosporaceae;Actinomadura;Actinomadura rifamycini	0	0	0	2	0	0	2	0	4
Bacteria;Bacteria_none;Proteobacteria;Epsilonproteobacteria;Campylobacterales;Arcobacteraceae;Malaciobacter;Malaciobacter molluscorum	0	4	0	0	0	0	0	0	4
Bacteria;Bacteria_none;Actinobacteria;Actinomycetia;Streptosporangiales;Streptosporangiaceae;Sphaerisporangium;Sphaerisporangium viridialbum	1	1	0	1	0	0	1	0	4
Bacteria;Bacteria_none;Proteobacteria;Deltaproteobacteria;Deltaproteobacteria_Incertae_sedis;Deltaproteobacteria_Incertae_sedis;Dissulfuribacter;Dissulfuribacter thermophilus	2	1	1	0	0	0	0	0	4
Bacteria;Bacteria_none;Proteobacteria;Gammaproteobacteria;Xanthomonadales;Xanthomonadaceae;Stenotrophomonas;Stenotrophomonas humi	4	0	0	0	0	0	0	0	4
Bacteria;Bacteria_none;Actinobacteria;Actinomycetia;Streptomycetales;Streptomycetaceae;Streptomyces;Streptomyces klenkii	1	1	0	2	0	0	0	0	4
Bacteria;Bacteria_none;Actinobacteria;Actinomycetia;Micrococcales;Microbacteriaceae;Microbacterium;Microbacterium sulfonylureivorans	1	0	0	1	0	1	0	1	4
Bacteria;Bacteria_none;Actinobacteria;Actinomycetia;Streptosporangiales;Thermomonosporaceae;Actinomadura;Actinomadura latina	0	2	1	0	1	0	0	0	4
Bacteria;Bacteria_none;Proteobacteria;Epsilonproteobacteria;Campylobacterales;Arcobacteraceae;Arcobacter;Arcobacter ellisii	0	0	0	0	0	1	0	3	4
Bacteria;Bacteria_none;Proteobacteria;Gammaproteobacteria;Xanthomonadales;Xanthomonadaceae;Stenotrophomonas;Stenotrophomonas lactitubi	2	0	2	0	0	0	0	0	4
Bacteria;Bacteria_none;Proteobacteria;Betaproteobacteria;Ferritrophicales;Ferritrophicaceae;Ferritrophicum;Ferritrophicum radicicola	1	2	0	1	0	0	0	0	4
Bacteria;Bacteria_none;Proteobacteria;Betaproteobacteria;Rhodocyclales;Zoogloeaceae;Zoogloea;Zoogloea dura	4	0	0	0	0	0	0	0	4
Bacteria;Bacteria_none;Proteobacteria;Deltaproteobacteria;Desulfurellales;Desulfurellaceae;Hippea;Hippea maritima	1	1	2	0	0	0	0	0	4
Bacteria;Bacteria_none;Actinobacteria;Actinomycetia;Streptosporangiales;Streptosporangiaceae;Nonomuraea;Nonomuraea zeae	0	1	1	2	0	0	0	0	4
Bacteria;Bacteria_none;Proteobacteria;Epsilonproteobacteria;Campylobacterales;Arcobacteraceae;Aliarcobacter;Aliarcobacter thereius	0	0	0	2	0	0	1	1	4
Bacteria;Bacteria_none;Proteobacteria;Betaproteobacteria;Nitrosomonadales;Sulfuricellaceae;Sulfurirhabdus;Sulfurirhabdus autotrophica	1	1	0	1	0	0	1	0	4
Bacteria;Bacteria_none;Proteobacteria;Epsilonproteobacteria;Campylobacterales;Campylobacteraceae;Campylobacter;Campylobacter cuniculorum	0	4	0	0	0	0	0	0	4
Bacteria;Bacteria_none;Proteobacteria;Deltaproteobacteria;Desulfuromonadales;Desulfuromonadaceae;Desulfuromonas;Desulfuromonas chloroethenica	3	1	0	0	0	0	0	0	4
Bacteria;Bacteria_none;Verrucomicrobia;Spartobacteria;Chthoniobacterales;Chthoniobacteraceae;Chthoniobacter;Chthoniobacter flavus	0	2	2	0	0	0	0	0	4
Bacteria;Bacteria_none;Proteobacteria;Betaproteobacteria;Burkholderiales;Sutterellaceae;Parasutterella;Parasutterella excrementihominis	4	0	0	0	0	0	0	0	4
Bacteria;Bacteria_none;Proteobacteria;Epsilonproteobacteria;Campylobacterales;Campylobacteraceae;Campylobacter;Campylobacter sputorum	0	4	0	0	0	0	0	0	4
Bacteria;Bacteria_none;Actinobacteria;Actinomycetia;Micrococcales;Microbacteriaceae;Microbacterium;Microbacterium kribbense	1	1	1	1	0	0	0	0	4
Bacteria;Bacteria_none;Actinobacteria;Actinomycetia;Streptomycetales;Streptomycetaceae;Streptomyces;Streptomyces hydrogenans	0	0	1	3	0	0	0	0	4
Bacteria;Bacteria_none;Verrucomicrobia;Verrucomicrobiae;Verrucomicrobiales;Verrucomicrobiaceae;Roseimicrobium;Roseimicrobium gellanilyticum	2	0	2	0	0	0	0	0	4
Bacteria;Bacteria_none;Actinobacteria;Actinomycetia;Micrococcales;Microbacteriaceae;Microbacterium;Microbacterium mangrovi	0	0	0	4	0	0	0	0	4
Bacteria;Bacteria_none;Proteobacteria;Betaproteobacteria;Burkholderiales;Sphaerotilaceae;Mitsuaria;Mitsuaria noduli	4	0	0	0	0	0	0	0	4
Bacteria;Bacteria_none;Actinobacteria;Rubrobacteria;Rubrobacterales;Rubrobacteraceae;Rubrobacter;Rubrobacter radiotolerans	0	2	0	2	0	0	0	0	4
Bacteria;Bacteria_none;Proteobacteria;Deltaproteobacteria;Desulfovibrionales;Desulfovibrionaceae;Desulfocurvibacter;Desulfocurvibacter africanus	0	3	0	1	0	0	0	0	4
Bacteria;Bacteria_none;Proteobacteria;Gammaproteobacteria;Xanthomonadales;Xanthomonadaceae;Silanimonas;Silanimonas mangrovi	2	1	0	0	0	0	0	1	4
Bacteria;Bacteria_none;Proteobacteria;Alphaproteobacteria;Rhodobacterales;Rhodobacteraceae;Albirhodobacter;Albirhodobacter marinus	0	0	3	0	1	0	0	0	4
Bacteria;Bacteria_none;Bacteroidota;Flavobacteriia;Flavobacteriales;Flavobacteriaceae;Ochrovirga;Ochrovirga pacifica	0	0	1	0	0	3	0	0	4
Bacteria;Bacteria_none;Actinobacteria;Actinomycetia;Streptomycetales;Streptomycetaceae;Streptomyces;Streptomyces prasinopilosus	0	2	1	1	0	0	0	0	4
Bacteria;Bacteria_none;Actinobacteria;Actinomycetia;Streptosporangiales;Thermomonosporaceae;Actinomadura;Actinomadura sediminis	2	0	2	0	0	0	0	0	4
Bacteria;Bacteria_none;Proteobacteria;Deltaproteobacteria;Desulfovibrionales;Desulfovibrionaceae;Desulfolutivibrio;Desulfolutivibrio sulfoxidireducens	0	0	0	0	0	1	3	0	4
Bacteria;Bacteria_none;Actinobacteria;Actinomycetia;Streptosporangiales;Nocardiopsaceae;Nocardiopsis;Nocardiopsis yanglingensis	1	1	1	1	0	0	0	0	4
Bacteria;Bacteria_none;Actinobacteria;Actinomycetia;Micrococcales;Microbacteriaceae;Microbacterium;Microbacterium trichothecenolyticum	2	2	0	0	0	0	0	0	4
Bacteria;Bacteria_none;Bacteroidota;Flavobacteriia;Flavobacteriales;Schleiferiaceae;Schleiferia;Schleiferia thermophila	2	0	1	1	0	0	0	0	4
Bacteria;Bacteria_none;Proteobacteria;Betaproteobacteria;Nitrosomonadales;Nitrosomonadaceae;Nitrosomonas;Nitrosomonas eutropha	3	0	0	0	0	1	0	0	4
Bacteria;Bacteria_none;Proteobacteria;Deltaproteobacteria;Syntrophobacterales;Syntrophobacteraceae;Desulfosoma;Desulfosoma profundi	1	3	0	0	0	0	0	0	4
Bacteria;Bacteria_none;Proteobacteria;Betaproteobacteria;Rhodocyclales;Zoogloeaceae;Thauera;Thauera aromatica	2	0	1	0	1	0	0	0	4
Bacteria;Bacteria_none;Actinobacteria;Actinomycetia;Actinomycetales;Actinomycetaceae;Actinomyces;Actinomyces bovis	2	0	1	0	0	1	0	0	4
Bacteria;Bacteria_none;Proteobacteria;Deltaproteobacteria;Desulfovibrionales;Desulfovibrionaceae;Pseudodesulfovibrio;Pseudodesulfovibrio alkaliphilus	0	4	0	0	0	0	0	0	4
Bacteria;Bacteria_none;Proteobacteria;Alphaproteobacteria;Hyphomicrobiales;Xanthobacteraceae;Azorhizobium;Azorhizobium doebereinerae	0	1	2	0	0	1	0	0	4
Bacteria;Bacteria_none;Proteobacteria;Betaproteobacteria;Neisseriales;Neisseriaceae;Neisseria;Neisseria wadsworthii	4	0	0	0	0	0	0	0	4
Bacteria;Bacteria_none;Proteobacteria;Deltaproteobacteria;Myxococcales;Polyangiaceae;Sorangium;Sorangium cellulosum	0	0	4	0	0	0	0	0	4
Bacteria;Bacteria_none;Proteobacteria;Deltaproteobacteria;Myxococcales;Polyangiaceae;Polyangium;Polyangium jinanense	4	0	0	0	0	0	0	0	4
Bacteria;Bacteria_none;Bacteroidota;Flavobacteriia;Flavobacteriales;Flavobacteriaceae;Flavobacterium;Flavobacterium compostarboris	2	0	2	0	0	0	0	0	4
Bacteria;Bacteria_none;Tenericutes;Mollicutes;Mycoplasmatales;Mycoplasmataceae;Mycoplasma;Mycoplasma miroungirhinis	0	1	1	1	0	1	0	0	4
Bacteria;Bacteria_none;Proteobacteria;Betaproteobacteria;Nitrosomonadales;Methylophilaceae;Methylobacillus;Methylobacillus methanolivorans	4	0	0	0	0	0	0	0	4
Bacteria;Bacteria_none;Proteobacteria;Deltaproteobacteria;Desulfovibrionales;Desulfovibrionaceae;Pseudodesulfovibrio;Pseudodesulfovibrio piezophilus	0	3	1	0	0	0	0	0	4
Bacteria;Bacteria_none;Proteobacteria;Alphaproteobacteria;Hyphomicrobiales;Stappiaceae;Pseudovibrio;Pseudovibrio exalbescens	0	0	1	3	0	0	0	0	4
Bacteria;Bacteria_none;Proteobacteria;Alphaproteobacteria;Hyphomicrobiales;Xanthobacteraceae;Xanthobacter;Xanthobacter tagetidis	0	0	0	4	0	0	0	0	4
Bacteria;Bacteria_none;Proteobacteria;Alphaproteobacteria;Rhodobacterales;Rhodobacteraceae;Paracoccus;Paracoccus aestuarii	0	0	0	4	0	0	0	0	4
Bacteria;Bacteria_none;Proteobacteria;Alphaproteobacteria;Hyphomicrobiales;Xanthobacteraceae;Starkeya;Starkeya novella	3	0	1	0	0	0	0	0	4
Bacteria;Bacteria_none;Proteobacteria;Deltaproteobacteria;Myxococcales;Myxococcaceae;Simulacricoccus;Simulacricoccus ruber	2	1	1	0	0	0	0	0	4
Bacteria;Bacteria_none;Actinobacteria;Actinomycetia;Actinomycetales;Actinomycetaceae;Actinomyces;Actinomyces oricola	4	0	0	0	0	0	0	0	4
Bacteria;Bacteria_none;Bacteroidota;Flavobacteriia;Flavobacteriales;Flavobacteriaceae;Luteirhabdus;Luteirhabdus pelagi	0	3	1	0	0	0	0	0	4
Bacteria;Bacteria_none;Proteobacteria;Deltaproteobacteria;Myxococcales;Polyangiaceae;Byssovorax;Byssovorax cruenta	2	2	0	0	0	0	0	0	4
Bacteria;Bacteria_none;Proteobacteria;Alphaproteobacteria;Hyphomicrobiales;Xanthobacteraceae;Xanthobacter;Xanthobacter polyaromaticivorans	1	0	0	0	0	3	0	0	4
Bacteria;Bacteria_none;Bacteroidota;Flavobacteriia;Flavobacteriales;Flavobacteriaceae;Flavobacterium;Flavobacterium hibernum	0	0	0	4	0	0	0	0	4
Bacteria;Bacteria_none;Tenericutes;Mollicutes;Entomoplasmatales;Spiroplasmataceae;Spiroplasma;Spiroplasma clarkii	0	0	1	0	1	2	0	0	4
Bacteria;Bacteria_none;Bacteroidota;Flavobacteriia;Flavobacteriales;Flavobacteriaceae;Croceitalea;Croceitalea marina	1	0	0	0	0	3	0	0	4
Bacteria;Bacteria_none;Proteobacteria;Alphaproteobacteria;Hyphomicrobiales;Xanthobacteraceae;Ancylobacter;Ancylobacter oerskovii	0	0	0	3	0	1	0	0	4
Bacteria;Bacteria_none;Actinobacteria;Actinomycetia;Streptomycetales;Streptomycetaceae;Streptomyces;Streptomyces qaidamensis	1	1	0	2	0	0	0	0	4
Bacteria;Bacteria_none;Actinobacteria;Actinomycetia;Streptomycetales;Streptomycetaceae;Streptomyces;Streptomyces olivoviridis	0	0	1	1	0	1	1	0	4
Bacteria;Bacteria_none;Proteobacteria;Alphaproteobacteria;Rhodobacterales;Rhodobacteraceae;Gemmobacter;Gemmobacter fontiphilus	0	2	1	0	0	0	1	0	4
Bacteria;Bacteria_none;Proteobacteria;Deltaproteobacteria;Desulfovibrionales;Desulfovibrionaceae;Fundidesulfovibrio;Fundidesulfovibrio butyratiphilus	3	0	1	0	0	0	0	0	4
Bacteria;Bacteria_none;Proteobacteria;Epsilonproteobacteria;Campylobacterales;Thiovulaceae;Sulfurimonas;Sulfurimonas hongkongensis	0	3	1	0	0	0	0	0	4
Bacteria;Bacteria_none;Proteobacteria;Alphaproteobacteria;Hyphomicrobiales;Tepidamorphaceae;Butyratibacter;Butyratibacter algicola	0	2	0	1	1	0	0	0	4
Bacteria;Bacteria_none;Proteobacteria;Betaproteobacteria;Neisseriales;Chromobacteriaceae;Jeongeupia;Jeongeupia naejangsanensis	2	2	0	0	0	0	0	0	4
Bacteria;Bacteria_none;Actinobacteria;Actinomycetia;Micrococcales;Microbacteriaceae;Microbacterium;Microbacterium pygmaeum	0	0	4	0	0	0	0	0	4
Bacteria;Bacteria_none;Proteobacteria;Alphaproteobacteria;Rhodobacterales;Rhodobacteraceae;Gemmobacter;Gemmobacter straminiformis	0	0	1	0	1	0	1	1	4
Bacteria;Bacteria_none;Actinobacteria;Actinomycetia;Micrococcales;Micrococcaceae;Arthrobacter;Arthrobacter liuii	2	1	0	1	0	0	0	0	4
Bacteria;Bacteria_none;Proteobacteria;Alphaproteobacteria;Magnetococcales;Magnetococcaceae;Magnetococcus;Magnetococcus marinus	0	0	2	1	0	0	0	1	4
Bacteria;Bacteria_none;Actinobacteria;Actinomycetia;Streptomycetales;Streptomycetaceae;Streptomyces;Streptomyces polyantibioticus	0	1	1	1	0	0	0	1	4
Bacteria;Bacteria_none;Actinobacteria;Coriobacteriia;Eggerthellales;Eggerthellaceae;Eggerthella;Eggerthella lenta	1	0	0	0	3	0	0	0	4
Bacteria;Bacteria_none;Proteobacteria;Betaproteobacteria;Neisseriales;Chromobacteriaceae;Silvimonas;Silvimonas iriomotensis	4	0	0	0	0	0	0	0	4
Bacteria;Bacteria_none;Proteobacteria;Oligoflexia;Bacteriovoracales;Bacteriovoracaceae;Peredibacter;Peredibacter starrii	1	2	0	0	0	0	1	0	4
Bacteria;Bacteria_none;Thermotogae;Thermotogae;Thermotogales;Fervidobacteriaceae;Fervidobacterium;Fervidobacterium pennivorans	0	0	3	1	0	0	0	0	4
Bacteria;Bacteria_none;Actinobacteria;Actinomycetia;Actinomycetales;Actinomycetaceae;Actinomyces;Actinomyces bowdenii	0	0	2	2	0	0	0	0	4
Bacteria;Bacteria_none;Proteobacteria;Betaproteobacteria;Neisseriales;Neisseriaceae;Aquella;Aquella oligotrophica	2	1	0	0	1	0	0	0	4
Bacteria;Bacteria_none;Proteobacteria;Alphaproteobacteria;Rhodobacterales;Rhodobacteraceae;Paracoccus;Paracoccus fontiphilus	0	1	0	2	0	0	0	1	4
Bacteria;Bacteria_none;Proteobacteria;Deltaproteobacteria;Desulfovibrionales;Desulfovibrionaceae;Salidesulfovibrio;Salidesulfovibrio brasiliensis	0	4	0	0	0	0	0	0	4
Bacteria;Bacteria_none;Proteobacteria;Betaproteobacteria;Neisseriales;Neisseriaceae;Crenobacter;Crenobacter intestini	1	2	1	0	0	0	0	0	4
Bacteria;Bacteria_none;Proteobacteria;Betaproteobacteria;Burkholderiales;Comamonadaceae;Serpentinimonas;Serpentinimonas barnesii	4	0	0	0	0	0	0	0	4
Bacteria;Bacteria_none;Bacteroidota;Cytophagia;Cytophagales;Spirosomaceae;Fibrivirga;Fibrivirga algicola	0	0	3	1	0	0	0	0	4
Bacteria;Bacteria_none;Bacteroidota;Chitinophagia;Chitinophagales;Chitinophagaceae;Niastella;Niastella vici	4	0	0	0	0	0	0	0	4
Bacteria;Bacteria_none;Proteobacteria;Gammaproteobacteria;Enterobacterales;Pectobacteriaceae;Samsonia;Samsonia erythrinae	1	0	1	1	0	0	1	0	4
Bacteria;Bacteria_none;Bacteroidota;Bacteroidia;Marinilabiliales;Marinilabiliaceae;Natronoflexus;Natronoflexus pectinivorans	0	0	0	0	0	1	0	3	4
Bacteria;Bacteria_none;Proteobacteria;Gammaproteobacteria;Oceanospirillales;Halomonadaceae;Chromohalobacter;Chromohalobacter israelensis	0	0	4	0	0	0	0	0	4
Bacteria;Bacteria_none;Proteobacteria;Betaproteobacteria;Burkholderiales;Burkholderiaceae;Paraburkholderia;Paraburkholderia eburnea	1	2	0	0	0	0	1	0	4
Bacteria;Bacteria_none;Proteobacteria;Gammaproteobacteria;Enterobacterales;Thorselliaceae;Thorsellia;Thorsellia kenyensis	2	2	0	0	0	0	0	0	4
Bacteria;Bacteria_none;Actinobacteria;Actinomycetia;Bifidobacteriales;Bifidobacteriaceae;Bifidobacterium;Bifidobacterium callimiconis	0	1	0	3	0	0	0	0	4
Bacteria;Bacteria_none;Proteobacteria;Gammaproteobacteria;Enterobacterales;Yersiniaceae;Gibbsiella;Gibbsiella dentisursi	3	0	0	0	0	0	1	0	4
Bacteria;Bacteria_none;Actinobacteria;Actinomycetia;Micrococcales;Microbacteriaceae;Curtobacterium;Curtobacterium albidum	0	1	0	1	1	0	0	1	4
Bacteria;Bacteria_none;Bacteroidota;Bacteroidia;Marinilabiliales;Prolixibacteraceae;Mangrovibacterium;Mangrovibacterium lignilyticum	1	3	0	0	0	0	0	0	4
Bacteria;Bacteria_none;Proteobacteria;Alphaproteobacteria;Sphingomonadales;Sphingomonadaceae;Novosphingobium;Novosphingobium clariflavum	1	0	0	3	0	0	0	0	4
Bacteria;Bacteria_none;Proteobacteria;Gammaproteobacteria;Enterobacterales;Yersiniaceae;Rahnella;Rahnella bonaserana	2	0	0	1	0	0	0	1	4
Bacteria;Bacteria_none;Proteobacteria;Gammaproteobacteria;Nevskiales;Sinobacteraceae;Alkanibacter;Alkanibacter difficilis	1	0	0	3	0	0	0	0	4
Bacteria;Bacteria_none;Actinobacteria;Actinomycetia;Micromonosporales;Micromonosporaceae;Micromonospora;Micromonospora vulcania	1	0	0	3	0	0	0	0	4
Bacteria;Bacteria_none;Proteobacteria;Alphaproteobacteria;Sphingomonadales;Sphingomonadaceae;Novosphingobium;Novosphingobium fuchskuhlense	3	0	0	1	0	0	0	0	4
Bacteria;Bacteria_none;Proteobacteria;Betaproteobacteria;Burkholderiales;Burkholderiaceae;Paraburkholderia;Paraburkholderia nodosa	1	1	0	1	0	0	0	1	4
Bacteria;Bacteria_none;Actinobacteria;Actinomycetia;Micromonosporales;Micromonosporaceae;Micromonospora;Micromonospora inyonensis	0	1	2	1	0	0	0	0	4
Bacteria;Bacteria_none;Bacteroidota;Chitinophagia;Chitinophagales;Chitinophagaceae;Terrimonas;Terrimonas rhizosphaerae	2	1	0	0	0	0	0	1	4
Bacteria;Bacteria_none;Bacteroidota;Bacteroidia;Bacteroidales;Tannerellaceae;Parabacteroides;Parabacteroides pekinense	0	0	0	0	0	1	0	3	4
Bacteria;Bacteria_none;Proteobacteria;Alphaproteobacteria;Rhodospirillales;Rhodospirillaceae;Pacificispira;Pacificispira spongiicola	1	0	2	0	0	0	1	0	4
Bacteria;Bacteria_none;Proteobacteria;Alphaproteobacteria;Rhodospirillales;Rhodospirillaceae;Phaeovibrio;Phaeovibrio sulfidiphilus	1	2	0	1	0	0	0	0	4
Bacteria;Bacteria_none;Proteobacteria;Alphaproteobacteria;Rhodospirillales;Rhodospirillaceae;Taonella;Taonella mepensis	0	0	2	1	1	0	0	0	4
Bacteria;Bacteria_none;Proteobacteria;Alphaproteobacteria;Rhodospirillales;Rhodospirillaceae;Telmatospirillum;Telmatospirillum siberiense	0	0	2	0	1	1	0	0	4
Bacteria;Bacteria_none;Proteobacteria;Alphaproteobacteria;Rhodospirillales;Rhodospirillaceae;Tistrella;Tistrella mobilis	4	0	0	0	0	0	0	0	4
Bacteria;Bacteria_none;Proteobacteria;Betaproteobacteria;Burkholderiales;Burkholderiales_Incertae_sedis;Aquabacterium;Aquabacterium lacunae	0	0	2	0	0	0	2	0	4
Bacteria;Bacteria_none;Bacteroidota;Bacteroidia;Bacteroidales;Tannerellaceae;Parabacteroides;Parabacteroides timonensis	0	0	0	0	0	0	0	4	4
Bacteria;Bacteria_none;Proteobacteria;Betaproteobacteria;Burkholderiales;Burkholderiaceae;Paraburkholderia;Paraburkholderia phenazinium	1	1	1	0	1	0	0	0	4
Bacteria;Bacteria_none;Proteobacteria;Gammaproteobacteria;Enterobacterales;Pectobacteriaceae;Affinibrenneria;Affinibrenneria salicis	2	1	0	1	0	0	0	0	4
Bacteria;Bacteria_none;Actinobacteria;Actinomycetia;Propionibacteriales;Propionibacteriaceae;Cutibacterium;Cutibacterium granulosum	1	3	0	0	0	0	0	0	4
Bacteria;Bacteria_none;Acidobacteria;Blastocatellia;Blastocatellia_Incertae_sedis;Blastocatellia_Incertae_sedis;Chloracidobacterium;Chloracidobacterium thermophilum	0	3	0	1	0	0	0	0	4
Bacteria;Bacteria_none;Proteobacteria;Betaproteobacteria;Burkholderiales;Burkholderiaceae;Polynucleobacter;Polynucleobacter acidiphobus	0	0	0	4	0	0	0	0	4
Bacteria;Bacteria_none;Actinobacteria;Actinomycetia;Propionibacteriales;Propionibacteriaceae;Arachnia;[Pseudopropionibacterium] massiliense	0	2	2	0	0	0	0	0	4
Bacteria;Bacteria_none;Proteobacteria;Alphaproteobacteria;Rickettsiales;Rickettsiaceae;Rickettsia;Rickettsia monteiroi	3	1	0	0	0	0	0	0	4
Bacteria;Bacteria_none;Proteobacteria;Gammaproteobacteria;Enterobacterales;Yersiniaceae;Serratia;Serratia oryzae	2	2	0	0	0	0	0	0	4
Bacteria;Bacteria_none;Bacteroidota;Chitinophagia;Chitinophagales;Chitinophagaceae;Niastella;Niastella gongjuensis	4	0	0	0	0	0	0	0	4
Bacteria;Bacteria_none;Actinobacteria;Actinomycetia;Bifidobacteriales;Bifidobacteriaceae;Bifidobacterium;Bifidobacterium adolescentis	1	1	1	0	0	0	0	1	4
Bacteria;Bacteria_none;Bacteroidota;Chitinophagia;Chitinophagales;Chitinophagaceae;Flavitalea;Flavitalea flava	4	0	0	0	0	0	0	0	4
Bacteria;Bacteria_none;Proteobacteria;Gammaproteobacteria;Legionellales;Legionellaceae;Legionella;Legionella tucsonensis	0	0	3	1	0	0	0	0	4
Bacteria;Bacteria_none;Actinobacteria;Actinomycetia;Propionibacteriales;Nocardioidaceae;Nocardioides;Nocardioides aestuarii	0	1	0	2	0	1	0	0	4
Bacteria;Bacteria_none;Proteobacteria;Betaproteobacteria;Burkholderiales;Alcaligenaceae;Achromobacter;Achromobacter pulmonis	4	0	0	0	0	0	0	0	4
Bacteria;Bacteria_none;Proteobacteria;Gammaproteobacteria;Methylococcales;Methylococcaceae;Methylogaea;Methylogaea oryzae	1	1	0	2	0	0	0	0	4
Bacteria;Bacteria_none;Actinobacteria;Actinomycetia;Propionibacteriales;Nocardioidaceae;Marmoricola;Marmoricola caldifontis	0	2	0	1	0	1	0	0	4
Bacteria;Bacteria_none;Proteobacteria;Alphaproteobacteria;Sphingomonadales;Sphingomonadaceae;Sphingomonas;Sphingomonas phyllosphaerae	1	1	0	1	1	0	0	0	4
Bacteria;Bacteria_none;Proteobacteria;Alphaproteobacteria;Sphingomonadales;Sphingomonadaceae;Sphingomonas;Sphingomonas profundi	1	0	0	2	0	1	0	0	4
Bacteria;Bacteria_none;Proteobacteria;Gammaproteobacteria;Gammaproteobacteria_Incertae_sedis;Gammaproteobacteria_Incertae_sedis;Ignatzschineria;Ignatzschineria cameli	4	0	0	0	0	0	0	0	4
Bacteria;Bacteria_none;Proteobacteria;Gammaproteobacteria;Moraxellales;Moraxellaceae;Acinetobacter;Acinetobacter calcoaceticus	4	0	0	0	0	0	0	0	4
Bacteria;Bacteria_none;Proteobacteria;Alphaproteobacteria;Sphingomonadales;Sphingomonadaceae;Sphingomonas;Sphingomonas xinjiangensis	2	0	2	0	0	0	0	0	4
Bacteria;Bacteria_none;Proteobacteria;Gammaproteobacteria;Moraxellales;Moraxellaceae;Acinetobacter;Acinetobacter lanii	4	0	0	0	0	0	0	0	4
Bacteria;Bacteria_none;Proteobacteria;Gammaproteobacteria;Moraxellales;Moraxellaceae;Acinetobacter;Acinetobacter gandensis	3	0	0	0	0	0	0	1	4
Bacteria;Bacteria_none;Proteobacteria;Alphaproteobacteria;Sphingomonadales;Sphingomonadaceae;Sphingorhabdus;Sphingorhabdus lutea	0	0	4	0	0	0	0	0	4
Bacteria;Bacteria_none;Bacteroidota;Chitinophagia;Chitinophagales;Chitinophagaceae;Foetidibacter;Foetidibacter luteolus	4	0	0	0	0	0	0	0	4
Bacteria;Bacteria_none;Actinobacteria;Actinomycetia;Propionibacteriales;Kribbellaceae;Kribbella;Kribbella sandramycini	0	0	0	4	0	0	0	0	4
Bacteria;Bacteria_none;Proteobacteria;Betaproteobacteria;Burkholderiales;Alcaligenaceae;Bordetella;Bordetella ansorpii	4	0	0	0	0	0	0	0	4
Bacteria;Bacteria_none;Proteobacteria;Gammaproteobacteria;Legionellales;Legionellaceae;Legionella;Legionella steigerwaltii	0	0	0	4	0	0	0	0	4
Bacteria;Bacteria_none;Proteobacteria;Alphaproteobacteria;Sphingomonadales;Sphingomonadaceae;Sphingomonas;Sphingomonas flava	0	3	1	0	0	0	0	0	4
Bacteria;Bacteria_none;Proteobacteria;Gammaproteobacteria;Moraxellales;Moraxellaceae;Acinetobacter;Acinetobacter pittii	0	0	0	4	0	0	0	0	4
Bacteria;Bacteria_none;Proteobacteria;Gammaproteobacteria;Legionellales;Legionellaceae;Legionella;Legionella saoudiensis	2	0	0	0	0	2	0	0	4
Bacteria;Bacteria_none;Actinobacteria;Actinomycetia;Propionibacteriales;Kribbellaceae;Kribbella;Kribbella qitaiheensis	1	0	1	1	0	0	1	0	4
Bacteria;Bacteria_none;Bacteroidota;Chitinophagia;Chitinophagales;Chitinophagaceae;Flavisolibacter;Flavisolibacter aluminii	4	0	0	0	0	0	0	0	4
Bacteria;Bacteria_none;Proteobacteria;Deltaproteobacteria;Desulfobacterales;Desulfobulbaceae;Desulfoprunum;Desulfoprunum benzoelyticum	3	0	0	1	0	0	0	0	4
Bacteria;Bacteria_none;Proteobacteria;Gammaproteobacteria;Legionellales;Legionellaceae;Legionella;Legionella nagasakiensis	1	0	2	0	0	0	1	0	4
Bacteria;Bacteria_none;Proteobacteria;Gammaproteobacteria;Legionellales;Legionellaceae;Legionella;Legionella impletisoli	0	0	4	0	0	0	0	0	4
Bacteria;Bacteria_none;Proteobacteria;Gammaproteobacteria;Moraxellales;Moraxellaceae;Acinetobacter;Acinetobacter tianfuensis	3	0	1	0	0	0	0	0	4
Bacteria;Bacteria_none;Proteobacteria;Alphaproteobacteria;Sphingomonadales;Sphingomonadaceae;Sphingomonas;Sphingomonas abaci	0	1	2	1	0	0	0	0	4
Bacteria;Bacteria_none;Proteobacteria;Alphaproteobacteria;Sphingomonadales;Sphingomonadaceae;Sphingomonas;'Sphingomonas ginsengisoli' Hoang et al. 2012	1	2	0	1	0	0	0	0	4
Bacteria;Bacteria_none;Proteobacteria;Gammaproteobacteria;Moraxellales;Moraxellaceae;Acinetobacter;Acinetobacter towneri	0	0	0	2	1	1	0	0	4
Bacteria;Bacteria_none;Proteobacteria;Gammaproteobacteria;Gammaproteobacteria_Incertae_sedis;Gammaproteobacteria_Incertae_sedis;Sedimenticola;Sedimenticola selenatireducens	0	1	1	1	1	0	0	0	4
Bacteria;Bacteria_none;Proteobacteria;Alphaproteobacteria;Sphingomonadales;Sphingomonadaceae;Parasphingorhabdus;Parasphingorhabdus flavimaris	1	2	1	0	0	0	0	0	4
Bacteria;Bacteria_none;Actinobacteria;Actinomycetia;Micromonosporales;Micromonosporaceae;Longispora;Longispora albida	0	0	0	2	1	0	0	1	4
Bacteria;Bacteria_none;Proteobacteria;Betaproteobacteria;Burkholderiales;Burkholderiales_Incertae_sedis;Thiobacter;Thiobacter subterraneus	1	1	1	1	0	0	0	0	4
Bacteria;Bacteria_none;Actinobacteria;Thermoleophilia;Solirubrobacterales;Patulibacteraceae;Patulibacter;Patulibacter brassicae	0	1	2	1	0	0	0	0	4
Bacteria;Bacteria_none;Proteobacteria;Gammaproteobacteria;Thiotrichales;Fastidiosibacteraceae;Caedibacter;Caedibacter taeniospiralis	0	1	2	0	0	1	0	0	4
Bacteria;Bacteria_none;Bacteroidota;Bacteroidia;Bacteroidales;Bacteroidaceae;Bacteroides;Bacteroides mediterraneensis	0	0	3	0	0	1	0	0	4
Bacteria;Bacteria_none;Proteobacteria;Betaproteobacteria;Burkholderiales;Comamonadaceae;Vandammella;Vandammella animalimorsus	3	0	0	0	0	0	1	0	4
Bacteria;Bacteria_none;Proteobacteria;Alphaproteobacteria;Rhodobacterales;Roseobacteraceae;Octadecabacter;Octadecabacter arcticus	2	1	0	1	0	0	0	0	4
Bacteria;Bacteria_none;Actinobacteria;Actinomycetia;Actinomycetales;Actinomycetaceae;Arcanobacterium;Arcanobacterium bovis	0	0	3	1	0	0	0	0	4
Bacteria;Bacteria_none;Proteobacteria;Gammaproteobacteria;Thiotrichales;Piscirickettsiaceae;Hydrogenovibrio;Hydrogenovibrio marinus	4	0	0	0	0	0	0	0	4
Bacteria;Bacteria_none;Actinobacteria;Actinomycetia;Micromonosporales;Micromonosporaceae;Actinoplanes;Actinoplanes deccanensis	2	2	0	0	0	0	0	0	4
Bacteria;Bacteria_none;Actinobacteria;Actinomycetia;Streptomycetales;Streptomycetaceae;Kitasatospora;Kitasatospora niigatensis	0	0	4	0	0	0	0	0	4
Bacteria;Bacteria_none;Bacteroidota;Bacteroidia;Bacteroidales;Bacteroidaceae;Bacteroides;Bacteroides luti	0	4	0	0	0	0	0	0	4
Bacteria;Bacteria_none;Actinobacteria;Actinomycetia;Streptomycetales;Streptomycetaceae;Kitasatospora;Kitasatospora aburaviensis	0	4	0	0	0	0	0	0	4
Bacteria;Bacteria_none;Proteobacteria;Betaproteobacteria;Burkholderiales;Comamonadaceae;Ramlibacter;Ramlibacter henchirensis	4	0	0	0	0	0	0	0	4
Bacteria;Bacteria_none;Proteobacteria;Alphaproteobacteria;Rhodospirillales;Acetobacteraceae;Acetobacter;Acetobacter ascendens	3	0	0	0	1	0	0	0	4
Bacteria;Bacteria_none;Proteobacteria;Betaproteobacteria;Burkholderiales;Comamonadaceae;Ramlibacter;Ramlibacter alkalitolerans	4	0	0	0	0	0	0	0	4
Bacteria;Bacteria_none;Actinobacteria;Actinomycetia;Micrococcales;Microbacteriaceae;Leucobacter;Leucobacter chromiiresistens	0	0	1	0	2	0	1	0	4
Bacteria;Bacteria_none;Proteobacteria;Gammaproteobacteria;Chromatiales;Thioalkalibacteraceae;Guyparkeria;Guyparkeria hydrothermalis	0	4	0	0	0	0	0	0	4
Bacteria;Bacteria_none;Proteobacteria;Alphaproteobacteria;Rhodobacterales;Roseobacteraceae;Leisingera;Leisingera methylohalidivorans	0	1	3	0	0	0	0	0	4
Bacteria;Bacteria_none;Bacteroidota;Bacteroidia;Bacteroidales;Bacteroidaceae;Bacteroides;Bacteroides heparinolyticus	1	3	0	0	0	0	0	0	4
Bacteria;Bacteria_none;Proteobacteria;Betaproteobacteria;Burkholderiales;Burkholderiales_Incertae_sedis;Thiomonas;Thiomonas bhubaneswarensis	2	1	0	0	0	0	1	0	4
Bacteria;Bacteria_none;Proteobacteria;Betaproteobacteria;Burkholderiales;Oxalobacteraceae;Oxalobacter;Oxalobacter vibrioformis	1	2	0	0	0	1	0	0	4
Bacteria;Bacteria_none;Proteobacteria;Gammaproteobacteria;Xanthomonadales;Xanthomonadaceae;Lysobacter;Lysobacter dokdonensis	2	1	1	0	0	0	0	0	4
Bacteria;Bacteria_none;Proteobacteria;Alphaproteobacteria;Rhodobacterales;Rhodobacteraceae;Pseudorhodobacter;Pseudorhodobacter ponti	2	1	0	0	1	0	0	0	4
Bacteria;Bacteria_none;Actinobacteria;Actinomycetia;Micrococcales;Microbacteriaceae;Marisediminicola;Marisediminicola senii	0	1	3	0	0	0	0	0	4
Bacteria;Bacteria_none;Proteobacteria;Gammaproteobacteria;Aeromonadales;Aeromonadaceae;Aeromonas;Aeromonas simiae	1	1	1	0	0	1	0	0	4
Bacteria;Bacteria_none;Proteobacteria;Gammaproteobacteria;Aeromonadales;Succinivibrionaceae;Succinimonas;Succinimonas amylolytica	1	3	0	0	0	0	0	0	4
Bacteria;Bacteria_none;Proteobacteria;Gammaproteobacteria;Alteromonadales;Alteromonadaceae;Planctobacterium;Planctobacterium marinum	1	1	1	0	0	1	0	0	4
Bacteria;Bacteria_none;Proteobacteria;Gammaproteobacteria;Alteromonadales;Pseudoalteromonadaceae;Pseudoalteromonas;Pseudoalteromonas denitrificans	0	1	2	1	0	0	0	0	4
Bacteria;Bacteria_none;Bacteroidota;Cytophagia;Cytophagales;Hymenobacteraceae;Pontibacter;Pontibacter ramchanderi	0	2	2	0	0	0	0	0	4
Bacteria;Bacteria_none;Proteobacteria;Gammaproteobacteria;Xanthomonadales;Xanthomonadaceae;Luteimonas;Luteimonas chenhongjianii	4	0	0	0	0	0	0	0	4
Bacteria;Bacteria_none;Proteobacteria;Gammaproteobacteria;Alteromonadales;Shewanellaceae;Shewanella;Shewanella amazonensis	2	2	0	0	0	0	0	0	4
Bacteria;Bacteria_none;Proteobacteria;Gammaproteobacteria;Vibrionales;Vibrionaceae;Vibrio;Vibrio sonorensis	2	0	0	0	1	1	0	0	4
Bacteria;Bacteria_none;Proteobacteria;Gammaproteobacteria;Chromatiales;Chromatiaceae;Phaeochromatium;Phaeochromatium fluminis	1	2	0	1	0	0	0	0	4
Bacteria;Bacteria_none;Actinobacteria;Actinomycetia;Streptomycetales;Streptomycetaceae;Streptacidiphilus;Streptacidiphilus fuscans	1	0	3	0	0	0	0	0	4
Bacteria;Bacteria_none;Proteobacteria;Gammaproteobacteria;Vibrionales;Vibrionaceae;Photobacterium;Photobacterium aestuarii	0	1	2	0	1	0	0	0	4
Bacteria;Bacteria_none;Actinobacteria;Actinomycetia;Pseudonocardiales;Pseudonocardiaceae;Thermocrispum;Thermocrispum agreste	0	1	2	0	0	1	0	0	4
Bacteria;Bacteria_none;Actinobacteria;Actinomycetia;Pseudonocardiales;Pseudonocardiaceae;Saccharopolyspora;Saccharopolyspora qijiaojingensis	0	1	1	0	0	0	0	2	4
Bacteria;Bacteria_none;Proteobacteria;Gammaproteobacteria;Enterobacterales;Enterobacteriaceae;Citrobacter;Citrobacter freundii	4	0	0	0	0	0	0	0	4
Bacteria;Bacteria_none;Actinobacteria;Actinomycetia;Propionibacteriales;Propionibacteriaceae;Microlunatus;Microlunatus terrae	1	0	0	2	1	0	0	0	4
Bacteria;Bacteria_none;Bacteroidota;Cytophagia;Cytophagales;Cytophagaceae;Siphonobacter;Siphonobacter aquaeclarae	2	2	0	0	0	0	0	0	4
Bacteria;Bacteria_none;Proteobacteria;Gammaproteobacteria;Pseudomonadales;Pseudomonadaceae;Pseudomonas;Pseudomonas amygdali	2	1	0	1	0	0	0	0	4
Bacteria;Bacteria_none;Actinobacteria;Actinomycetia;Propionibacteriales;Propionibacteriaceae;Propionibacterium;Propionibacterium freudenreichii	1	2	0	1	0	0	0	0	4
Bacteria;Bacteria_none;Proteobacteria;Gammaproteobacteria;Pseudomonadales;Pseudomonadaceae;Pseudomonas;Pseudomonas aeruginosa	2	0	1	1	0	0	0	0	4
Bacteria;Bacteria_none;Bacteroidota;Bacteroidia;Bacteroidales;Prevotellaceae;Prevotella;Prevotella intermedia	0	1	1	2	0	0	0	0	4
Bacteria;Bacteria_none;Proteobacteria;Alphaproteobacteria;Rhodospirillales;Azospirillaceae;Nitrospirillum;Nitrospirillum iridis	0	1	1	1	0	1	0	0	4
Bacteria;Bacteria_none;Proteobacteria;Betaproteobacteria;Burkholderiales;Comamonadaceae;Caenimonas;Caenimonas terrae	1	0	1	2	0	0	0	0	4
Bacteria;Bacteria_none;Proteobacteria;Gammaproteobacteria;Enterobacterales;Enterobacteriaceae;Cronobacter;Cronobacter sakazakii	3	0	1	0	0	0	0	0	4
Bacteria;Bacteria_none;Proteobacteria;Gammaproteobacteria;Enterobacterales;Erwiniaceae;Pantoea;Pantoea endophytica	0	0	0	4	0	0	0	0	4
Bacteria;Bacteria_none;Proteobacteria;Gammaproteobacteria;Enterobacterales;Erwiniaceae;Pantoea;Pantoea vagans	4	0	0	0	0	0	0	0	4
Bacteria;Bacteria_none;Proteobacteria;Gammaproteobacteria;Pseudomonadales;Pseudomonadaceae;Denitrificimonas;Denitrificimonas caeni	0	0	2	2	0	0	0	0	4
Bacteria;Bacteria_none;Proteobacteria;Alphaproteobacteria;Rhodospirillales;Rhodospirillaceae;Algihabitans;Algihabitans albus	1	2	1	0	0	0	0	0	4
Bacteria;Bacteria_none;Proteobacteria;Alphaproteobacteria;Rhodospirillales;Rhodospirillaceae;Caenispirillum;Caenispirillum humi	3	0	0	0	1	0	0	0	4
Bacteria;Bacteria_none;Proteobacteria;Alphaproteobacteria;Rhodospirillales;Rhodospirillaceae;Elstera;Elstera cyanobacteriorum	2	0	1	1	0	0	0	0	4
Bacteria;Bacteria_none;Proteobacteria;Alphaproteobacteria;Rhodospirillales;Acetobacteraceae;Roseomonas;Roseomonas ponticola	3	0	0	1	0	0	0	0	4
Bacteria;Bacteria_none;Bacteroidota;Cytophagia;Cytophagales;Cytophagaceae;Siphonobacter;Siphonobacter intestinalis	4	0	0	0	0	0	0	0	4
Bacteria;Bacteria_none;Proteobacteria;Alphaproteobacteria;Rhodospirillales;Acetobacteraceae;Roseomonas;Roseomonas musae	4	0	0	0	0	0	0	0	4
Bacteria;Bacteria_none;Proteobacteria;Gammaproteobacteria;Enterobacterales;Enterobacteriaceae;Symbiopectobacterium;Symbiopectobacterium purcellii	4	0	0	0	0	0	0	0	4
Bacteria;Bacteria_none;Actinobacteria;Actinomycetia;Micromonosporales;Micromonosporaceae;Catellatospora;Catellatospora citrea	0	1	1	1	1	0	0	0	4
Bacteria;Bacteria_none;Bacteroidota;Cytophagia;Cytophagales;Cytophagaceae;Sporocytophaga;Sporocytophaga myxococcoides	2	0	1	0	0	0	0	1	4
Bacteria;Bacteria_none;Proteobacteria;Alphaproteobacteria;Rhodospirillales;Acetobacteraceae;Roseomonas;Roseomonas aeriglobus	1	1	1	1	0	0	0	0	4
Bacteria;Bacteria_none;Proteobacteria;Alphaproteobacteria;Rhodospirillales;Acetobacteraceae;Roseococcus;Roseococcus thiosulfatophilus	1	3	0	0	0	0	0	0	4
Bacteria;Bacteria_none;Proteobacteria;Gammaproteobacteria;Enterobacterales;Enterobacteriaceae;Mangrovibacter;Mangrovibacter yixingensis	3	0	1	0	0	0	0	0	4
Bacteria;Bacteria_none;Bacteroidota;Bacteroidia;Bacteroidales;Prevotellaceae;Prevotella;Prevotella baroniae	0	1	0	3	0	0	0	0	4
Bacteria;Bacteria_none;Proteobacteria;Alphaproteobacteria;Rhodospirillales;Acetobacteraceae;Komagataeibacter;Komagataeibacter europaeus	4	0	0	0	0	0	0	0	4
Bacteria;Bacteria_none;Proteobacteria;Gammaproteobacteria;Pseudomonadales;Pseudomonadaceae;Pseudomonas;Pseudomonas mediterranea	2	0	1	1	0	0	0	0	4
Bacteria;Bacteria_none;Proteobacteria;Gammaproteobacteria;Pseudomonadales;Pseudomonadaceae;Pseudomonas;Pseudomonas phragmitis	1	1	2	0	0	0	0	0	4
Bacteria;Bacteria_none;Proteobacteria;Alphaproteobacteria;Rhodospirillales;Acetobacteraceae;Entomobacter;Entomobacter blattae	1	2	0	0	0	1	0	0	4
Bacteria;Bacteria_none;Actinobacteria;Actinomycetia;Pseudonocardiales;Pseudonocardiaceae;Halosaccharopolyspora;Halosaccharopolyspora lacisalsi	0	0	0	4	0	0	0	0	4
Bacteria;Bacteria_none;Proteobacteria;Betaproteobacteria;Burkholderiales;Comamonadaceae;Limnohabitans;Limnohabitans parvus	2	2	0	0	0	0	0	0	4
Bacteria;Bacteria_none;Actinobacteria;Actinomycetia;Pseudonocardiales;Pseudonocardiaceae;Pseudonocardia;Pseudonocardia saturnea	0	2	1	0	0	1	0	0	4
Bacteria;Bacteria_none;Bacteroidota;Chitinophagia;Chitinophagales;Chitinophagaceae;Thermoflavifilum;Thermoflavifilum thermophilum	0	1	2	0	0	0	0	1	4
Bacteria;Bacteria_none;Actinobacteria;Actinomycetia;Corynebacteriales;Mycobacteriaceae;Mycobacterium;Mycobacterium branderi	0	0	2	1	0	1	0	0	4
Bacteria;Bacteria_none;Firmicutes;Tissierellia;Tissierellales;Peptoniphilaceae;Peptoniphilus;Peptoniphilus urinimassiliensis	1	0	0	0	3	0	0	0	4
Bacteria;Bacteria_none;Cyanobacteria;Cyanobacteria_Incertae_sedis;Nostocales;Tolypothrichaceae;Kryptousia;Kryptousia macronema	0	4	0	0	0	0	0	0	4
Bacteria;Bacteria_none;Firmicutes;Clostridia;Eubacteriales;Clostridiales Family XVII. Incertae Sedis;Thermaerobacter;Thermaerobacter subterraneus	0	0	0	4	0	0	0	0	4
Bacteria;Bacteria_none;Firmicutes;Bacilli;Bacillales;Staphylococcaceae;Staphylococcus;Staphylococcus nepalensis	0	2	0	2	0	0	0	0	4
Bacteria;Bacteria_none;Firmicutes;Clostridia;Thermoanaerobacterales;Thermoanaerobacterales Family III. Incertae Sedis;Caldicellulosiruptor;Caldicellulosiruptor obsidiansis	0	4	0	0	0	0	0	0	4
Bacteria;Bacteria_none;Actinobacteria;Actinomycetia;Micrococcales;Demequinaceae;Demequina;Demequina lutea	1	1	0	0	0	0	2	0	4
Bacteria;Bacteria_none;Firmicutes;Clostridia;Eubacteriales;Lachnospiraceae;Sporofaciens;Sporofaciens musculi	2	0	0	1	0	0	0	1	4
Bacteria;Bacteria_none;Proteobacteria;Alphaproteobacteria;Hyphomicrobiales;Phyllobacteriaceae;Aminobacter;Aminobacter lissarensis	2	0	2	0	0	0	0	0	4
Bacteria;Bacteria_none;Firmicutes;Bacilli;Bacillales;Bacillaceae;Geobacillus;Geobacillus uzenensis	0	0	0	3	1	0	0	0	4
Bacteria;Bacteria_none;Proteobacteria;Alphaproteobacteria;Hyphomicrobiales;Aurantimonadaceae;Martelella;Martelella alba	0	1	0	2	0	1	0	0	4
Bacteria;Bacteria_none;Firmicutes;Clostridia;Eubacteriales;Clostridiaceae;Clostridium;Clostridium ganghwense	1	0	1	2	0	0	0	0	4
Bacteria;Bacteria_none;Firmicutes;Bacilli;Bacillales;Planococcaceae;Bhargavaea;Bhargavaea beijingensis	0	0	2	0	0	2	0	0	4
Bacteria;Bacteria_none;Firmicutes;Clostridia;Thermoanaerobacterales;Thermoanaerobacteraceae;Moorella;Moorella mulderi	1	3	0	0	0	0	0	0	4
Bacteria;Bacteria_none;Proteobacteria;Alphaproteobacteria;Hyphomicrobiales;Bartonellaceae;Bartonella;Bartonella grahamii	0	0	4	0	0	0	0	0	4
Bacteria;Bacteria_none;Proteobacteria;Alphaproteobacteria;Hyphomicrobiales;Phreatobacteraceae;Phreatobacter;Phreatobacter cathodiphilus	1	0	1	0	0	2	0	0	4
Bacteria;Bacteria_none;Proteobacteria;Alphaproteobacteria;Hyphomicrobiales;Bartonellaceae;Bartonella;Bartonella taylorii	0	0	1	3	0	0	0	0	4
Bacteria;Bacteria_none;Firmicutes;Clostridia;Thermoanaerobacterales;Thermoanaerobacteraceae;Desulfovirgula;Desulfovirgula thermocuniculi	0	1	2	1	0	0	0	0	4
Bacteria;Bacteria_none;Firmicutes;Bacilli;Bacillales;Planococcaceae;Jeotgalibacillus;Jeotgalibacillus soli	3	0	0	1	0	0	0	0	4
Bacteria;Bacteria_none;Proteobacteria;Alphaproteobacteria;Hyphomicrobiales;Beijerinckiaceae;Methylocella;Methylocella palustris	2	2	0	0	0	0	0	0	4
Bacteria;Bacteria_none;Cyanobacteria;Cyanobacteria_Incertae_sedis;Oscillatoriales;Microcoleaceae;Microcoleus;Microcoleus acremannii	0	1	2	0	0	0	1	0	4
Bacteria;Bacteria_none;Firmicutes;Clostridia;Halanaerobiales;Halobacteroidaceae;Halonatronum;Halonatronum saccharophilum	1	0	1	0	0	2	0	0	4
Bacteria;Bacteria_none;Firmicutes;Bacilli;Bacillales;Staphylococcaceae;Staphylococcus;Staphylococcus capitis	4	0	0	0	0	0	0	0	4
Bacteria;Bacteria_none;Proteobacteria;Alphaproteobacteria;Hyphomicrobiales;Beijerinckiaceae;Methyloferula;Methyloferula stellata	0	3	0	0	1	0	0	0	4
Bacteria;Bacteria_none;Firmicutes;Clostridia;Halanaerobiales;Halobacteroidaceae;Halanaerobaculum;Halanaerobaculum tunisiense	0	0	2	0	0	2	0	0	4
Bacteria;Bacteria_none;Firmicutes;Bacilli;Lactobacillales;Lactobacillaceae;Leuconostoc;Leuconostoc miyukkimchii	4	0	0	0	0	0	0	0	4
Bacteria;Bacteria_none;Proteobacteria;Alphaproteobacteria;Hyphomicrobiales;Nitrobacteraceae;Bradyrhizobium;Bradyrhizobium retamae	2	0	0	0	2	0	0	0	4
Bacteria;Bacteria_none;Firmicutes;Clostridia;Halanaerobiales;Halanaerobiales_Incertae_sedis;Anoxybacter;Anoxybacter fermentans	0	1	2	1	0	0	0	0	4
Bacteria;Bacteria_none;Actinobacteria;Actinomycetia;Micrococcales;Dermacoccaceae;Dermacoccus;Dermacoccus abyssi	0	2	2	0	0	0	0	0	4
Bacteria;Bacteria_none;Actinobacteria;Actinomycetia;Micrococcales;Intrasporangiaceae;Fodinibacter;Fodinibacter luteus	0	2	0	2	0	0	0	0	4
Bacteria;Bacteria_none;Firmicutes;Bacilli;Bacillales;Staphylococcaceae;Staphylococcus;Staphylococcus saprophyticus	4	0	0	0	0	0	0	0	4
Bacteria;Bacteria_none;Firmicutes;Bacilli;Bacillales;Paenibacillaceae;Paenibacillus;Paenibacillus anaericanus	0	0	0	0	0	4	0	0	4
Bacteria;Bacteria_none;Planctomycetota;Planctomycetia;Planctomycetales;Planctomycetaceae;Alienimonas;Alienimonas californiensis	0	0	0	0	0	4	0	0	4
Bacteria;Bacteria_none;Cyanobacteria;Cyanobacteria_Incertae_sedis;Pseudanabaenales;Thermosynechococcaceae;Thermosynechococcus;Thermosynechococcus vestitus	2	0	1	0	0	0	1	0	4
Bacteria;Bacteria_none;Firmicutes;Negativicutes;Selenomonadales;Selenomonadaceae;Selenomonas;Selenomonas noxia	0	0	2	1	0	0	1	0	4
Bacteria;Bacteria_none;Cyanobacteria;Cyanobacteria_Incertae_sedis;Pseudanabaenales;Prochlorotrichaceae;Nodosilinea;Nodosilinea ramsarensis	1	1	1	1	0	0	0	0	4
Bacteria;Bacteria_none;Actinobacteria;Actinomycetia;Micrococcales;Microbacteriaceae;Agrococcus;Agrococcus casei	0	3	1	0	0	0	0	0	4
Bacteria;Bacteria_none;Firmicutes;Bacilli;Bacillales;Thermoactinomycetaceae;Thermoactinomyces;Thermoactinomyces daqus	0	0	1	0	0	2	0	1	4
Bacteria;Bacteria_none;Firmicutes;Bacilli;Bacillales;Paenibacillaceae;Paenibacillus;Paenibacillus chartarius	0	4	0	0	0	0	0	0	4
Bacteria;Bacteria_none;Firmicutes;Bacilli;Bacillales;Paenibacillaceae;Paenibacillus;Paenibacillus beijingensis	0	1	2	1	0	0	0	0	4
Bacteria;Bacteria_none;Firmicutes;Bacilli;Bacillales;Paenibacillaceae;Paenibacillus;Paenibacillus barengoltzii	0	1	3	0	0	0	0	0	4
Bacteria;Bacteria_none;Firmicutes;Bacilli;Lactobacillales;Enterococcaceae;Enterococcus;Enterococcus pallens	3	0	0	1	0	0	0	0	4
Bacteria;Bacteria_none;Firmicutes;Clostridia;Eubacteriales;Lachnospiraceae;Lacrimispora;Lacrimispora indolis	4	0	0	0	0	0	0	0	4
Bacteria;Bacteria_none;Firmicutes;Bacilli;Bacillales;Paenibacillaceae;Paenibacillus;Paenibacillus algicola	0	0	2	0	2	0	0	0	4
Bacteria;Bacteria_none;Proteobacteria;Alphaproteobacteria;Hyphomicrobiales;Phyllobacteriaceae;Mesorhizobium;Mesorhizobium alhagi	4	0	0	0	0	0	0	0	4
Bacteria;Bacteria_none;Firmicutes;Bacilli;Bacillales;Bacillaceae;Caldalkalibacillus;Caldalkalibacillus uzonensis	2	1	1	0	0	0	0	0	4
Bacteria;Bacteria_none;Actinobacteria;Actinomycetia;Glycomycetales;Glycomycetaceae;Stackebrandtia;Stackebrandtia nassauensis	2	1	1	0	0	0	0	0	4
Bacteria;Bacteria_none;Bacteroidota;Saprospiria;Saprospirales;Lewinellaceae;Neolewinella;Neolewinella xylanilytica	1	1	2	0	0	0	0	0	4
Bacteria;Bacteria_none;Firmicutes;Bacilli;Bacillales;Bacillaceae;Calidifontibacillus;Calidifontibacillus erzurumensis	0	0	2	2	0	0	0	0	4
Bacteria;Bacteria_none;Proteobacteria;Alphaproteobacteria;Caulobacterales;Caulobacteraceae;Phenylobacterium;Phenylobacterium falsum	1	0	0	3	0	0	0	0	4
Bacteria;Bacteria_none;Firmicutes;Clostridia;Eubacteriales;Clostridiales Family XVI. Incertae Sedis;Carboxydocella;Carboxydocella manganica	0	0	1	1	0	2	0	0	4
Bacteria;Bacteria_none;Proteobacteria;Alphaproteobacteria;Caulobacterales;Caulobacteraceae;Phenylobacterium;Phenylobacterium kunshanense	1	1	0	1	0	1	0	0	4
Bacteria;Bacteria_none;Proteobacteria;Alphaproteobacteria;Hyphomicrobiales;Phyllobacteriaceae;Mesorhizobium;Mesorhizobium hungaricum	0	3	0	1	0	0	0	0	4
Bacteria;Bacteria_none;Proteobacteria;Alphaproteobacteria;Caulobacterales;Caulobacteraceae;Phenylobacterium;Phenylobacterium zucineum	2	2	0	0	0	0	0	0	4
Bacteria;Bacteria_none;Proteobacteria;Alphaproteobacteria;Caulobacterales;Caulobacteraceae;Pseudaquidulcibacter;Pseudaquidulcibacter saccharophilus	0	1	0	3	0	0	0	0	4
Bacteria;Bacteria_none;Cyanobacteria;Cyanobacteria_Incertae_sedis;Pleurocapsales;Xenococcaceae;Xenococcus;Xenococcus spongiosum	0	0	0	4	0	0	0	0	4
Bacteria;Bacteria_none;Firmicutes;Bacilli;Lactobacillales;Streptococcaceae;Streptococcus;Streptococcus ursoris	3	0	0	1	0	0	0	0	4
Bacteria;Bacteria_none;Proteobacteria;Alphaproteobacteria;Hyphomicrobiales;Brucellaceae;Brucella;Brucella gallinifaecis	0	0	0	4	0	0	0	0	4
Bacteria;Bacteria_none;Firmicutes;Bacilli;Bacillales;Bacillaceae;Bacillus;Bacillus borbori	0	0	0	4	0	0	0	0	4
Bacteria;Bacteria_none;Actinobacteria;Actinomycetia;Corynebacteriales;Mycobacteriaceae;Mycolicibacter;Mycolicibacter icosiumassiliensis	0	1	0	3	0	0	0	0	4
Bacteria;Bacteria_none;Firmicutes;Bacilli;Lactobacillales;Lactobacillaceae;Lactiplantibacillus;Lactiplantibacillus daowaiensis	1	0	3	0	0	0	0	0	4
Bacteria;Bacteria_none;Actinobacteria;Actinomycetia;Corynebacteriales;Mycobacteriaceae;Mycolicibacterium;Mycolicibacterium oryzae	0	0	1	1	1	1	0	0	4
Bacteria;Bacteria_none;Firmicutes;Bacilli;Bacillales;Bacillaceae;Neobacillus;Neobacillus bataviensis	0	0	2	0	2	0	0	0	4
Bacteria;Bacteria_none;Firmicutes;Bacilli;Lactobacillales;Lactobacillaceae;Lactobacillus;Lactobacillus ultunensis	2	0	0	1	0	1	0	0	4
Bacteria;Bacteria_none;Chloroflexi;Dehalococcoidia;Dehalococcoidia_Incertae_sedis;Dehalococcoidia_Incertae_sedis;Dehalogenimonas;Dehalogenimonas formicexedens	0	0	0	0	2	2	0	0	4
Bacteria;Bacteria_none;Firmicutes;Bacilli;Bacillales;Bacillaceae;Psychrobacillus;Psychrobacillus insolitus	0	0	3	0	0	1	0	0	4
Bacteria;Bacteria_none;Firmicutes;Bacilli;Lactobacillales;Lactobacillaceae;Lactobacillus;Lactobacillus porci	3	1	0	0	0	0	0	0	4
Bacteria;Bacteria_none;Actinobacteria;Actinomycetia;Corynebacteriales;Nocardiaceae;Nocardia;Nocardia zhihengii	0	1	0	2	0	1	0	0	4
Bacteria;Bacteria_none;Proteobacteria;Alphaproteobacteria;Hyphomicrobiales;Methylobacteriaceae;Methylobacterium;Methylobacterium komagatae	4	0	0	0	0	0	0	0	4
Bacteria;Bacteria_none;Actinobacteria;Actinomycetia;Micrococcales;Dermatophilaceae;Kineosphaera;Kineosphaera limosa	0	2	2	0	0	0	0	0	4
Bacteria;Bacteria_none;Firmicutes;Bacilli;Bacillales;Planococcaceae;Sporosarcina;Sporosarcina terrae	0	0	1	0	0	2	0	1	4
Bacteria;Bacteria_none;Proteobacteria;Alphaproteobacteria;Hyphomicrobiales;Methylobacteriaceae;Methylobacterium;Methylobacterium fujisawaense	4	0	0	0	0	0	0	0	4
Bacteria;Bacteria_none;Firmicutes;Clostridia;Eubacteriales;Eubacteriaceae;Alkalibacter;Alkalibacter saccharofermentans	2	0	0	0	0	2	0	0	4
Bacteria;Bacteria_none;Firmicutes;Clostridia;Eubacteriales;Clostridiaceae;Clostridium;Clostridium aestuarii	1	0	1	1	1	0	0	0	4
Bacteria;Bacteria_none;Firmicutes;Clostridia;Eubacteriales;Peptococcaceae;Desulforamulus;Desulforamulus putei	0	1	2	1	0	0	0	0	4
Bacteria;Bacteria_none;Proteobacteria;Alphaproteobacteria;Hyphomicrobiales;Methylobacteriaceae;Methylobacterium;Methylobacterium cerastii	1	0	2	1	0	0	0	0	4
Bacteria;Bacteria_none;Actinobacteria;Actinomycetia;Micrococcales;Brevibacteriaceae;Brevibacterium;Brevibacterium sandarakinum	0	3	0	1	0	0	0	0	4
Bacteria;Bacteria_none;Firmicutes;Bacilli;Bacillales;Bacillaceae;Ornithinibacillus;Ornithinibacillus californiensis	0	0	3	0	1	0	0	0	4
Bacteria;Bacteria_none;Cyanobacteria;Cyanobacteria_Incertae_sedis;Chroococcidiopsidales;Chroococcidiopsidaceae;Chroococcidiopsis;Chroococcidiopsis thermalis	0	3	0	1	0	0	0	0	4
Bacteria;Bacteria_none;Chloroflexi;Ktedonobacteria;Ktedonobacterales;Ktedonobacteraceae;Ktedonobacter;Ktedonobacter robiniae	0	0	4	0	0	0	0	0	4
Bacteria;Bacteria_none;Actinobacteria;Actinomycetia;Corynebacteriales;Nocardiaceae;Nocardia;Nocardia jinanensis	1	1	1	1	0	0	0	0	4
Bacteria;Bacteria_none;Proteobacteria;Alphaproteobacteria;Hyphomicrobiales;Lichenibacteriaceae;Lichenibacterium;Lichenibacterium ramalinae	0	2	0	2	0	0	0	0	4
Bacteria;Bacteria_none;Firmicutes;Bacilli;Bacillales;Planococcaceae;Sporosarcina;Sporosarcina thermotolerans	0	0	2	0	0	0	0	2	4
Bacteria;Bacteria_none;Firmicutes;Clostridia;Eubacteriales;Peptococcaceae;Desulfofundulus;Desulfofundulus luciae	0	1	2	1	0	0	0	0	4
Bacteria;Bacteria_none;Proteobacteria;Alphaproteobacteria;Hyphomicrobiales;Kaistiaceae;Kaistia;Kaistia dalseonensis	0	2	1	1	0	0	0	0	4
Bacteria;Bacteria_none;Firmicutes;Bacilli;Bacillales;Bacillaceae;Metabacillus;Metabacillus idriensis	0	0	3	1	0	0	0	0	4
Bacteria;Bacteria_none;Firmicutes;Bacilli;Bacillales;Bacillaceae;Rossellomorea;Rossellomorea aquimaris	0	0	3	0	0	0	0	1	4
Bacteria;Bacteria_none;Proteobacteria;Alphaproteobacteria;Hyphomicrobiales;Methylobacteriaceae;Microvirga;Microvirga alba	1	1	0	0	2	0	0	0	4
Bacteria;Bacteria_none;Firmicutes;Bacilli;Bacillales;Bacillaceae;Salicibibacter;Salicibibacter cibarius	0	4	0	0	0	0	0	0	4
Bacteria;Bacteria_none;Firmicutes;Bacilli;Bacillales;Planococcaceae;Solibacillus;Solibacillus isronensis	0	0	1	0	0	3	0	0	4
Bacteria;Bacteria_none;Firmicutes;Bacilli;Bacillales;Bacillaceae;Tepidibacillus;Tepidibacillus decaturensis	0	1	0	1	0	2	0	0	4
Bacteria;Bacteria_none;Chlamydiae;Chlamydiia;Chlamydiales;Chlamydiaceae;Chlamydia;Chlamydia ibidis	0	0	2	2	0	0	0	0	4
Bacteria;Bacteria_none;Proteobacteria;Alphaproteobacteria;Hyphomicrobiales;Chelatococcaceae;Chelatococcus;Chelatococcus asaccharovorans	1	0	0	2	1	0	0	0	4
Bacteria;Bacteria_none;Actinobacteria;Actinomycetia;Corynebacteriales;Mycobacteriaceae;Mycolicibacterium;Mycolicibacter acidiphilus	0	0	1	3	0	0	0	0	4
Bacteria;Bacteria_none;Firmicutes;Bacilli;Bacillales;Bacillaceae;Siminovitchia;Siminovitchia farraginis	0	0	4	0	0	0	0	0	4
Bacteria;Bacteria_none;Firmicutes;Bacilli;Bacillales;Bacillaceae;Salimicrobium;Salimicrobium jeotgali	0	4	0	0	0	0	0	0	4
Bacteria;Bacteria_none;Firmicutes;Clostridia;Eubacteriales;Proteinivoraceae;Anaerobranca;Anaerobranca gottschalkii	0	0	4	0	0	0	0	0	4
Bacteria;Bacteria_none;Actinobacteria;Actinomycetia;Corynebacteriales;Mycobacteriaceae;Mycolicibacterium;Mycolicibacterium aubagnense	2	0	0	0	0	0	2	0	4
Bacteria;Bacteria_none;Actinobacteria;Actinomycetia;Corynebacteriales;Tsukamurellaceae;Tsukamurella;Tsukamurella tyrosinosolvens	2	0	0	2	0	0	0	0	4
Bacteria;Bacteria_none;Actinobacteria;Actinomycetia;Corynebacteriales;Mycobacteriaceae;Mycolicibacterium;Mycolicibacterium elephantis	0	1	1	1	0	1	0	0	4
Bacteria;Bacteria_none;Proteobacteria;Alphaproteobacteria;Hyphomicrobiales;Devosiaceae;Devosia;Devosia limi	0	0	3	1	0	0	0	0	4
Bacteria;Bacteria_none;Firmicutes;Clostridia;Eubacteriales;Oscillospiraceae;Lawsonibacter;Lawsonibacter asaccharolyticus	1	0	1	2	0	0	0	0	4
Bacteria;Bacteria_none;Firmicutes;Clostridia;Eubacteriales;Clostridiaceae;Alkaliphilus;Alkaliphilus serpentinus	0	0	3	0	0	1	0	0	4
Bacteria;Bacteria_none;Proteobacteria;Alphaproteobacteria;Hyphomicrobiales;Devosiaceae;Devosia;Devosia neptuniae	1	0	0	3	0	0	0	0	4
Bacteria;Bacteria_none;Firmicutes;Bacilli;Bacillales;Bacillaceae;Mesobacillus;Mesobacillus campisalis	0	0	2	0	2	0	0	0	4
Bacteria;Bacteria_none;Firmicutes;Clostridia;Eubacteriales;Oscillospiraceae;Fournierella;Fournierella massiliensis	1	3	0	0	0	0	0	0	4
Bacteria;Bacteria_none;Firmicutes;Bacilli;Bacillales;Planococcaceae;Sporosarcina;Sporosarcina pasteurii	0	0	4	0	0	0	0	0	4
Bacteria;Bacteria_none;Firmicutes;Bacilli;Bacillales;Planococcaceae;Sporosarcina;Sporosarcina psychrophila	0	0	0	4	0	0	0	0	4
Bacteria;Bacteria_none;Firmicutes;Bacilli;Bacillales;Bacillaceae;Rossellomorea;Rossellomorea marisflavi	0	0	2	0	0	0	1	1	4
Bacteria;Bacteria_none;Firmicutes;Clostridia;Eubacteriales;Peptostreptococcaceae;Peptoanaerobacter;Peptoanaerobacter stomatis	0	1	1	0	0	1	1	0	4
Bacteria;Bacteria_none;Actinobacteria;Actinomycetia;Micrococcales;Cellulomonadaceae;Cellulomonas;Cellulomonas hominis	0	3	1	0	0	0	0	0	4
Bacteria;Bacteria_none;Proteobacteria;Alphaproteobacteria;Hyphomicrobiales;Methylobacteriaceae;Microvirga;Microvirga indica	0	3	0	1	0	0	0	0	4
Bacteria;Bacteria_none;Proteobacteria;Alphaproteobacteria;Hyphomicrobiales;Methylobacteriaceae;Microvirga;Microvirga brassicacearum	3	0	1	0	0	0	0	0	4
Bacteria;Bacteria_none;Cyanobacteria;Cyanobacteria_Incertae_sedis;Synechococcales;Synechococcaceae;Synechococcus;Synechococcus moorigangaii	0	0	3	0	0	1	0	0	4
Bacteria;Bacteria_none;Proteobacteria;Alphaproteobacteria;Hyphomicrobiales;Aurantimonadaceae;Aureimonas;Aureimonas psammosilenae	1	2	0	0	1	0	0	0	4
Bacteria;Bacteria_none;Firmicutes;Bacilli;Bacillales;Paenibacillaceae;Paenibacillus;Paenibacillus phoenicis	0	0	2	0	2	0	0	0	4
Bacteria;Bacteria_none;Actinobacteria;Actinomycetia;Micrococcales;Microbacteriaceae;Microbacterium;Microbacterium faecale	0	0	2	1	0	0	1	0	4
Bacteria;Bacteria_none;Firmicutes;Clostridia;Eubacteriales;Clostridiaceae;Geosporobacter;Geosporobacter subterraneus	0	0	2	0	0	2	0	0	4
Bacteria;Bacteria_none;Firmicutes;Clostridia;Eubacteriales;Clostridiaceae;Lactonifactor;Lactonifactor longoviformis	1	1	2	0	0	0	0	0	4
Bacteria;Bacteria_none;Actinobacteria;Actinomycetia;Corynebacteriales;Gordoniaceae;Gordonia;Gordonia shandongensis	0	1	0	3	0	0	0	0	4
Bacteria;Bacteria_none;Firmicutes;Bacilli;Bacillales;Bacillaceae;Anoxybacillus;Anoxybacillus ayderensis	0	0	3	1	0	0	0	0	4
Bacteria;Bacteria_none;Firmicutes;Bacilli;Bacillales;Paenibacillaceae;Paenibacillus;Paenibacillus panaciterrae	1	0	1	0	0	1	0	1	4
Bacteria;Bacteria_none;Nitrospirae;Thermodesulfovibrionia;Thermodesulfovibrionales;Thermodesulfovibrionaceae;Thermodesulfovibrio;Thermodesulfovibrio aggregans	0	1	1	0	0	0	0	2	4
Bacteria;Bacteria_none;Firmicutes;Bacilli;Lactobacillales;Lactobacillaceae;Loigolactobacillus;Loigolactobacillus bifermentans	4	0	0	0	0	0	0	0	4
Bacteria;Bacteria_none;Firmicutes;Bacilli;Lactobacillales;Aerococcaceae;Facklamia;Facklamia hominis	3	0	1	0	0	0	0	0	4
Bacteria;Bacteria_none;Firmicutes;Tissierellia;Tissierellales;Peptoniphilaceae;Peptoniphilus;Peptoniphilus ivorii	1	2	0	0	0	1	0	0	4
Bacteria;Bacteria_none;Actinobacteria;Actinomycetia;Corynebacteriales;Gordoniaceae;Gordonia;Gordonia iterans	2	0	0	0	2	0	0	0	4
Bacteria;Bacteria_none;Firmicutes;Tissierellia;Tissierellales;Peptoniphilaceae;Peptoniphilus;Peptoniphilus indolicus	0	0	3	1	0	0	0	0	4
Bacteria;Bacteria_none;Firmicutes;Clostridia;Eubacteriales;Clostridiaceae;Fonticella;Fonticella tunisiensis	1	1	0	1	0	0	0	1	4
Bacteria;Bacteria_none;Planctomycetota;Planctomycetia;Pirellulales;Lacipirellulaceae;Bythopirellula;Bythopirellula goksoeyrii	0	0	1	1	0	2	0	0	4
Bacteria;Bacteria_none;Firmicutes;Tissierellia;Tissierellales;Peptoniphilaceae;Anaerococcus;Anaerococcus obesiensis	4	0	0	0	0	0	0	0	4
Bacteria;Bacteria_none;Firmicutes;Bacilli;Bacillales;Paenibacillaceae;Paenibacillus;Paenibacillus pini	0	0	4	0	0	0	0	0	4
Bacteria;Bacteria_none;Proteobacteria;Alphaproteobacteria;Hyphomicrobiales;Rhizobiaceae;Pararhizobium;Pararhizobium haloflavum	1	0	1	1	0	1	0	0	4
Bacteria;Bacteria_none;Proteobacteria;Alphaproteobacteria;Hyphomicrobiales;Phyllobacteriaceae;Roseitalea;Roseitalea porphyridii	1	1	0	2	0	0	0	0	4
Bacteria;Bacteria_none;Firmicutes;Clostridia;Eubacteriales;Clostridiaceae;Massilioclostridium;Massilioclostridium coli	1	0	0	0	1	2	0	0	4
Bacteria;Bacteria_none;Bacteroidota;Flavobacteriia;Flavobacteriales;Weeksellaceae;Epilithonimonas;Epilithonimonas bovis	3	1	0	0	0	0	0	0	4
Bacteria;Bacteria_none;Deinococcus-Thermus;Deinococci;Trueperales;Trueperaceae;Truepera;Truepera radiovictrix	0	1	1	1	0	0	0	1	4
Bacteria;Bacteria_none;Firmicutes;Clostridia;Eubacteriales;Lachnospiraceae;Blautia;Blautia hominis	1	0	0	2	0	1	0	0	4
Bacteria;Bacteria_none;Firmicutes;Clostridia;Eubacteriales;Clostridiaceae;Clostridium;Clostridium putrefaciens	0	2	0	1	0	1	0	0	4
Bacteria;Bacteria_none;Actinobacteria;Actinomycetia;Kineosporiales;Kineosporiaceae;Kineococcus;Kineococcus aurantiacus	0	0	2	2	0	0	0	0	4
Bacteria;Bacteria_none;Firmicutes;Bacilli;Bacillales;Alicyclobacillaceae;Tumebacillus;Tumebacillus ginsengisoli	0	0	1	3	0	0	0	0	4
Bacteria;Bacteria_none;Actinobacteria;Actinomycetia;Corynebacteriales;Gordoniaceae;Gordonia;Gordonia phthalatica	0	2	1	0	1	0	0	0	4
Bacteria;Bacteria_none;Bacteroidota;Flavobacteriia;Flavobacteriales;Weeksellaceae;Cloacibacterium;Cloacibacterium haliotis	4	0	0	0	0	0	0	0	4
Bacteria;Bacteria_none;Cyanobacteria;Cyanobacteria_Incertae_sedis;Synechococcales;Synechococcales_Incertae_sedis;Metis;Metis fasciculata	0	0	2	1	0	0	0	1	4
Bacteria;Bacteria_none;Actinobacteria;Actinomycetia;Corynebacteriales;Gordoniaceae;Gordonia;Gordonia defluvii	0	2	2	0	0	0	0	0	4
Bacteria;Bacteria_none;Firmicutes;Bacilli;Bacillales;Bacillaceae;Bacillus;Bacillus bingmayongensis	0	0	4	0	0	0	0	0	4
Bacteria;Bacteria_none;Actinobacteria;Actinomycetia;Micrococcales;Intrasporangiaceae;Tetrasphaera;Tetrasphaera vanveenii	3	1	0	0	0	0	0	0	4
Bacteria;Bacteria_none;Firmicutes;Tissierellia;Tissierellales;Tissierellaceae;Gudongella;Gudongella oleilytica	4	0	0	0	0	0	0	0	4
Bacteria;Bacteria_none;Firmicutes;Clostridia;Eubacteriales;Clostridiaceae;Clostridium;Clostridium sartagoforme	1	1	0	0	0	2	0	0	4
Bacteria;Bacteria_none;Firmicutes;Clostridia;Eubacteriales;Clostridiaceae;Hathewaya;Hathewaya massiliensis	1	1	0	0	1	0	0	1	4
Bacteria;Bacteria_none;Proteobacteria;Alphaproteobacteria;Hyphomicrobiales;Rhizobiaceae;Ensifer;Ensifer numidicus	0	3	1	0	0	0	0	0	4
Bacteria;Bacteria_none;Firmicutes;Tissierellia;Tissierellales;Tissierellaceae;Anaerosalibacter;Anaerosalibacter bizertensis	0	1	1	0	1	0	0	1	4
Bacteria;Bacteria_none;Fusobacteria;Fusobacteriia;Fusobacteriales;Fusobacteriaceae;Fusobacterium;Fusobacterium mortiferum	2	0	0	0	0	0	0	2	4
Bacteria;Bacteria_none;Proteobacteria;Alphaproteobacteria;Hyphomicrobiales;Rhizobiaceae;Pseudorhizobium;Pseudorhizobium halotolerans	1	0	0	3	0	0	0	0	4
Bacteria;Bacteria_none;Actinobacteria;Actinomycetia;Streptosporangiales;Nocardiopsaceae;Nocardiopsis;Nocardiopsis coralli	0	0	1	1	0	0	1	0	3
Bacteria;Bacteria_none;Bacteroidota;Chitinophagia;Chitinophagales;Chitinophagaceae;Sediminibacterium;Sediminibacterium salmoneum	2	1	0	0	0	0	0	0	3
Bacteria;Bacteria_none;Firmicutes;Bacilli;Bacillales;Bacillaceae;Mesobacillus;Mesobacillus rigiliprofundi	0	0	1	1	0	1	0	0	3
Bacteria;Bacteria_none;Proteobacteria;Deltaproteobacteria;Desulfovibrionales;Desulfovibrionaceae;Desulfovibrio;Desulfovibrio giganteus	0	3	0	0	0	0	0	0	3
Bacteria;Bacteria_none;Proteobacteria;Alphaproteobacteria;Rhodospirillales;Thalassospiraceae;Magnetospira;Magnetospira thiophila	3	0	0	0	0	0	0	0	3
Bacteria;Bacteria_none;Proteobacteria;Gammaproteobacteria;Methylococcales;Methylococcaceae;Methylocaldum;Methylocaldum szegediense	2	1	0	0	0	0	0	0	3
Bacteria;Bacteria_none;Actinobacteria;Actinomycetia;Corynebacteriales;Mycobacteriaceae;Mycolicibacterium;Mycolicibacterium chubuense	0	2	0	0	0	0	0	1	3
Bacteria;Bacteria_none;Cyanobacteria;Cyanobacteria_Incertae_sedis;Nostocales;Nostocaceae;Cyanocohniella;Cyanocohniella hyphalmyra	0	2	0	1	0	0	0	0	3
Bacteria;Bacteria_none;Acidobacteria;Acidobacteriia;Acidobacteriales;Acidobacteriaceae;Acidicapsa;Acidicapsa acidiphila	2	0	1	0	0	0	0	0	3
Bacteria;Bacteria_none;Proteobacteria;Gammaproteobacteria;Oceanospirillales;Halomonadaceae;Halomonas;Halomonas flava	0	3	0	0	0	0	0	0	3
Bacteria;Bacteria_none;Proteobacteria;Gammaproteobacteria;Xanthomonadales;Xanthomonadaceae;Luteimonas;Luteimonas terricola	2	0	0	1	0	0	0	0	3
Bacteria;Bacteria_none;Actinobacteria;Actinomycetia;Micrococcales;Micrococcaceae;Pseudarthrobacter;Pseudarthrobacter phenanthrenivorans	0	0	1	2	0	0	0	0	3
Bacteria;Bacteria_none;Actinobacteria;Actinomycetia;Corynebacteriales;Corynebacteriaceae;Corynebacterium;Corynebacterium timonense	1	2	0	0	0	0	0	0	3
Bacteria;Bacteria_none;Bacteroidota;Bacteroidia;Bacteroidales;Prevotellaceae;Prevotella;Prevotella micans	1	1	0	1	0	0	0	0	3
Bacteria;Bacteria_none;Actinobacteria;Actinomycetia;Actinomycetales;Actinomycetaceae;Actinomyces;Actinomyces dentalis	1	1	0	0	0	1	0	0	3
Bacteria;Bacteria_none;Actinobacteria;Actinomycetia;Micrococcales;Microbacteriaceae;Leifsonia;Leifsonia soli	0	0	0	3	0	0	0	0	3
Bacteria;Bacteria_none;Bacteroidota;Bacteroidia;Bacteroidales;Prevotellaceae;Prevotella;Prevotella mizrahii	1	0	0	1	0	0	1	0	3
Bacteria;Bacteria_none;Proteobacteria;Gammaproteobacteria;Legionellales;Legionellaceae;Legionella;Legionella yabuuchiae	1	0	1	0	0	1	0	0	3
Bacteria;Bacteria_none;Proteobacteria;Alphaproteobacteria;Rhodospirillales;Rhodospirillaceae;Rhodospirillum;Rhodospirillum rubrum	0	2	1	0	0	0	0	0	3
Bacteria;Bacteria_none;Actinobacteria;Actinomycetia;Streptosporangiales;Nocardiopsaceae;Allosalinactinospora;Allosalinactinospora lopnorensis	0	2	0	1	0	0	0	0	3
Bacteria;Bacteria_none;Actinobacteria;Actinomycetia;Corynebacteriales;Mycobacteriaceae;Mycolicibacterium;Mycolicibacterium hassiacum	1	0	0	2	0	0	0	0	3
Bacteria;Bacteria_none;Actinobacteria;Actinomycetia;Actinomycetales;Actinomycetaceae;Pauljensenia;Pauljensenia hongkongensis	1	1	1	0	0	0	0	0	3
Bacteria;Bacteria_none;Firmicutes;Negativicutes;Selenomonadales;Sporomusaceae;Sporolituus;Sporolituus thermophilus	1	0	0	1	0	1	0	0	3
Bacteria;Bacteria_none;Proteobacteria;Alphaproteobacteria;Rhodospirillales;Thalassospiraceae;Thalassospira;Thalassospira povalilytica	0	1	2	0	0	0	0	0	3
Bacteria;Bacteria_none;Actinobacteria;Actinomycetia;Micrococcales;Micrococcaceae;Rothia;Rothia kristinae	1	1	0	1	0	0	0	0	3
Bacteria;Bacteria_none;Proteobacteria;Gammaproteobacteria;Oceanospirillales;Halomonadaceae;Carnimonas;Carnimonas nigrificans	2	0	1	0	0	0	0	0	3
Bacteria;Bacteria_none;Proteobacteria;Alphaproteobacteria;Sphingomonadales;Erythrobacteraceae;Erythrobacter;Erythrobacter aureus	0	0	0	1	0	2	0	0	3
Bacteria;Bacteria_none;Proteobacteria;Alphaproteobacteria;Hyphomicrobiales;Brucellaceae;Falsochrobactrum;Falsochrobactrum ovis	2	0	0	0	0	1	0	0	3
Bacteria;Bacteria_none;Proteobacteria;Gammaproteobacteria;Oceanospirillales;Hahellaceae;Hahella;Hahella ganghwensis	0	1	0	2	0	0	0	0	3
Bacteria;Bacteria_none;Proteobacteria;Alphaproteobacteria;Sphingomonadales;Erythrobacteraceae;Erythrobacter;Erythrobacter dokdonensis	0	0	0	3	0	0	0	0	3
Bacteria;Bacteria_none;Actinobacteria;Actinomycetia;Corynebacteriales;Mycobacteriaceae;Mycolicibacter;Mycolicibacter longobardus	1	1	1	0	0	0	0	0	3
Bacteria;Bacteria_none;Actinobacteria;Actinomycetia;Micrococcales;Cellulomonadaceae;Pseudactinotalea;Pseudactinotalea suaedae	0	3	0	0	0	0	0	0	3
Bacteria;Bacteria_none;Actinobacteria;Actinomycetia;Streptosporangiales;Streptosporangiaceae;Nonomuraea;Nonomuraea fastidiosa	0	1	0	0	2	0	0	0	3
Bacteria;Bacteria_none;Proteobacteria;Deltaproteobacteria;Desulfobacterales;Desulfobulbaceae;Desulfomarina;Desulfomarina profundi	0	2	1	0	0	0	0	0	3
Bacteria;Bacteria_none;Firmicutes;Negativicutes;Veillonellales;Veillonellaceae;Veillonella;Veillonella caviae	1	1	0	0	0	1	0	0	3
Bacteria;Bacteria_none;Firmicutes;Negativicutes;Veillonellales;Veillonellaceae;Negativicoccus;Negativicoccus succinicivorans	0	3	0	0	0	0	0	0	3
Bacteria;Bacteria_none;Proteobacteria;Deltaproteobacteria;Desulfobacterales;Desulfobulbaceae;Desulfobulbus;Desulfobulbus elongatus	1	2	0	0	0	0	0	0	3
Bacteria;Bacteria_none;Actinobacteria;Actinomycetia;Micrococcales;Micrococcaceae;Zhihengliuella;Zhihengliuella somnathii	1	0	2	0	0	0	0	0	3
Bacteria;Bacteria_none;Cyanobacteria;Cyanobacteria_Incertae_sedis;Nostocales;Rivulariaceae;Phyllonema;Phyllonema ansata	0	1	1	0	0	0	1	0	3
Bacteria;Bacteria_none;Firmicutes;Bacilli;Bacillales;Bacillaceae;Lentibacillus;Lentibacillus populi	3	0	0	0	0	0	0	0	3
Bacteria;Bacteria_none;Firmicutes;Bacilli;Bacillales;Bacillaceae;Lysinibacillus;Lysinibacillus cavernae	1	1	1	0	0	0	0	0	3
Bacteria;Bacteria_none;Firmicutes;Bacilli;Lactobacillales;Lactobacillaceae;Companilactobacillus;Companilactobacillus paralimentarius	2	0	0	1	0	0	0	0	3
Bacteria;Bacteria_none;Actinobacteria;Actinomycetia;Streptosporangiales;Nocardiopsaceae;Nocardiopsis;Nocardiopsis nanhaiensis	0	0	1	0	2	0	0	0	3
Bacteria;Bacteria_none;Actinobacteria;Actinomycetia;Corynebacteriales;Mycobacteriaceae;Hoyosella;Hoyosella lacisalsi	1	0	0	1	0	1	0	0	3
Bacteria;Bacteria_none;Firmicutes;Bacilli;Bacillales;Bacillaceae;Lysinibacillus;Lysinibacillus varians	0	0	2	1	0	0	0	0	3
Bacteria;Bacteria_none;Firmicutes;Bacilli;Bacillales;Bacillaceae;Alteribacter;Alteribacter lacisalsi	1	2	0	0	0	0	0	0	3
Bacteria;Bacteria_none;Firmicutes;Bacilli;Bacillales;Alicyclobacillaceae;Alicyclobacillus;Alicyclobacillus shizuokensis	0	0	2	1	0	0	0	0	3
Bacteria;Bacteria_none;Firmicutes;Bacilli;Lactobacillales;Aerococcaceae;Falseniella;Falseniella ignava	3	0	0	0	0	0	0	0	3
Bacteria;Bacteria_none;Actinobacteria;Actinomycetia;Streptosporangiales;Streptosporangiaceae;Microbispora;Microbispora cellulosiformans	0	0	2	0	0	1	0	0	3
Bacteria;Bacteria_none;Firmicutes;Bacilli;Lactobacillales;Lactobacillaceae;Fructilactobacillus;Fructilactobacillus sanfranciscensis	0	3	0	0	0	0	0	0	3
Bacteria;Bacteria_none;Proteobacteria;Gammaproteobacteria;Xanthomonadales;Xanthomonadaceae;Luteimonas;Luteimonas marina	2	1	0	0	0	0	0	0	3
Bacteria;Bacteria_none;Proteobacteria;Alphaproteobacteria;Rickettsiales;Rickettsiaceae;Rickettsia;Rickettsia honei	3	0	0	0	0	0	0	0	3
Bacteria;Bacteria_none;Proteobacteria;Alphaproteobacteria;Hyphomicrobiales;Devosiaceae;Cucumibacter;Cucumibacter marinus	1	1	1	0	0	0	0	0	3
Bacteria;Bacteria_none;Actinobacteria;Actinomycetia;Propionibacteriales;Nocardioidaceae;Marmoricola;Marmoricola scoriae	0	3	0	0	0	0	0	0	3
Bacteria;Bacteria_none;Bacteroidota;Chitinophagia;Chitinophagales;Chitinophagaceae;Paraflavitalea;Paraflavitalea devenefica	2	1	0	0	0	0	0	0	3
Bacteria;Bacteria_none;Proteobacteria;Gammaproteobacteria;Pasteurellales;Pasteurellaceae;Mannheimia;Mannheimia ovis	2	0	0	0	1	0	0	0	3
Bacteria;Bacteria_none;Proteobacteria;Alphaproteobacteria;Sphingomonadales;Erythrobacteraceae;Altererythrobacter;Altererythrobacter palmitatis	2	0	0	0	0	1	0	0	3
Bacteria;Bacteria_none;Proteobacteria;Deltaproteobacteria;Desulfovibrionales;Desulfohalobiaceae;Desulfothermus;Desulfothermus okinawensis	0	1	2	0	0	0	0	0	3
Bacteria;Bacteria_none;Firmicutes;Bacilli;Bacillales;Bacillaceae;Lysinibacillus;Lysinibacillus endophyticus	0	3	0	0	0	0	0	0	3
Bacteria;Bacteria_none;Firmicutes;Bacilli;Bacillales;Staphylococcaceae;Nosocomiicoccus;Nosocomiicoccus ampullae	0	0	0	2	0	1	0	0	3
Bacteria;Bacteria_none;Proteobacteria;Alphaproteobacteria;Rhodospirillales;Rhodospirillaceae;Hwanghaeella;Hwanghaeella grinnelliae	0	3	0	0	0	0	0	0	3
Bacteria;Bacteria_none;Actinobacteria;Actinomycetia;Propionibacteriales;Nocardioidaceae;Nocardioides;Nocardioides albus	1	0	1	0	0	1	0	0	3
Bacteria;Bacteria_none;Actinobacteria;Actinomycetia;Micrococcales;Micrococcaceae;Nesterenkonia;Nesterenkonia alkaliphila	0	3	0	0	0	0	0	0	3
Bacteria;Bacteria_none;Firmicutes;Bacilli;Bacillales;Bacillaceae;Alkalihalobacillus;Alkalihalobacillus lindianensis	1	2	0	0	0	0	0	0	3
Bacteria;Bacteria_none;Firmicutes;Tissierellia;Tissierellales;Peptoniphilaceae;Peptoniphilus;Peptoniphilus koenoeneniae	0	2	0	1	0	0	0	0	3
Bacteria;Bacteria_none;Actinobacteria;Actinomycetia;Micrococcales;Micrococcaceae;Micrococcus;Micrococcus antarcticus	0	2	0	1	0	0	0	0	3
Bacteria;Bacteria_none;Actinobacteria;Actinomycetia;Propionibacteriales;Nocardioidaceae;Nocardioides;Nocardioides bigeumensis	0	0	1	1	0	1	0	0	3
Bacteria;Bacteria_none;Cyanobacteria;Cyanobacteria_Incertae_sedis;Nostocales;Calotrichaceae;Dulcicalothrix;Dulcicalothrix alborzica	0	1	2	0	0	0	0	0	3
Bacteria;Bacteria_none;Proteobacteria;Betaproteobacteria;Burkholderiales;Comamonadaceae;Hydrogenophaga;Hydrogenophaga temperata	3	0	0	0	0	0	0	0	3
Bacteria;Bacteria_none;Firmicutes;Bacilli;Lactobacillales;Lactobacillaceae;Lactobacillus;Lactobacillus acidophilus	2	0	0	0	0	0	0	1	3
Bacteria;Bacteria_none;Actinobacteria;Actinomycetia;Micrococcales;Brevibacteriaceae;Sediminivirga;Sediminivirga luteola	0	0	1	1	1	0	0	0	3
Bacteria;Bacteria_none;Proteobacteria;Gammaproteobacteria;Oceanospirillales;Oceanospirillaceae;Marinobacterium;Marinobacterium coralli	3	0	0	0	0	0	0	0	3
Bacteria;Bacteria_none;Bacteroidota;Cytophagia;Cytophagales;Cyclobacteriaceae;Shivajiella;Shivajiella indica	2	1	0	0	0	0	0	0	3
Bacteria;Bacteria_none;Actinobacteria;Actinomycetia;Streptomycetales;Streptomycetaceae;Streptomyces;Streptomyces spiralis	0	1	0	2	0	0	0	0	3
Bacteria;Bacteria_none;Bacteroidota;Cytophagia;Cytophagales;Cyclobacteriaceae;Lunatibacter;Lunatibacter salilacus	2	0	0	0	0	0	0	1	3
Bacteria;Bacteria_none;Firmicutes;Bacilli;Bacillales;Staphylococcaceae;Abyssicoccus;Abyssicoccus albus	1	1	0	0	0	0	0	1	3
Bacteria;Bacteria_none;Actinobacteria;Actinomycetia;Streptomycetales;Streptomycetaceae;Streptomyces;Streptomyces sulphureus	0	1	2	0	0	0	0	0	3
Bacteria;Bacteria_none;Proteobacteria;Alphaproteobacteria;Hyphomicrobiales;Hyphomicrobiaceae;Hyphomicrobium;Hyphomicrobium nitrativorans	0	3	0	0	0	0	0	0	3
Bacteria;Bacteria_none;Cyanobacteria;Cyanobacteria_Incertae_sedis;Chroococcidiopsidales;Chroococcidiopsidaceae;Chroococcidiopsis;Chroococcidiopsis lichenoides	0	1	1	1	0	0	0	0	3
Bacteria;Bacteria_none;Proteobacteria;Deltaproteobacteria;Desulfuromonadales;Geobacteraceae;Citrifermentans;Citrifermentans bemidjiense	0	3	0	0	0	0	0	0	3
Bacteria;Bacteria_none;Bacteroidota;Bacteroidia;Bacteroidales;Porphyromonadaceae;Porphyromonas;Porphyromonas cangingivalis	0	2	1	0	0	0	0	0	3
Bacteria;Bacteria_none;Firmicutes;Bacilli;Bacillales;Planococcaceae;Ureibacillus;Ureibacillus thermosphaericus	0	2	0	0	1	0	0	0	3
Bacteria;Bacteria_none;Actinobacteria;Actinomycetia;Micrococcales;Microbacteriaceae;Leucobacter;Leucobacter alluvii	0	2	1	0	0	0	0	0	3
Bacteria;Bacteria_none;Proteobacteria;Alphaproteobacteria;Rhodospirillales;Acetobacteraceae;Roseomonas;Roseomonas deserti	0	2	0	1	0	0	0	0	3
Bacteria;Bacteria_none;Proteobacteria;Gammaproteobacteria;Legionellales;Legionellaceae;Legionella;Legionella gratiana	1	0	2	0	0	0	0	0	3
Bacteria;Bacteria_none;Proteobacteria;Deltaproteobacteria;Myxococcales;Archangiaceae;Vitiosangium;Vitiosangium cumulatum	2	0	1	0	0	0	0	0	3
Bacteria;Bacteria_none;Firmicutes;Clostridia;Eubacteriales;Clostridiaceae;Clostridium;Clostridium argentinense	2	0	0	0	0	0	0	1	3
Bacteria;Bacteria_none;Proteobacteria;Alphaproteobacteria;Rhodospirillales;Acetobacteraceae;Roseomonas;Roseomonas hellenica	0	3	0	0	0	0	0	0	3
Bacteria;Bacteria_none;Actinobacteria;Actinomycetia;Streptomycetales;Streptomycetaceae;Streptomyces;Streptomyces reticuliscabiei	2	1	0	0	0	0	0	0	3
Bacteria;Bacteria_none;Proteobacteria;Gammaproteobacteria;Legionellales;Legionellaceae;Legionella;Legionella maceachernii	0	0	2	0	0	1	0	0	3
Bacteria;Bacteria_none;Actinobacteria;Actinomycetia;Streptomycetales;Streptomycetaceae;Streptomyces;Streptomyces roseoviridis	0	0	1	2	0	0	0	0	3
Bacteria;Bacteria_none;Firmicutes;Bacilli;Lactobacillales;Lactobacillaceae;Lactobacillus;Lactobacillus crispatus	3	0	0	0	0	0	0	0	3
Bacteria;Bacteria_none;Firmicutes;Tissierellia;Tissierellales;Thermohalobacteraceae;Caloranaerobacter;Caloranaerobacter ferrireducens	0	0	1	1	0	0	0	1	3
Bacteria;Bacteria_none;Proteobacteria;Alphaproteobacteria;Rhodospirillales;Acetobacteraceae;Roseomonas;Roseomonas radiodurans	1	0	0	2	0	0	0	0	3
Bacteria;Bacteria_none;Firmicutes;Clostridia;Eubacteriales;Peptococcaceae;Desulfofundulus;Desulfofundulus thermosubterraneus	0	0	1	0	0	2	0	0	3
Bacteria;Bacteria_none;Proteobacteria;Deltaproteobacteria;Desulfuromonadales;Geobacteraceae;Geobacter;Geobacter argillaceus	2	1	0	0	0	0	0	0	3
Bacteria;Bacteria_none;Actinobacteria;Actinomycetia;Streptomycetales;Streptomycetaceae;Streptomyces;Streptomyces sundarbansensis	0	0	0	3	0	0	0	0	3
Bacteria;Bacteria_none;Proteobacteria;Gammaproteobacteria;Oceanospirillales;Halomonadaceae;Halomonas;Halomonas smyrnensis	1	0	1	1	0	0	0	0	3
Bacteria;Bacteria_none;Bacteroidota;Bacteroidia;Bacteroidales;Prevotellaceae;Prevotella;Prevotella marshii	0	2	0	0	0	1	0	0	3
Bacteria;Bacteria_none;Actinobacteria;Actinomycetia;Corynebacteriales;Corynebacteriaceae;Corynebacterium;Corynebacterium striatum	0	0	1	0	1	1	0	0	3
Bacteria;Bacteria_none;Bacteroidota;Cytophagia;Cytophagales;Cyclobacteriaceae;Algoriphagus;Algoriphagus jejuensis	0	0	2	1	0	0	0	0	3
Bacteria;Bacteria_none;Firmicutes;Tissierellia;Tissierellales;Peptoniphilaceae;Peptoniphilus;Peptoniphilus raoultii	0	3	0	0	0	0	0	0	3
Bacteria;Bacteria_none;Firmicutes;Bacilli;Lactobacillales;Streptococcaceae;Lactococcus;Lactococcus nasutitermitis	3	0	0	0	0	0	0	0	3
Bacteria;Bacteria_none;Proteobacteria;Deltaproteobacteria;Desulfovibrionales;Desulfovibrionaceae;Oleidesulfovibrio;Oleidesulfovibrio vietnamensis	0	3	0	0	0	0	0	0	3
Bacteria;Bacteria_none;Actinobacteria;Actinomycetia;Corynebacteriales;Mycobacteriaceae;Mycolicibacterium;Mycolicibacterium mengxianglii	1	1	1	0	0	0	0	0	3
Bacteria;Bacteria_none;Fusobacteria;Fusobacteriia;Fusobacteriales;Fusobacteriaceae;Fusobacterium;Fusobacterium necrophorum	2	1	0	0	0	0	0	0	3
Bacteria;Bacteria_none;Cyanobacteria;Cyanobacteria_Incertae_sedis;Nostocales;Scytonemataceae;Scytonema;Scytonema foetidum	0	1	2	0	0	0	0	0	3
Bacteria;Bacteria_none;Actinobacteria;Actinomycetia;Actinomycetales;Actinomycetaceae;Arcanobacterium;Arcanobacterium ihumii	1	2	0	0	0	0	0	0	3
Bacteria;Bacteria_none;Actinobacteria;Actinomycetia;Streptomycetales;Streptomycetaceae;Streptomyces;Streptomyces urticae	0	0	1	2	0	0	0	0	3
Bacteria;Bacteria_none;Proteobacteria;Betaproteobacteria;Burkholderiales;Comamonadaceae;Curvibacter;Curvibacter gracilis	2	1	0	0	0	0	0	0	3
Bacteria;Bacteria_none;Proteobacteria;Alphaproteobacteria;Hyphomicrobiales;Devosiaceae;Maritalea;Maritalea porphyrae	2	0	1	0	0	0	0	0	3
Bacteria;Bacteria_none;Proteobacteria;Gammaproteobacteria;Oceanospirillales;Halomonadaceae;Halomonas;Halomonas lionensis	0	3	0	0	0	0	0	0	3
Bacteria;Bacteria_none;Firmicutes;Tissierellia;Tissierellales;Peptoniphilaceae;Anaerococcus;Anaerococcus tetradius	0	1	1	1	0	0	0	0	3
Bacteria;Bacteria_none;Bacteroidota;Bacteroidia;Bacteroidales;Prevotellaceae;Prevotella;Prevotella marseillensis	0	0	0	3	0	0	0	0	3
Bacteria;Bacteria_none;Proteobacteria;Alphaproteobacteria;Hyphomicrobiales;Devosiaceae;Devosia;Devosia subaequoris	1	1	0	0	0	1	0	0	3
Bacteria;Bacteria_none;Bacteroidota;Bacteroidia;Bacteroidales;Prevotellaceae;Prevotella;Prevotella bryantii	0	0	0	3	0	0	0	0	3
Bacteria;Bacteria_none;Proteobacteria;Alphaproteobacteria;Rhodospirillales;Rhodospirillaceae;Caenispirillum;Caenispirillum deserti	0	0	0	3	0	0	0	0	3
Bacteria;Bacteria_none;Firmicutes;Tissierellia;Tissierellia_Incertae_sedis;Tissierellia_Incertae_sedis;Ezakiella;Ezakiella massiliensis	1	0	1	0	1	0	0	0	3
Bacteria;Bacteria_none;Firmicutes;Bacilli;Bacillales;Bacillaceae;Neobacillus;Neobacillus notoginsengisoli	1	1	0	1	0	0	0	0	3
Bacteria;Bacteria_none;Proteobacteria;Gammaproteobacteria;Xanthomonadales;Xanthomonadaceae;Lysobacter;Lysobacter ruishenii	1	1	0	0	0	0	1	0	3
Bacteria;Bacteria_none;Firmicutes;Tissierellia;Tissierellales;Tissierellaceae;Tissierella;Tissierella praeacuta	1	0	1	0	0	0	0	1	3
Bacteria;Bacteria_none;Actinobacteria;Actinomycetia;Micrococcales;Micrococcaceae;Nesterenkonia;Nesterenkonia aurantiaca	0	0	0	0	0	3	0	0	3
Bacteria;Bacteria_none;Proteobacteria;Gammaproteobacteria;Xanthomonadales;Xanthomonadaceae;Lysobacter;Lysobacter rhizosphaerae	3	0	0	0	0	0	0	0	3
Bacteria;Bacteria_none;Actinobacteria;Actinomycetia;Micrococcales;Microbacteriaceae;Leucobacter;Leucobacter chromiisoli	0	0	1	2	0	0	0	0	3
Bacteria;Bacteria_none;Proteobacteria;Alphaproteobacteria;Rhodospirillales;Azospirillaceae;Skermanella;Skermanella rubra	0	0	0	2	0	1	0	0	3
Bacteria;Bacteria_none;Actinobacteria;Actinomycetia;Bifidobacteriales;Bifidobacteriaceae;Bifidobacterium;Bifidobacterium minimum	0	2	1	0	0	0	0	0	3
Bacteria;Bacteria_none;Firmicutes;Tissierellia;Tissierellia_Incertae_sedis;Tissierellia_Incertae_sedis;Ezakiella;Ezakiella coagulans	1	0	0	1	1	0	0	0	3
Bacteria;Bacteria_none;Actinobacteria;Actinomycetia;Streptomycetales;Streptomycetaceae;Streptomyces;Streptomyces tacrolimicus	0	1	0	1	0	1	0	0	3
Bacteria;Bacteria_none;Firmicutes;Bacilli;Lactobacillales;Aerococcaceae;Facklamia;Facklamia lactis	1	0	1	0	1	0	0	0	3
Bacteria;Bacteria_none;Proteobacteria;Gammaproteobacteria;Xanthomonadales;Xanthomonadaceae;Lysobacter;Lysobacter oryzae	2	0	0	1	0	0	0	0	3
Bacteria;Bacteria_none;Proteobacteria;Alphaproteobacteria;Rhodospirillales;Kiloniellaceae;Kiloniella;Kiloniella antarctica	2	0	1	0	0	0	0	0	3
Bacteria;Bacteria_none;Actinobacteria;Actinomycetia;Micrococcales;Micrococcaceae;Nesterenkonia;Nesterenkonia flava	2	0	0	1	0	0	0	0	3
Bacteria;Bacteria_none;Cyanobacteria;Cyanobacteria_Incertae_sedis;Nostocales;Hapalosiphonaceae;Fischerella;Fischerella indica	1	2	0	0	0	0	0	0	3
Bacteria;Bacteria_none;Proteobacteria;Alphaproteobacteria;Hyphomicrobiales;Brucellaceae;Brucella;Brucella ovis	0	0	3	0	0	0	0	0	3
Bacteria;Bacteria_none;Firmicutes;Clostridia;Eubacteriales;Clostridiaceae;Clostridium;Clostridium fessum	2	0	0	0	1	0	0	0	3
Bacteria;Bacteria_none;Actinobacteria;Actinomycetia;Micrococcales;Microbacteriaceae;Humibacter;Humibacter ginsengisoli	1	1	0	1	0	0	0	0	3
Bacteria;Bacteria_none;Proteobacteria;Betaproteobacteria;Burkholderiales;Alcaligenaceae;Kerstersia;Kerstersia gyiorum	0	0	2	1	0	0	0	0	3
Bacteria;Bacteria_none;Actinobacteria;Coriobacteriia;Coriobacteriales;Coriobacteriaceae;Collinsella;Collinsella intestinalis	1	1	1	0	0	0	0	0	3
Bacteria;Bacteria_none;Proteobacteria;Alphaproteobacteria;Caulobacterales;Caulobacteraceae;Caulobacter;Caulobacter fusiformis	1	0	0	2	0	0	0	0	3
Bacteria;Bacteria_none;Proteobacteria;Betaproteobacteria;Burkholderiales;Alcaligenaceae;Castellaniella;Castellaniella denitrificans	0	0	2	0	0	1	0	0	3
Bacteria;Bacteria_none;Proteobacteria;Betaproteobacteria;Burkholderiales;Alcaligenaceae;Castellaniella;Castellaniella fermenti	0	1	1	1	0	0	0	0	3
Bacteria;Bacteria_none;Proteobacteria;Gammaproteobacteria;Salinisphaerales;Salinisphaeraceae;Salinisphaera;Salinisphaera shabanensis	1	1	0	1	0	0	0	0	3
Bacteria;Bacteria_none;Proteobacteria;Alphaproteobacteria;Caulobacterales;Caulobacteraceae;Brevundimonas;Brevundimonas variabilis	0	3	0	0	0	0	0	0	3
Bacteria;Bacteria_none;Proteobacteria;Gammaproteobacteria;Moraxellales;Moraxellaceae;Aquirhabdus;Aquirhabdus parva	2	1	0	0	0	0	0	0	3
Bacteria;Bacteria_none;Proteobacteria;Betaproteobacteria;Burkholderiales;Burkholderiaceae;Polynucleobacter;Polynucleobacter difficilis	0	0	0	3	0	0	0	0	3
Bacteria;Bacteria_none;Firmicutes;Erysipelotrichia;Erysipelotrichales;Erysipelotrichaceae;Dielma;Dielma fastidiosa	0	0	1	1	0	0	0	1	3
Bacteria;Bacteria_none;Actinobacteria;Coriobacteriia;Coriobacteriales;Coriobacteriaceae;Coriobacterium;Coriobacterium glomerans	0	0	0	1	0	2	0	0	3
Bacteria;Bacteria_none;Proteobacteria;Alphaproteobacteria;Caulobacterales;Caulobacteraceae;Brevundimonas;Brevundimonas poindexterae	3	0	0	0	0	0	0	0	3
Bacteria;Bacteria_none;Firmicutes;Bacilli;Bacillales;Thermoactinomycetaceae;Seinonella;Seinonella peptonophila	1	2	0	0	0	0	0	0	3
Bacteria;Bacteria_none;Firmicutes;Clostridia;Eubacteriales;Clostridiaceae;Clostridium;Clostridium merdae	1	0	2	0	0	0	0	0	3
Bacteria;Bacteria_none;Proteobacteria;Gammaproteobacteria;Pseudomonadales;Pseudomonadaceae;Pseudomonas;Pseudomonas borbori	2	0	1	0	0	0	0	0	3
Bacteria;Bacteria_none;Proteobacteria;Gammaproteobacteria;Moraxellales;Moraxellaceae;Moraxella;Moraxella catarrhalis	0	2	1	0	0	0	0	0	3
Bacteria;Bacteria_none;Proteobacteria;Gammaproteobacteria;Pseudomonadales;Pseudomonadaceae;Thiopseudomonas;Thiopseudomonas denitrificans	2	1	0	0	0	0	0	0	3
Bacteria;Bacteria_none;Proteobacteria;Gammaproteobacteria;Moraxellales;Moraxellaceae;Alkanindiges;Alkanindiges hongkongensis	3	0	0	0	0	0	0	0	3
Bacteria;Bacteria_none;Proteobacteria;Betaproteobacteria;Burkholderiales;Alcaligenaceae;Ampullimonas;Ampullimonas aquatilis	3	0	0	0	0	0	0	0	3
Bacteria;Bacteria_none;Proteobacteria;Gammaproteobacteria;Moraxellales;Moraxellaceae;Agitococcus;Agitococcus lubricus	0	2	1	0	0	0	0	0	3
Bacteria;Bacteria_none;Proteobacteria;Betaproteobacteria;Burkholderiales;Oxalobacteraceae;Solimicrobium;Solimicrobium silvestre	1	1	1	0	0	0	0	0	3
Bacteria;Bacteria_none;Actinobacteria;Actinomycetia;Motilibacterales;Motilibacteraceae;Motilibacter;Motilibacter deserti	0	0	0	2	0	1	0	0	3
Bacteria;Bacteria_none;Firmicutes;Erysipelotrichia;Erysipelotrichales;Erysipelotrichaceae;Erysipelothrix;Erysipelothrix anatis	0	0	2	1	0	0	0	0	3
Bacteria;Bacteria_none;Firmicutes;Negativicutes;Veillonellales;Veillonellaceae;Dialister;Dialister pneumosintes	1	1	0	1	0	0	0	0	3
Bacteria;Bacteria_none;Actinobacteria;Actinomycetia;Micromonosporales;Micromonosporaceae;Micromonospora;Micromonospora krabiensis	0	1	2	0	0	0	0	0	3
Bacteria;Bacteria_none;Proteobacteria;Alphaproteobacteria;Caulobacterales;Caulobacteraceae;Phenylobacterium;Phenylobacterium soli	0	0	0	1	0	2	0	0	3
Bacteria;Bacteria_none;Proteobacteria;Betaproteobacteria;Burkholderiales;Alcaligenaceae;Achromobacter;Achromobacter aestuarii	1	0	1	0	1	0	0	0	3
Bacteria;Bacteria_none;Firmicutes;Bacilli;Bacillales;Bacillaceae;Bacillus;Bacillus aeolius	1	0	0	1	0	0	0	1	3
Bacteria;Bacteria_none;Proteobacteria;Alphaproteobacteria;Caulobacterales;Caulobacteraceae;Phenylobacterium;Phenylobacterium muchangponense	0	0	0	3	0	0	0	0	3
Bacteria;Bacteria_none;Firmicutes;Bacilli;Bacillales;Thermoactinomycetaceae;Planifilum;Planifilum fulgidum	0	0	3	0	0	0	0	0	3
Bacteria;Bacteria_none;Proteobacteria;Betaproteobacteria;Burkholderiales;Burkholderiaceae;Robbsia;Robbsia andropogonis	2	1	0	0	0	0	0	0	3
Bacteria;Bacteria_none;Deinococcus-Thermus;Deinococci;Deinococcales;Deinococcaceae;Deinococcus;Deinococcus radiopugnans	3	0	0	0	0	0	0	0	3
Bacteria;Bacteria_none;Proteobacteria;Gammaproteobacteria;Moraxellales;Moraxellaceae;Acinetobacter;Acinetobacter variabilis	1	0	0	1	0	0	1	0	3
Bacteria;Bacteria_none;Cyanobacteria;Cyanobacteria_Incertae_sedis;Pseudanabaenales;Leptolyngbyaceae;Euryhalinema;Euryhalinema epiphyticum	0	1	2	0	0	0	0	0	3
Bacteria;Bacteria_none;Proteobacteria;Gammaproteobacteria;Thiotrichales;Fastidiosibacteraceae;Facilibium;Facilibium subflavum	2	0	0	0	0	1	0	0	3
Bacteria;Bacteria_none;Proteobacteria;Betaproteobacteria;Burkholderiales;Alcaligenaceae;Alcaligenes;Alcaligenes ammonioxydans	0	0	0	0	0	3	0	0	3
Bacteria;Bacteria_none;Actinobacteria;Actinomycetia;Micromonosporales;Micromonosporaceae;Actinoplanes;Actinoplanes derwentensis	0	3	0	0	0	0	0	0	3
Bacteria;Bacteria_none;Firmicutes;Bacilli;Bacillales;Bacillaceae;Bacillus;Bacillus velezensis	0	0	0	3	0	0	0	0	3
Bacteria;Bacteria_none;Proteobacteria;Betaproteobacteria;Neisseriales;Neisseriaceae;Crenobacter;Crenobacter cavernae	1	0	0	1	0	0	0	1	3
Bacteria;Bacteria_none;Firmicutes;Clostridia;Eubacteriales;Clostridiaceae;Clostridium;Clostridium pascui	0	0	1	1	0	1	0	0	3
Bacteria;Bacteria_none;Proteobacteria;Gammaproteobacteria;Pseudomonadales;Pseudomonadaceae;Pseudomonas;Pseudomonas oryzihabitans	0	0	0	3	0	0	0	0	3
Bacteria;Bacteria_none;Firmicutes;Negativicutes;Selenomonadales;Sporomusaceae;Sporomusa;Sporomusa malonica	2	0	0	0	0	1	0	0	3
Bacteria;Bacteria_none;Bacteroidota;Bacteroidota_Incertae_sedis;Bacteroidetes Order II. Incertae sedis;Rhodothermaceae;Rhodothermus;Rhodothermus bifroesti	0	0	2	0	1	0	0	0	3
Bacteria;Bacteria_none;Firmicutes;Bacilli;Bacillales;Bacillaceae;Bacillus;Bacillus mesophilus	0	1	0	2	0	0	0	0	3
Bacteria;Bacteria_none;Cyanobacteria;Cyanobacteria_Incertae_sedis;Pseudanabaenales;Prochlorotrichaceae;Nodosilinea;Nodosilinea conica	0	0	1	0	0	0	1	1	3
Bacteria;Bacteria_none;Firmicutes;Bacilli;Lactobacillales;Aerococcaceae;Abiotrophia;Abiotrophia defectiva	3	0	0	0	0	0	0	0	3
Bacteria;Bacteria_none;Proteobacteria;Betaproteobacteria;Burkholderiales;Sphaerotilaceae;Azohydromonas;Azohydromonas caseinilytica	3	0	0	0	0	0	0	0	3
Bacteria;Bacteria_none;Proteobacteria;Betaproteobacteria;Burkholderiales;Burkholderiaceae;Paraburkholderia;Paraburkholderia lacunae	0	0	0	0	0	3	0	0	3
Bacteria;Bacteria_none;Proteobacteria;Betaproteobacteria;Burkholderiales;Burkholderiaceae;Pandoraea;Pandoraea apista	0	0	3	0	0	0	0	0	3
Bacteria;Bacteria_none;Actinobacteria;Actinomycetia;Corynebacteriales;Mycobacteriaceae;Mycobacterium;Mycobacterium fragae	1	0	1	1	0	0	0	0	3
Bacteria;Bacteria_none;Firmicutes;Bacilli;Lactobacillales;Aerococcaceae;Aerococcus;Aerococcus christensenii	1	0	1	0	1	0	0	0	3
Bacteria;Bacteria_none;Firmicutes;Bacilli;Lactobacillales;Enterococcaceae;Enterococcus;Enterococcus diestrammenae	3	0	0	0	0	0	0	0	3
Bacteria;Bacteria_none;Proteobacteria;Betaproteobacteria;Burkholderiales;Sphaerotilaceae;Rubrivivax;Rubrivivax benzoatilyticus	3	0	0	0	0	0	0	0	3
Bacteria;Bacteria_none;Proteobacteria;Gammaproteobacteria;Pseudomonadales;Pseudomonadaceae;Pseudomonas;Pseudomonas humi	2	0	0	0	1	0	0	0	3
Bacteria;Bacteria_none;Proteobacteria;Gammaproteobacteria;Pseudomonadales;Pseudomonadaceae;Pseudomonas;Pseudomonas guangdongensis	1	0	0	0	0	2	0	0	3
Bacteria;Bacteria_none;Proteobacteria;Betaproteobacteria;Burkholderiales;Burkholderiaceae;Cupriavidus;Cupriavidus nantongensis	0	1	1	0	0	1	0	0	3
Bacteria;Bacteria_none;Firmicutes;Bacilli;Bacillales;Bacillaceae;Bacillus;Bacillus siamensis	0	0	3	0	0	0	0	0	3
Bacteria;Bacteria_none;Deinococcus-Thermus;Deinococci;Deinococcales;Deinococcaceae;Deinococcus;Deinococcus geothermalis	0	0	3	0	0	0	0	0	3
Bacteria;Bacteria_none;Firmicutes;Bacilli;Lactobacillales;Enterococcaceae;Enterococcus;Enterococcus hirae	0	0	3	0	0	0	0	0	3
Bacteria;Bacteria_none;Proteobacteria;Betaproteobacteria;Burkholderiales;Burkholderiaceae;Paraburkholderia;Paraburkholderia solisilvae	2	0	0	0	0	0	1	0	3
Bacteria;Bacteria_none;Proteobacteria;Alphaproteobacteria;Caulobacterales;Caulobacteraceae;Brevundimonas;Brevundimonas bullata	0	0	0	0	0	3	0	0	3
Bacteria;Bacteria_none;Bacteroidota;Chitinophagia;Chitinophagales;Chitinophagaceae;Chitinophaga;Chitinophaga sedimenti	2	1	0	0	0	0	0	0	3
Bacteria;Bacteria_none;Firmicutes;Bacilli;Bacillales;Bacillaceae;Bacillus;Bacillus tianmuensis	0	1	0	0	0	1	1	0	3
Bacteria;Bacteria_none;Proteobacteria;Betaproteobacteria;Burkholderiales;Burkholderiaceae;Paraburkholderia;Paraburkholderia rhizosphaerae	1	1	0	0	0	0	1	0	3
Bacteria;Bacteria_none;Firmicutes;Negativicutes;Selenomonadales;Sporomusaceae;Sporomusa;Sporomusa termitida	0	0	1	1	0	0	1	0	3
Bacteria;Bacteria_none;Bacteroidota;Chitinophagia;Chitinophagales;Chitinophagaceae;Chitinophaga;Chitinophaga sancti	2	1	0	0	0	0	0	0	3
Bacteria;Bacteria_none;Proteobacteria;Betaproteobacteria;Burkholderiales;Burkholderiaceae;Burkholderia;Burkholderia gladioli	3	0	0	0	0	0	0	0	3
Bacteria;Bacteria_none;Proteobacteria;Alphaproteobacteria;Caulobacterales;Caulobacteraceae;Asticcacaulis;Asticcacaulis taihuensis	0	1	2	0	0	0	0	0	3
Bacteria;Bacteria_none;Firmicutes;Bacilli;Bacillales;Bacillaceae;Bacillus;Bacillus thermotolerans	0	0	0	1	2	0	0	0	3
Bacteria;Bacteria_none;Firmicutes;Negativicutes;Acidaminococcales;Acidaminococcaceae;Acidaminococcus;Acidaminococcus fermentans	2	0	1	0	0	0	0	0	3
Bacteria;Bacteria_none;Firmicutes;Bacilli;Lactobacillales;Enterococcaceae;Enterococcus;Enterococcus lactis	3	0	0	0	0	0	0	0	3
Bacteria;Bacteria_none;Firmicutes;Bacilli;Lactobacillales;Enterococcaceae;Enterococcus;Enterococcus alishanensis	0	0	1	0	1	1	0	0	3
Bacteria;Bacteria_none;Bacteroidota;Chitinophagia;Chitinophagales;Chitinophagaceae;Chitinophaga;Chitinophaga caeni	1	0	1	0	0	0	1	0	3
Bacteria;Bacteria_none;Actinobacteria;Actinomycetia;Corynebacteriales;Mycobacteriaceae;Mycobacterium;Mycobacterium paragordonae	0	0	0	0	3	0	0	0	3
Bacteria;Bacteria_none;Proteobacteria;Gammaproteobacteria;Thiotrichales;Piscirickettsiaceae;Piscirickettsia;Piscirickettsia salmonis	1	0	0	2	0	0	0	0	3
Bacteria;Bacteria_none;Actinobacteria;Coriobacteriia;Coriobacteriales;Atopobiaceae;Atopobium;Atopobium fossor	0	0	2	1	0	0	0	0	3
Bacteria;Bacteria_none;Firmicutes;Clostridia;Eubacteriales;Vallitaleaceae;Vallitalea;Vallitalea pronyensis	1	1	0	1	0	0	0	0	3
Bacteria;Bacteria_none;Firmicutes;Clostridia;Halanaerobiales;Halobacteroidaceae;Selenihalanaerobacter;Selenihalanaerobacter shriftii	0	0	2	0	0	1	0	0	3
Bacteria;Bacteria_none;Proteobacteria;Alphaproteobacteria;Sphingomonadales;Sphingomonadaceae;Rhizorhabdus;Rhizorhabdus phycosphaerae	0	3	0	0	0	0	0	0	3
Bacteria;Bacteria_none;Proteobacteria;Deltaproteobacteria;Desulfobacterales;Desulfobacteraceae;Desulfamplus;Desulfamplus magnetovallimortis	2	1	0	0	0	0	0	0	3
Bacteria;Bacteria_none;Actinobacteria;Actinomycetia;Corynebacteriales;Mycobacteriaceae;Mycobacterium;Mycobacterium botniense	1	2	0	0	0	0	0	0	3
Bacteria;Bacteria_none;Proteobacteria;Alphaproteobacteria;Sphingomonadales;Sphingomonadaceae;Sphingobium;Sphingobium cupriresistens	1	0	1	1	0	0	0	0	3
Bacteria;Bacteria_none;Proteobacteria;Deltaproteobacteria;Bradymonadales;Bradymonadaceae;Persicimonas;Persicimonas caeni	0	2	1	0	0	0	0	0	3
Bacteria;Bacteria_none;Proteobacteria;Alphaproteobacteria;Sphingomonadales;Sphingomonadaceae;Sphingobium;Sphingobium indicum	0	1	0	0	0	1	0	1	3
Bacteria;Bacteria_none;Actinobacteria;Actinomycetia;Streptosporangiales;Streptosporangiaceae;Streptosporangium;Streptosporangium nanhuense	1	1	1	0	0	0	0	0	3
Bacteria;Bacteria_none;Actinobacteria;Actinomycetia;Micromonosporales;Micromonosporaceae;Dactylosporangium;Dactylosporangium roseum	0	1	1	1	0	0	0	0	3
Bacteria;Bacteria_none;Proteobacteria;Gammaproteobacteria;Thiotrichales;Thiotrichaceae;Thiothrix;Thiothrix caldifontis	1	1	1	0	0	0	0	0	3
Bacteria;Bacteria_none;Firmicutes;Clostridia;Natranaerobiales;Natranaerobiaceae;Natranaerobius;Natranaerobius thermophilus	0	0	2	0	0	1	0	0	3
Bacteria;Bacteria_none;Nitrospirae;Thermodesulfovibrionia;Thermodesulfovibrionales;Thermodesulfovibrionaceae;Thermodesulfovibrio;Thermodesulfovibrio hydrogeniphilus	0	1	2	0	0	0	0	0	3
Bacteria;Bacteria_none;Actinobacteria;Actinomycetia;Streptosporangiales;Streptosporangiaceae;Streptosporangium;Streptosporangium nondiastaticum	0	0	1	0	0	2	0	0	3
Bacteria;Bacteria_none;Proteobacteria;Alphaproteobacteria;Sphingomonadales;Sphingomonadaceae;Sphingobium;Sphingobium yanoikuyae	0	0	0	2	0	0	1	0	3
Bacteria;Bacteria_none;Actinobacteria;Actinomycetia;Corynebacteriales;Mycobacteriaceae;Mycobacterium;Mycobacterium xenopi	0	1	1	0	0	1	0	0	3
Bacteria;Bacteria_none;Firmicutes;Clostridia;Thermoanaerobacterales;Thermoanaerobacteraceae;Carboxydothermus;Carboxydothermus hydrogenoformans	0	3	0	0	0	0	0	0	3
Bacteria;Bacteria_none;Proteobacteria;Gammaproteobacteria;Pseudomonadales;Marinobacteraceae;Marinobacter;Marinobacter fonticola	3	0	0	0	0	0	0	0	3
Bacteria;Bacteria_none;Cyanobacteria;Cyanobacteria_Incertae_sedis;Oscillatoriales;Microcoleaceae;Baaleninema;Baaleninema simplex	1	0	1	1	0	0	0	0	3
Bacteria;Bacteria_none;Proteobacteria;Gammaproteobacteria;Xanthomonadales;Rhodanobacteraceae;Dyella;Dyella psychrodurans	1	2	0	0	0	0	0	0	3
Bacteria;Bacteria_none;Cyanobacteria;Cyanobacteria_Incertae_sedis;Oscillatoriales;Cyanothecaceae;Cyanothece;Cyanothece svehlovae	0	1	1	1	0	0	0	0	3
Bacteria;Bacteria_none;Fibrobacteres;Chitinivibrionia;Chitinivibrionales;Chitinivibrionaceae;Chitinivibrio;Chitinivibrio alkaliphilus	0	0	3	0	0	0	0	0	3
Bacteria;Bacteria_none;Firmicutes;Bacilli;Lactobacillales;Aerococcaceae;Eremococcus;Eremococcus coleocola	0	0	0	2	0	1	0	0	3
Bacteria;Bacteria_none;Proteobacteria;Gammaproteobacteria;Xanthomonadales;Rhodanobacteraceae;Rhodanobacter;Rhodanobacter lindaniclasticus	3	0	0	0	0	0	0	0	3
Bacteria;Bacteria_none;Proteobacteria;Gammaproteobacteria;Moraxellales;Moraxellaceae;Acinetobacter;Acinetobacter equi	0	0	3	0	0	0	0	0	3
Bacteria;Bacteria_none;Proteobacteria;Gammaproteobacteria;Xanthomonadales;Rhodanobacteraceae;Oleiagrimonas;Oleiagrimonas soli	3	0	0	0	0	0	0	0	3
Bacteria;Bacteria_none;Firmicutes;Bacilli;Lactobacillales;Lactobacillaceae;Companilactobacillus;Companilactobacillus ginsenosidimutans	3	0	0	0	0	0	0	0	3
Bacteria;Bacteria_none;Proteobacteria;Alphaproteobacteria;Sphingomonadales;Sphingomonadaceae;Novosphingobium;Novosphingobium ipomoeae	1	0	1	0	1	0	0	0	3
Bacteria;Bacteria_none;Proteobacteria;Alphaproteobacteria;Sphingomonadales;Sphingomonadaceae;Novosphingobium;Novosphingobium lentum	1	0	1	0	0	0	0	1	3
Bacteria;Bacteria_none;Bacteroidota;Bacteroidia;Marinilabiliales;Marinilabiliaceae;Marinilabilia;Marinilabilia rubra	0	1	0	2	0	0	0	0	3
Bacteria;Bacteria_none;Firmicutes;Bacilli;Bacillales;Bacillaceae;Lederbergia;Lederbergia lenta	0	0	3	0	0	0	0	0	3
Bacteria;Bacteria_none;Firmicutes;Bacilli;Bacillales;Bacillaceae;Halolactibacillus;Halolactibacillus miurensis	1	0	1	0	0	1	0	0	3
Bacteria;Bacteria_none;Actinobacteria;Actinomycetia;Micrococcales;Microbacteriaceae;Huakuichenia;Huakuichenia soli	0	0	1	2	0	0	0	0	3
Bacteria;Bacteria_none;Proteobacteria;Deltaproteobacteria;Desulfobacterales;Desulfobacteraceae;Desulfobacter;Desulfobacter halotolerans	0	3	0	0	0	0	0	0	3
Bacteria;Bacteria_none;Actinobacteria;Actinomycetia;Streptosporangiales;Streptosporangiaceae;Sphaerisporangium;Sphaerisporangium album	0	1	0	2	0	0	0	0	3
Bacteria;Bacteria_none;Bacteroidota;Bacteroidia;Bacteroidales;Bacteroidaceae;Bacteroides;Bacteroides caecigallinarum	1	0	1	1	0	0	0	0	3
Bacteria;Bacteria_none;Firmicutes;Clostridia;Halanaerobiales;Halobacteroidaceae;Halanaerobacter;Halanaerobacter chitinivorans	0	0	0	3	0	0	0	0	3
Bacteria;Bacteria_none;Firmicutes;Bacilli;Bacillales;Bacillaceae;Anoxybacillus;Anoxybacillus mongoliensis	0	0	3	0	0	0	0	0	3
Bacteria;Bacteria_none;Firmicutes;Bacilli;Bacillales;Staphylococcaceae;Staphylococcus;Staphylococcus caprae	3	0	0	0	0	0	0	0	3
Bacteria;Bacteria_none;Firmicutes;Bacilli;Bacillales;Bacillaceae;Gracilibacillus;Gracilibacillus kimchii	0	0	3	0	0	0	0	0	3
Bacteria;Bacteria_none;Actinobacteria;Actinomycetia;Streptosporangiales;Thermomonosporaceae;Actinomadura;Actinomadura hallensis	0	0	1	2	0	0	0	0	3
Bacteria;Bacteria_none;Firmicutes;Clostridia;Thermoanaerobacterales;Thermoanaerobacteraceae;Thermodesulfitimonas;Thermodesulfitimonas autotrophica	1	0	1	1	0	0	0	0	3
Bacteria;Bacteria_none;Bacteroidota;Chitinophagia;Chitinophagales;Chitinophagaceae;Lacibacter;Lacibacter luteus	3	0	0	0	0	0	0	0	3
Bacteria;Bacteria_none;Proteobacteria;Gammaproteobacteria;Vibrionales;Vibrionaceae;Salinivibrio;Salinivibrio proteolyticus	0	0	2	0	1	0	0	0	3
Bacteria;Bacteria_none;Actinobacteria;Actinomycetia;Streptosporangiales;Thermomonosporaceae;Actinomadura;Actinomadura macra	0	3	0	0	0	0	0	0	3
Bacteria;Bacteria_none;Proteobacteria;Alphaproteobacteria;Sphingomonadales;Sphingomonadaceae;Sphingomonas;Sphingomonas mucosissima	1	0	0	2	0	0	0	0	3
Bacteria;Bacteria_none;Bacteroidota;Bacteroidia;Bacteroidales;Rikenellaceae;Tidjanibacter;Tidjanibacter massiliensis	0	0	0	0	3	0	0	0	3
Bacteria;Bacteria_none;Proteobacteria;Alphaproteobacteria;Sphingomonadales;Sphingomonadaceae;Sphingomonas;Sphingomonas palustris	2	0	0	1	0	0	0	0	3
Bacteria;Bacteria_none;Proteobacteria;Alphaproteobacteria;Hyphomicrobiales;Aurantimonadaceae;Aureimonas;Aureimonas fodinaquatilis	0	0	0	3	0	0	0	0	3
Bacteria;Bacteria_none;Proteobacteria;Alphaproteobacteria;Sphingomonadales;Sphingomonadaceae;Sphingomonas;Sphingomonas panacisoli	1	2	0	0	0	0	0	0	3
Bacteria;Bacteria_none;Proteobacteria;Betaproteobacteria;Burkholderiales;Burkholderiales_Incertae_sedis;Aquariibacter;Aquariibacter albus	3	0	0	0	0	0	0	0	3
Bacteria;Bacteria_none;Actinobacteria;Actinomycetia;Streptosporangiales;Thermomonosporaceae;Actinomadura;Actinomadura rudentiformis	0	3	0	0	0	0	0	0	3
Bacteria;Bacteria_none;Proteobacteria;Betaproteobacteria;Burkholderiales;Burkholderiales_Incertae_sedis;Aquabacterium;Aquabacterium parvum	3	0	0	0	0	0	0	0	3
Bacteria;Bacteria_none;Actinobacteria;Actinomycetia;Micrococcales;Ruaniaceae;Ruania;Ruania zhangjianzhongii	1	2	0	0	0	0	0	0	3
Bacteria;Bacteria_none;Bacteroidota;Bacteroidia;Bacteroidales;Tannerellaceae;Parabacteroides;Parabacteroides acidifaciens	0	0	0	3	0	0	0	0	3
Bacteria;Bacteria_none;Actinobacteria;Actinomycetia;Propionibacteriales;Kribbellaceae;Kribbella;Kribbella jiaozuonensis	0	2	0	1	0	0	0	0	3
Bacteria;Bacteria_none;Proteobacteria;Alphaproteobacteria;Rhodospirillales;Acetobacteraceae;Roseomonas;Roseomonas chloroacetimidivorans	1	1	1	0	0	0	0	0	3
Bacteria;Bacteria_none;Proteobacteria;Gammaproteobacteria;Vibrionales;Vibrionaceae;Vibrio;Vibrio celticus	1	2	0	0	0	0	0	0	3
Bacteria;Bacteria_none;Actinobacteria;Actinomycetia;Micrococcales;Microbacteriaceae;Gulosibacter;Gulosibacter bifidus	0	1	1	1	0	0	0	0	3
Bacteria;Bacteria_none;Proteobacteria;Alphaproteobacteria;Sphingomonadales;Sphingomonadaceae;Sphingomonas;Sphingomonas guangdongensis	0	2	1	0	0	0	0	0	3
Bacteria;Bacteria_none;Firmicutes;Bacilli;Bacillales;Staphylococcaceae;Staphylococcus;Staphylococcus casei	0	0	3	0	0	0	0	0	3
Bacteria;Bacteria_none;Firmicutes;Bacilli;Bacillales;Bacillaceae;Anoxybacillus;Anoxybacillus rupiensis	0	0	0	0	0	3	0	0	3
Bacteria;Bacteria_none;Firmicutes;Bacilli;Bacillales;Bacillaceae;Anoxybacillus;Anoxybacillus salavatliensis	0	1	0	0	0	0	2	0	3
Bacteria;Bacteria_none;Proteobacteria;Gammaproteobacteria;Vibrionales;Vibrionaceae;Vibrio;Vibrio splendidus	2	1	0	0	0	0	0	0	3
Bacteria;Bacteria_none;Proteobacteria;Gammaproteobacteria;Pseudomonadales;Pseudomonadaceae;Atopomonas;Atopomonas hussainii	2	1	0	0	0	0	0	0	3
Bacteria;Bacteria_none;Proteobacteria;Alphaproteobacteria;Sphingomonadales;Sphingomonadaceae;Sphingomonas;Sphingomonas colocasiae	0	0	0	3	0	0	0	0	3
Bacteria;Bacteria_none;Proteobacteria;Alphaproteobacteria;Sphingomonadales;Sphingomonadaceae;Sphingomonas;Sphingomonas crocodyli	2	0	0	1	0	0	0	0	3
Bacteria;Bacteria_none;Proteobacteria;Alphaproteobacteria;Sphingomonadales;Sphingomonadaceae;Sphingomonas;Sphingomonas cynarae	3	0	0	0	0	0	0	0	3
Bacteria;Bacteria_none;Deinococcus-Thermus;Deinococci;Thermales;Thermaceae;Thermus;Thermus filiformis	0	0	0	3	0	0	0	0	3
Bacteria;Bacteria_none;Firmicutes;Bacilli;Lactobacillales;Lactobacillaceae;Agrilactobacillus;Agrilactobacillus composti	2	1	0	0	0	0	0	0	3
Bacteria;Bacteria_none;Firmicutes;Bacilli;Lactobacillales;Carnobacteriaceae;Dolosigranulum;Dolosigranulum pigrum	0	2	1	0	0	0	0	0	3
Bacteria;Bacteria_none;Proteobacteria;Alphaproteobacteria;Sphingomonadales;Sphingomonadaceae;Sphingomonas;Sphingomonas endophytica	0	3	0	0	0	0	0	0	3
Bacteria;Bacteria_none;Proteobacteria;Gammaproteobacteria;Pseudomonadales;Pseudomonadaceae;Entomomonas;Entomomonas asaccharolytica	0	3	0	0	0	0	0	0	3
Bacteria;Bacteria_none;Cyanobacteria;Cyanobacteria_Incertae_sedis;Oscillatoriales;Oscillatoriaceae;Okeania;Okeania hirsuta	0	0	3	0	0	0	0	0	3
Bacteria;Bacteria_none;Actinobacteria;Actinomycetia;Actinomycetales;Actinomycetaceae;Actinomyces;Actinomyces israelii	2	0	0	0	1	0	0	0	3
Bacteria;Bacteria_none;Firmicutes;Bacilli;Bacillales;Bacillaceae;Oceanobacillus;Oceanobacillus locisalsi	0	0	3	0	0	0	0	0	3
Bacteria;Bacteria_none;Proteobacteria;Gammaproteobacteria;Enterobacterales;Enterobacteriaceae;Shigella;Shigella dysenteriae	3	0	0	0	0	0	0	0	3
Bacteria;Bacteria_none;Firmicutes;Bacilli;Bacillales;Paenibacillaceae;Paenibacillus;Paenibacillus tumbae	0	3	0	0	0	0	0	0	3
Bacteria;Bacteria_none;Bacteroidota;Flavobacteriia;Flavobacteriales;Weeksellaceae;Chryseobacterium;Chryseobacterium taichungense	1	0	0	2	0	0	0	0	3
Bacteria;Bacteria_none;Proteobacteria;Alphaproteobacteria;Hyphomicrobiales;Tepidamorphaceae;Microbaculum;Microbaculum marinum	0	1	1	1	0	0	0	0	3
Bacteria;Bacteria_none;Proteobacteria;Alphaproteobacteria;Hyphomicrobiales;Propylenellaceae;Propylenella;Propylenella binzhouense	2	0	0	1	0	0	0	0	3
Bacteria;Bacteria_none;Bacteroidota;Cytophagia;Cytophagales;Spirosomaceae;Larkinella;Larkinella rosea	2	0	1	0	0	0	0	0	3
Bacteria;Bacteria_none;Bacteroidota;Flavobacteriia;Flavobacteriales;Weeksellaceae;Cloacibacterium;Cloacibacterium caeni	0	0	3	0	0	0	0	0	3
Bacteria;Bacteria_none;Verrucomicrobia;Opitutae;Opitutales;Opitutaceae;Geminisphaera;Geminisphaera colitermitum	0	2	1	0	0	0	0	0	3
Bacteria;Bacteria_none;Proteobacteria;Gammaproteobacteria;Alteromonadales;Colwelliaceae;Thalassotalea;Thalassotalea algicola	0	2	0	1	0	0	0	0	3
Bacteria;Bacteria_none;Proteobacteria;Gammaproteobacteria;Enterobacterales;Enterobacteriaceae;Edaphovirga;Edaphovirga cremea	3	0	0	0	0	0	0	0	3
Bacteria;Bacteria_none;Actinobacteria;Actinomycetia;Propionibacteriales;Propionibacteriaceae;Aestuariimicrobium;Aestuariimicrobium kwangyangense	1	1	0	1	0	0	0	0	3
Bacteria;Bacteria_none;Actinobacteria;Actinomycetia;Kineosporiales;Kineosporiaceae;Kineosporia;Kineosporia aurantiaca	1	0	0	2	0	0	0	0	3
Bacteria;Bacteria_none;Bacteroidota;Sphingobacteriia;Sphingobacteriales;Sphingobacteriaceae;Pedobacter;Pedobacter xixiisoli	0	1	2	0	0	0	0	0	3
Bacteria;Bacteria_none;Firmicutes;Bacilli;Bacillales;Planococcaceae;Kurthia;Kurthia zopfii	0	0	0	2	0	0	0	1	3
Bacteria;Bacteria_none;Spirochaetes;Spirochaetia;Spirochaetales;Treponemataceae;Treponema;Treponema brennaborense	0	0	0	0	0	3	0	0	3
Bacteria;Bacteria_none;Firmicutes;Bacilli;Lactobacillales;Streptococcaceae;Streptococcus;Streptococcus hillyeri	2	1	0	0	0	0	0	0	3
Bacteria;Bacteria_none;Actinobacteria;Acidimicrobiia;Acidimicrobiales;Acidimicrobiaceae;Acidimicrobium;Acidimicrobium ferrooxidans	0	0	1	2	0	0	0	0	3
Bacteria;Bacteria_none;Bacteroidota;Cytophagia;Cytophagales;Spirosomaceae;Runella;Runella slithyformis	3	0	0	0	0	0	0	0	3
Bacteria;Bacteria_none;Firmicutes;Bacilli;Bacillales;Paenibacillaceae;Paenibacillus;Paenibacillus ginsengihumi	0	1	0	1	0	0	1	0	3
Bacteria;Bacteria_none;Firmicutes;Bacilli;Bacillales;Paenibacillaceae;Paenibacillus;Paenibacillus gelatinilyticus	0	0	0	1	0	2	0	0	3
Bacteria;Bacteria_none;Proteobacteria;Gammaproteobacteria;Enterobacterales;Thorselliaceae;Thorsellia;Thorsellia anophelis	2	0	1	0	0	0	0	0	3
Bacteria;Bacteria_none;Proteobacteria;Gammaproteobacteria;Enterobacterales;Thorselliaceae;Coetzeea;Coetzeea brasiliensis	1	0	0	1	0	1	0	0	3
Bacteria;Bacteria_none;Bacteroidota;Flavobacteriia;Flavobacteriales;Flavobacteriaceae;Maribacter;Maribacter orientalis	0	0	0	0	3	0	0	0	3
Bacteria;Bacteria_none;Bacteroidota;Cytophagia;Cytophagales;Thermoflexibacteraceae;Thermoflexibacter;Thermoflexibacter ruber	0	0	1	0	1	1	0	0	3
Bacteria;Bacteria_none;Proteobacteria;Alphaproteobacteria;Hyphomicrobiales;Parvibaculaceae;Rhodoligotrophos;Rhodoligotrophos defluvii	2	1	0	0	0	0	0	0	3
Bacteria;Bacteria_none;Bacteroidota;Flavobacteriia;Flavobacteriales;Crocinitomicaceae;Brumimicrobium;Brumimicrobium glaciale	0	0	0	1	0	0	2	0	3
Bacteria;Bacteria_none;Firmicutes;Bacilli;Lactobacillales;Lactobacillaceae;Loigolactobacillus;Loigolactobacillus coryniformis	0	0	0	2	0	0	1	0	3
Bacteria;Bacteria_none;Proteobacteria;Alphaproteobacteria;Hyphomicrobiales;Xanthobacteraceae;Xanthobacter;Xanthobacter viscosus	0	1	1	1	0	0	0	0	3
Bacteria;Bacteria_none;Proteobacteria;Gammaproteobacteria;Alteromonadales;Psychromonadaceae;Psychromonas;Psychromonas hadalis	3	0	0	0	0	0	0	0	3
Bacteria;Bacteria_none;Bacteroidota;Flavobacteriia;Flavobacteriales;Cryomorphaceae;Cryomorpha;Cryomorpha ignava	2	0	0	1	0	0	0	0	3
Bacteria;Bacteria_none;Firmicutes;Bacilli;Lactobacillales;Lactobacillaceae;Leuconostoc;Leuconostoc pseudomesenteroides	3	0	0	0	0	0	0	0	3
Bacteria;Bacteria_none;Firmicutes;Bacilli;Lactobacillales;Streptococcaceae;Streptococcus;Streptococcus sinensis	2	0	0	1	0	0	0	0	3
Bacteria;Bacteria_none;Proteobacteria;Gammaproteobacteria;Alteromonadales;Alteromonadaceae;Alteromonas;Alteromonas lipolytica	2	0	0	0	1	0	0	0	3
Bacteria;Bacteria_none;Proteobacteria;Gammaproteobacteria;Enterobacterales;Enterobacteriaceae;Enterobacter;Enterobacter bugandensis	2	0	1	0	0	0	0	0	3
Bacteria;Bacteria_none;Thermotogae;Thermotogae;Mesoaciditogales;Mesoaciditogaceae;Athalassotoga;Athalassotoga saccharophila	0	1	1	0	0	1	0	0	3
Bacteria;Bacteria_none;Spirochaetes;Spirochaetia;Spirochaetales;Spirochaetaceae;Spirochaeta;Spirochaeta africana	0	1	2	0	0	0	0	0	3
Bacteria;Bacteria_none;Proteobacteria;Gammaproteobacteria;Enterobacterales;Enterobacteriaceae;Franconibacter;Franconibacter pulveris	3	0	0	0	0	0	0	0	3
Bacteria;Bacteria_none;Firmicutes;Bacilli;Bacillales;Bacillaceae;Siminovitchia;Siminovitchia fordii	0	0	1	0	0	2	0	0	3
Bacteria;Bacteria_none;Actinobacteria;Actinomycetia;Streptomycetales;Streptomycetaceae;Streptomyces;Streptomyces europaeiscabiei	0	0	0	2	0	1	0	0	3
Bacteria;Bacteria_none;Actinobacteria;Actinomycetia;Micrococcales;Microbacteriaceae;Pseudoclavibacter;Pseudoclavibacter soli	0	1	0	2	0	0	0	0	3
Bacteria;Bacteria_none;Actinobacteria;Actinomycetia;Streptomycetales;Streptomycetaceae;Streptomyces;Streptomyces ehimensis	0	0	1	2	0	0	0	0	3
Bacteria;Bacteria_none;Proteobacteria;Gammaproteobacteria;Enterobacterales;Yersiniaceae;Yersinia;Yersinia frederiksenii	3	0	0	0	0	0	0	0	3
Bacteria;Bacteria_none;Firmicutes;Bacilli;Lactobacillales;Lactobacillaceae;Pediococcus;Pediococcus damnosus	0	0	2	1	0	0	0	0	3
Bacteria;Bacteria_none;Firmicutes;Bacilli;Bacillales;Bacillaceae;Siminovitchia;Siminovitchia sediminis	0	2	1	0	0	0	0	0	3
Bacteria;Bacteria_none;Bacteroidota;Cytophagia;Cytophagales;Spirosomaceae;Arsenicibacter;Arsenicibacter rosenii	0	0	1	1	0	0	0	1	3
Bacteria;Bacteria_none;Proteobacteria;Gammaproteobacteria;Enterobacterales;Enterobacteriaceae;Escherichia;Escherichia coli	3	0	0	0	0	0	0	0	3
Bacteria;Bacteria_none;Proteobacteria;Gammaproteobacteria;Aeromonadales;Aeromonadaceae;Aeromonas;Aeromonas sanarellii	0	0	0	0	0	3	0	0	3
Bacteria;Bacteria_none;Bacteroidota;Cytophagia;Cytophagales;Spirosomaceae;Dyadobacter;Dyadobacter hamtensis	1	1	0	0	1	0	0	0	3
Bacteria;Bacteria_none;Proteobacteria;Alphaproteobacteria;Hyphomicrobiales;Salinarimonadaceae;Salinarimonas;Salinarimonas soli	2	0	0	1	0	0	0	0	3
Bacteria;Bacteria_none;Proteobacteria;Gammaproteobacteria;Enterobacterales;Yersiniaceae;Yersinia;Yersinia alsatica	0	0	0	3	0	0	0	0	3
Bacteria;Bacteria_none;Bacteroidota;Cytophagia;Cytophagales;Spirosomaceae;Emticicia;Emticicia sediminis	0	1	0	1	1	0	0	0	3
Bacteria;Bacteria_none;Proteobacteria;Alphaproteobacteria;Hyphomicrobiales;Stappiaceae;Pannonibacter;Pannonibacter phragmitetus	0	0	2	1	0	0	0	0	3
Bacteria;Bacteria_none;Bacteroidota;Flavobacteriia;Flavobacteriales;Flavobacteriaceae;Nonlabens;Nonlabens spongiae	0	0	0	1	0	0	0	2	3
Bacteria;Bacteria_none;Actinobacteria;Actinomycetia;Propionibacteriales;Nocardioidaceae;Nocardioides;Nocardioides szechwanensis	0	2	1	0	0	0	0	0	3
Bacteria;Bacteria_none;Spirochaetes;Spirochaetia;Spirochaetales;Spirochaetaceae;Bullifex;Bullifex porci	0	3	0	0	0	0	0	0	3
Bacteria;Bacteria_none;Actinobacteria;Actinomycetia;Streptomycetales;Streptomycetaceae;Streptomyces;Streptomyces corchorusii	0	1	0	1	0	1	0	0	3
Bacteria;Bacteria_none;Firmicutes;Bacilli;Bacillales;Bacillaceae;Virgibacillus;Virgibacillus carmonensis	0	3	0	0	0	0	0	0	3
Bacteria;Bacteria_none;Actinobacteria;Actinomycetia;Geodermatophilales;Geodermatophilaceae;Geodermatophilus;Geodermatophilus dictyosporus	0	1	1	0	0	1	0	0	3
Bacteria;Bacteria_none;Proteobacteria;Gammaproteobacteria;Aeromonadales;Succinivibrionaceae;Anaerobiospirillum;Anaerobiospirillum thomasii	0	0	2	0	1	0	0	0	3
Bacteria;Bacteria_none;Actinobacteria;Actinomycetia;Geodermatophilales;Geodermatophilaceae;Modestobacter;Modestobacter lacusdianchii	0	2	1	0	0	0	0	0	3
Bacteria;Bacteria_none;Firmicutes;Bacilli;Lactobacillales;Lactobacillaceae;Paucilactobacillus;Paucilactobacillus vaccinostercus	1	2	0	0	0	0	0	0	3
Bacteria;Bacteria_none;Proteobacteria;Gammaproteobacteria;Alteromonadales;Alteromonadaceae;Aliagarivorans;Aliagarivorans taiwanensis	2	0	0	0	1	0	0	0	3
Bacteria;Bacteria_none;Bacteroidota;Flavobacteriia;Flavobacteriales;Flavobacteriaceae;Myroides;Myroides profundi	0	3	0	0	0	0	0	0	3
Bacteria;Bacteria_none;Proteobacteria;Gammaproteobacteria;Alteromonadales;Alteromonadaceae;Aliiglaciecola;Aliiglaciecola litoralis	1	2	0	0	0	0	0	0	3
Bacteria;Bacteria_none;Proteobacteria;Alphaproteobacteria;Hyphomicrobiales;Stappiaceae;Stappia;Stappia conradae	0	1	1	1	0	0	0	0	3
Bacteria;Bacteria_none;Proteobacteria;Alphaproteobacteria;Rhodobacterales;Rhodobacteraceae;Paracoccus;Paracoccus marinus	1	1	0	1	0	0	0	0	3
Bacteria;Bacteria_none;Proteobacteria;Alphaproteobacteria;Hyphomicrobiales;Phyllobacteriaceae;Pseudaminobacter;Pseudaminobacter salicylatoxidans	3	0	0	0	0	0	0	0	3
Bacteria;Bacteria_none;Proteobacteria;Gammaproteobacteria;Enterobacterales;Enterobacteriaceae;Intestinirhabdus;Intestinirhabdus alba	0	0	2	1	0	0	0	0	3
Bacteria;Bacteria_none;Bacteroidota;Flavobacteriia;Flavobacteriales;Flavobacteriaceae;Flavobacterium;Flavobacterium filum	0	0	1	0	1	0	0	1	3
Bacteria;Bacteria_none;Proteobacteria;Alphaproteobacteria;Rhodobacterales;Rhodobacteraceae;Oceanicella;Oceanicella actignis	0	1	1	0	0	0	1	0	3
Bacteria;Bacteria_none;Firmicutes;Clostridia;Eubacteriales;Lachnospiraceae;Oribacterium;Oribacterium asaccharolyticum	3	0	0	0	0	0	0	0	3
Bacteria;Bacteria_none;Bacteroidota;Flavobacteriia;Flavobacteriales;Flavobacteriaceae;Flavobacterium;Flavobacterium haoranii	3	0	0	0	0	0	0	0	3
Bacteria;Bacteria_none;Proteobacteria;Gammaproteobacteria;Chromatiales;Chromatiaceae;Imhoffiella;Imhoffiella bheemlica	3	0	0	0	0	0	0	0	3
Bacteria;Bacteria_none;Tenericutes;Mollicutes;Mycoplasmatales;Mycoplasmataceae;Mycoplasma;Mycoplasma elephantis	3	0	0	0	0	0	0	0	3
Bacteria;Bacteria_none;Proteobacteria;Gammaproteobacteria;Chromatiales;Chromatiaceae;Marichromatium;Marichromatium bheemlicum	1	0	0	1	0	1	0	0	3
Bacteria;Bacteria_none;Proteobacteria;Gammaproteobacteria;Chromatiales;Chromatiaceae;Marichromatium;Marichromatium purpuratum	0	2	0	0	1	0	0	0	3
Bacteria;Bacteria_none;Proteobacteria;Alphaproteobacteria;Rhodobacterales;Rhodobacteraceae;Marinibacterium;Marinibacterium profundimaris	1	0	1	0	0	1	0	0	3
Bacteria;Bacteria_none;Bacteroidota;Flavobacteriia;Flavobacteriales;Flavobacteriaceae;Flavobacterium;Flavobacterium laiguense	0	0	0	3	0	0	0	0	3
Bacteria;Bacteria_none;Synergistetes;Synergistia;Synergistales;Synergistaceae;Jonquetella;Jonquetella anthropi	0	2	1	0	0	0	0	0	3
Bacteria;Bacteria_none;Acidobacteria;Acidobacteriia;Acidobacteriales;Acidobacteriaceae;Edaphobacter;Edaphobacter lichenicola	0	0	0	0	0	3	0	0	3
Bacteria;Bacteria_none;Firmicutes;Bacilli;Lactobacillales;Lactobacillaceae;Limosilactobacillus;Limosilactobacillus panis	2	0	0	1	0	0	0	0	3
Bacteria;Bacteria_none;Firmicutes;Bacilli;Bacillales;Paenibacillaceae;Cohnella;Cohnella phaseoli	0	0	1	2	0	0	0	0	3
Bacteria;Bacteria_none;Firmicutes;Bacilli;Lactobacillales;Lactobacillaceae;Ligilactobacillus;Ligilactobacillus pobuzihii	1	0	2	0	0	0	0	0	3
Bacteria;Bacteria_none;Actinobacteria;Actinomycetia;Micrococcales;Microbacteriaceae;Microbacterium;Microbacterium suwonense	0	0	0	3	0	0	0	0	3
Bacteria;Bacteria_none;Proteobacteria;Gammaproteobacteria;Chromatiales;Chromatiaceae;Phaeobacterium;Phaeobacterium nitratireducens	1	1	0	1	0	0	0	0	3
Bacteria;Bacteria_none;Proteobacteria;Alphaproteobacteria;Rhodobacterales;Rhodobacteraceae;Aquimixticola;Aquimixticola soesokkakensis	0	0	0	3	0	0	0	0	3
Bacteria;Bacteria_none;Bacteroidota;Flavobacteriia;Flavobacteriales;Flavobacteriaceae;Gelidibacter;Gelidibacter gilvus	0	0	0	0	0	3	0	0	3
Bacteria;Bacteria_none;Proteobacteria;Gammaproteobacteria;Chromatiales;Chromatiaceae;Thermochromatium;Thermochromatium tepidum	1	0	0	1	0	0	1	0	3
Bacteria;Bacteria_none;Firmicutes;Bacilli;Bacillales;Paenibacillaceae;Paenibacillus;Paenibacillus chibensis	0	0	3	0	0	0	0	0	3
Bacteria;Bacteria_none;Proteobacteria;Gammaproteobacteria;Enterobacterales;Morganellaceae;Providencia;Providencia rustigianii	3	0	0	0	0	0	0	0	3
Bacteria;Bacteria_none;Bacteroidota;Saprospiria;Saprospirales;Lewinellaceae;Neolewinella;Neolewinella maritima	3	0	0	0	0	0	0	0	3
Bacteria;Bacteria_none;Actinobacteria;Actinomycetia;Micrococcales;Microbacteriaceae;Microbacterium;Microbacterium schleiferi	0	0	0	3	0	0	0	0	3
Bacteria;Bacteria_none;Proteobacteria;Gammaproteobacteria;Chromatiales;Chromatiaceae;Thiolamprovum;Thiolamprovum pedioforme	1	1	0	0	1	0	0	0	3
Bacteria;Bacteria_none;Firmicutes;Bacilli;Bacillales;Paenibacillaceae;Paenibacillus;Paenibacillus terrigena	1	0	1	0	1	0	0	0	3
Bacteria;Bacteria_none;Tenericutes;Mollicutes;Anaeroplasmatales;Anaeroplasmataceae;Anaeroplasma;Anaeroplasma abactoclasticum	0	0	1	2	0	0	0	0	3
Bacteria;Bacteria_none;Acidobacteria;Acidobacteriia;Acidobacteriales;Acidobacteriaceae;Edaphobacter;Edaphobacter bradus	2	0	0	0	1	0	0	0	3
Bacteria;Bacteria_none;Bacteroidota;Flavobacteriia;Flavobacteriales;Flavobacteriaceae;Flavobacterium;Flavobacterium vireti	1	0	2	0	0	0	0	0	3
Bacteria;Bacteria_none;Bacteroidota;Flavobacteriia;Flavobacteriales;Flavobacteriaceae;Flavobacterium;Flavobacterium succinicans	0	0	0	3	0	0	0	0	3
Bacteria;Bacteria_none;Bacteroidota;Flavobacteriia;Flavobacteriales;Flavobacteriaceae;Flavobacterium;Flavobacterium gillisiae	0	1	0	0	1	0	0	1	3
Bacteria;Bacteria_none;Bacteroidota;Sphingobacteriia;Sphingobacteriales;Sphingobacteriaceae;Daejeonella;Daejeonella oryzae	3	0	0	0	0	0	0	0	3
Bacteria;Bacteria_none;Bacteroidota;Flavobacteriia;Flavobacteriales;Flavobacteriaceae;Arenibacter;Arenibacter nanhaiticus	0	0	3	0	0	0	0	0	3
Bacteria;Bacteria_none;Bacteroidota;Flavobacteriia;Flavobacteriales;Flavobacteriaceae;Flavobacterium;Flavobacterium cucumis	3	0	0	0	0	0	0	0	3
Bacteria;Bacteria_none;Firmicutes;Bacilli;Bacillales;Paenibacillaceae;Paenibacillus;Paenibacillus planticolens	0	0	0	1	0	2	0	0	3
Bacteria;Bacteria_none;Proteobacteria;Gammaproteobacteria;Enterobacterales;Budviciaceae;Pragia;Pragia fontium	3	0	0	0	0	0	0	0	3
Bacteria;Bacteria_none;Firmicutes;Bacilli;Lactobacillales;Streptococcaceae;Streptococcus;Streptococcus shenyangsis	1	0	0	0	1	1	0	0	3
Bacteria;Bacteria_none;Bacteroidota;Flavobacteriia;Flavobacteriales;Flavobacteriaceae;Litoribaculum;Litoribaculum gwangyangense	1	2	0	0	0	0	0	0	3
Bacteria;Bacteria_none;Proteobacteria;Gammaproteobacteria;Cardiobacteriales;Cardiobacteriaceae;Cardiobacterium;Cardiobacterium hominis	0	0	2	1	0	0	0	0	3
Bacteria;Bacteria_none;Proteobacteria;Gammaproteobacteria;Cardiobacteriales;Ostreibacteriaceae;Ostreibacterium;Ostreibacterium oceani	0	0	1	0	0	2	0	0	3
Bacteria;Bacteria_none;Proteobacteria;Gammaproteobacteria;Enterobacterales;Erwiniaceae;Pantoea;Pantoea rodasii	3	0	0	0	0	0	0	0	3
Bacteria;Bacteria_none;Proteobacteria;Alphaproteobacteria;Hyphomicrobiales;Phyllobacteriaceae;Aquibium;Aquibium carbonis	0	0	3	0	0	0	0	0	3
Bacteria;Bacteria_none;Proteobacteria;Alphaproteobacteria;Kordiimonadales;Temperatibacteraceae;Temperatibacter;Temperatibacter marinus	0	2	0	0	1	0	0	0	3
Bacteria;Bacteria_none;Proteobacteria;Alphaproteobacteria;Maricaulales;Maricaulaceae;Glycocaulis;Glycocaulis albus	0	0	1	2	0	0	0	0	3
Bacteria;Bacteria_none;Proteobacteria;Gammaproteobacteria;Enterobacterales;Budviciaceae;Budvicia;Budvicia aquatica	0	0	0	0	0	0	0	3	3
Bacteria;Bacteria_none;Proteobacteria;Alphaproteobacteria;Hyphomicrobiales;Phyllobacteriaceae;Chelativorans;Chelativorans intermedius	0	2	0	1	0	0	0	0	3
Bacteria;Bacteria_none;Proteobacteria;Gammaproteobacteria;Enterobacterales;Bruguierivoracaceae;Sodalis;Sodalis ligni	2	0	0	1	0	0	0	0	3
Bacteria;Bacteria_none;Actinobacteria;Actinomycetia;Kineosporiales;Kineosporiaceae;Angustibacter;Angustibacter speluncae	2	1	0	0	0	0	0	0	3
Bacteria;Bacteria_none;Proteobacteria;Alphaproteobacteria;Micropepsales;Micropepsaceae;Micropepsis;Micropepsis pineolensis	3	0	0	0	0	0	0	0	3
Bacteria;Bacteria_none;Proteobacteria;Alphaproteobacteria;Rhodobacterales;Rhodobacteraceae;Paracoccus;Paracoccus caeni	1	1	0	0	0	1	0	0	3
Bacteria;Bacteria_none;Firmicutes;Bacilli;Bacillales;Paenibacillaceae;Paenibacillus;Paenibacillus validus	0	0	3	0	0	0	0	0	3
Bacteria;Bacteria_none;Firmicutes;Clostridia;Eubacteriales;Lachnospiraceae;Lachnoanaerobaculum;Lachnoanaerobaculum gingivalis	0	3	0	0	0	0	0	0	3
Bacteria;Bacteria_none;Proteobacteria;Gammaproteobacteria;Cellvibrionales;Spongiibacteraceae;Sinobacterium;Sinobacterium caligoides	2	0	1	0	0	0	0	0	3
Bacteria;Bacteria_none;Proteobacteria;Alphaproteobacteria;Rhodobacterales;Rhodobacteraceae;Paracoccus;Paracoccus aurantiacus	1	1	1	0	0	0	0	0	3
Bacteria;Bacteria_none;Actinobacteria;Actinomycetia;Micrococcales;Microbacteriaceae;Microbacterium;Microbacterium rhizosphaerae	0	1	1	1	0	0	0	0	3
Bacteria;Bacteria_none;Proteobacteria;Gammaproteobacteria;Cellvibrionales;Spongiibacteraceae;Spongiibacter;Spongiibacter pelagi	1	1	0	1	0	0	0	0	3
Bacteria;Bacteria_none;Actinobacteria;Actinomycetia;Streptomycetales;Streptomycetaceae;Streptomyces;Streptomyces aridus	1	0	0	0	1	1	0	0	3
Bacteria;Bacteria_none;Tenericutes;Mollicutes;Mycoplasmatales;Mycoplasmataceae;Mycoplasmopsis;Mycoplasmopsis phocirhinis	0	3	0	0	0	0	0	0	3
Bacteria;Bacteria_none;Proteobacteria;Gammaproteobacteria;Chromatiales;Thioalkalispiraceae;Thiohalophilus;Thiohalophilus thiocyanatoxydans	1	0	1	0	0	0	0	1	3
Bacteria;Bacteria_none;Actinobacteria;Actinomycetia;Streptomycetales;Streptomycetaceae;Streptomyces;Streptomyces alkalithermotolerans	0	0	2	0	0	0	1	0	3
Bacteria;Bacteria_none;Proteobacteria;Deltaproteobacteria;Myxococcales;Myxococcaceae;Citreicoccus;Citreicoccus inhibens	3	0	0	0	0	0	0	0	3
Bacteria;Bacteria_none;Proteobacteria;Gammaproteobacteria;Chromatiales;Halothiobacillaceae;Halothiobacillus;Halothiobacillus neapolitanus	2	1	0	0	0	0	0	0	3
Bacteria;Bacteria_none;Tenericutes;Mollicutes;Mycoplasmatales;Mycoplasmataceae;Mycoplasma;Mycoplasma simbae	0	3	0	0	0	0	0	0	3
Bacteria;Bacteria_none;Proteobacteria;Alphaproteobacteria;Hyphomicrobiales;Rhodovibrionaceae;Pelagibius;Pelagibius marinus	1	0	2	0	0	0	0	0	3
Bacteria;Bacteria_none;Firmicutes;Bacilli;Bacillales;Planococcaceae;Solibacillus;Solibacillus cecembensis	0	0	2	1	0	0	0	0	3
Bacteria;Bacteria_none;Proteobacteria;Alphaproteobacteria;Hyphomicrobiales;Rhodovibrionaceae;Limimonas;Limimonas halophila	1	0	1	0	1	0	0	0	3
Bacteria;Bacteria_none;Proteobacteria;Alphaproteobacteria;Hyphomicrobiales;Methylobacteriaceae;Psychroglaciecola;Psychroglaciecola arctica	0	1	1	0	0	1	0	0	3
Bacteria;Bacteria_none;Firmicutes;Clostridia;Eubacteriales;Clostridiaceae;Caloramator;Caloramator mitchellensis	0	0	2	0	0	0	0	1	3
Bacteria;Bacteria_none;Firmicutes;Bacilli;Lactobacillales;Streptococcaceae;Lactococcus;Lactococcus carnosus	2	1	0	0	0	0	0	0	3
Bacteria;Bacteria_none;Actinobacteria;Actinomycetia;Corynebacteriales;Nocardiaceae;Parvopolyspora;Parvopolyspora pallida	1	1	1	0	0	0	0	0	3
Bacteria;Bacteria_none;Actinobacteria;Actinomycetia;Corynebacteriales;Nocardiaceae;Rhodococcus;Rhodococcus coprophilus	1	1	0	0	0	0	0	1	3
Bacteria;Bacteria_none;Actinobacteria;Actinomycetia;Micrococcales;Microbacteriaceae;Microbacterium;Microbacterium imperiale	1	1	0	1	0	0	0	0	3
Bacteria;Bacteria_none;Proteobacteria;Gammaproteobacteria;Xanthomonadales;Xanthomonadaceae;Stenotrophomonas;Stenotrophomonas pictorum	2	1	0	0	0	0	0	0	3
Bacteria;Bacteria_none;Proteobacteria;Gammaproteobacteria;Legionellales;Legionellaceae;Fluoribacter;Fluoribacter dumoffii	3	0	0	0	0	0	0	0	3
Bacteria;Bacteria_none;Actinobacteria;Actinomycetia;Streptomycetales;Streptomycetaceae;Streptomyces;Streptomyces lunalinharesii	1	1	0	1	0	0	0	0	3
Bacteria;Bacteria_none;Actinobacteria;Actinomycetia;Pseudonocardiales;Pseudonocardiaceae;Amycolatopsis;Amycolatopsis albispora	0	0	3	0	0	0	0	0	3
Bacteria;Bacteria_none;Firmicutes;Bacilli;Bacillales;Paenibacillaceae;Paenibacillus;Paenibacillus pectinilyticus	0	0	3	0	0	0	0	0	3
Bacteria;Bacteria_none;Proteobacteria;Gammaproteobacteria;Enterobacterales;Enterobacteriaceae;Kosakonia;Kosakonia oryziphila	3	0	0	0	0	0	0	0	3
Bacteria;Bacteria_none;Firmicutes;Bacilli;Bacillales;Bacillaceae;Salinibacillus;Salinibacillus kushneri	0	0	2	1	0	0	0	0	3
Bacteria;Bacteria_none;Bacteroidota;Flavobacteriia;Flavobacteriales;Flavobacteriaceae;Subsaximicrobium;Subsaximicrobium saxinquilinus	0	0	0	3	0	0	0	0	3
Bacteria;Bacteria_none;Actinobacteria;Actinomycetia;Kineosporiales;Kineosporiaceae;Kineosporia;Kineosporia rhamnosa	0	3	0	0	0	0	0	0	3
Bacteria;Bacteria_none;Actinobacteria;Actinomycetia;Propionibacteriales;Nocardioidaceae;Nocardioides;Nocardioides nanhaiensis	0	0	2	0	0	0	0	1	3
Bacteria;Bacteria_none;Firmicutes;Bacilli;Lactobacillales;Lactobacillaceae;Latilactobacillus;Latilactobacillus fuchuensis	0	2	0	1	0	0	0	0	3
Bacteria;Bacteria_none;Proteobacteria;Alphaproteobacteria;Rhodobacterales;Roseobacteraceae;Rubellimicrobium;Rubellimicrobium roseum	1	1	0	1	0	0	0	0	3
Bacteria;Bacteria_none;Actinobacteria;Actinomycetia;Streptomycetales;Streptomycetaceae;Streptomyces;Streptomyces lacrimifluminis	0	0	1	1	0	1	0	0	3
Bacteria;Bacteria_none;Proteobacteria;Epsilonproteobacteria;Campylobacterales;Arcobacteraceae;Arcobacter;Arcobacter caeni	0	0	0	1	0	0	0	2	3
Bacteria;Bacteria_none;Proteobacteria;Gammaproteobacteria;Xanthomonadales;Xanthomonadaceae;Xanthomonas;Xanthomonas albilineans	3	0	0	0	0	0	0	0	3
Bacteria;Bacteria_none;Actinobacteria;Actinomycetia;Corynebacteriales;Nocardiaceae;Rhodococcus;Rhodococcus qingshengii	0	2	1	0	0	0	0	0	3
Bacteria;Bacteria_none;Proteobacteria;Gammaproteobacteria;Enterobacterales;Enterobacteriaceae;Kluyvera;Kluyvera intermedia	3	0	0	0	0	0	0	0	3
Bacteria;Bacteria_none;Actinobacteria;Actinomycetia;Streptomycetales;Streptomycetaceae;Streptomyces;Streptomyces kalpinensis	0	0	1	2	0	0	0	0	3
Bacteria;Bacteria_none;Bacteroidota;Flavobacteriia;Flavobacteriales;Flavobacteriaceae;Sinomicrobium;Sinomicrobium pectinilyticum	2	0	0	0	0	0	0	1	3
Bacteria;Bacteria_none;Actinobacteria;Actinomycetia;Micrococcales;Microbacteriaceae;Microbacterium;Microbacterium keratanolyticum	0	0	0	3	0	0	0	0	3
Bacteria;Bacteria_none;Proteobacteria;Epsilonproteobacteria;Campylobacterales;Campylobacterales_Incertae_sedis;Thiofractor;Thiofractor thiocaminus	0	3	0	0	0	0	0	0	3
Bacteria;Bacteria_none;Actinobacteria;Actinomycetia;Streptomycetales;Streptomycetaceae;Streptomyces;Streptomyces hyaluromycini	0	0	2	1	0	0	0	0	3
Bacteria;Bacteria_none;Actinobacteria;Actinomycetia;Streptomycetales;Streptomycetaceae;Streptomyces;Streptomyces muensis	0	1	1	1	0	0	0	0	3
Bacteria;Bacteria_none;Bacteroidota;Cytophagia;Cytophagales;Fulvivirgaceae;Pseudochryseolinea;Pseudochryseolinea flava	1	0	0	0	0	0	2	0	3
Bacteria;Bacteria_none;Proteobacteria;Alphaproteobacteria;Hyphomicrobiales;Rhizobiaceae;Rhizobium;Rhizobium lusitanum	0	1	2	0	0	0	0	0	3
Bacteria;Bacteria_none;Actinobacteria;Actinomycetia;Pseudonocardiales;Pseudonocardiaceae;Actinokineospora;Actinokineospora inagensis	0	0	3	0	0	0	0	0	3
Bacteria;Bacteria_none;Bacteroidota;Flavobacteriia;Flavobacteriales;Weeksellaceae;Chryseobacterium;Chryseobacterium flavum	2	0	0	1	0	0	0	0	3
Bacteria;Bacteria_none;Proteobacteria;Gammaproteobacteria;Xanthomonadales;Xanthomonadaceae;Pseudoxanthomonas;Pseudoxanthomonas putridarboris	2	0	0	1	0	0	0	0	3
Bacteria;Bacteria_none;Actinobacteria;Actinomycetia;Kineosporiales;Kineosporiaceae;Quadrisphaera;Quadrisphaera granulorum	1	2	0	0	0	0	0	0	3
Bacteria;Bacteria_none;Actinobacteria;Actinomycetia;Propionibacteriales;Propionibacteriaceae;Tessaracoccus;Tessaracoccus timonensis	1	0	0	2	0	0	0	0	3
Bacteria;Bacteria_none;Proteobacteria;Deltaproteobacteria;Myxococcales;Myxococcaceae;Myxococcus;Myxococcus fulvus	0	0	0	3	0	0	0	0	3
Bacteria;Bacteria_none;Proteobacteria;Alphaproteobacteria;Hyphomicrobiales;Kaistiaceae;Kaistia;Kaistia granuli	0	0	1	1	0	1	0	0	3
Bacteria;Bacteria_none;Bacteroidota;Cytophagia;Cytophagales;Flammeovirgaceae;Limibacter;Limibacter armeniacum	0	0	0	3	0	0	0	0	3
Bacteria;Bacteria_none;Bacteroidota;Cytophagia;Cytophagales;Flammeovirgaceae;Perexilibacter;Perexilibacter aurantiacus	0	0	2	0	0	1	0	0	3
Bacteria;Bacteria_none;Actinobacteria;Actinomycetia;Corynebacteriales;Corynebacteriaceae;Corynebacterium;Corynebacterium lowii	0	1	1	1	0	0	0	0	3
Bacteria;Bacteria_none;Proteobacteria;Alphaproteobacteria;Rhodospirillales;Acetobacteraceae;Rhodopila;Rhodopila globiformis	0	1	0	2	0	0	0	0	3
Bacteria;Bacteria_none;Actinobacteria;Actinomycetia;Micrococcales;Microbacteriaceae;Microbacterium;Microbacterium flavum	0	1	0	1	0	1	0	0	3
Bacteria;Bacteria_none;Bacteroidota;Flavobacteriia;Flavobacteriales;Weeksellaceae;Chryseobacterium;Chryseobacterium camelliae	0	0	0	0	0	0	0	3	3
Bacteria;Bacteria_none;Proteobacteria;Deltaproteobacteria;Myxococcales;Nannocystaceae;Plesiocystis;Plesiocystis pacifica	2	0	0	1	0	0	0	0	3
Bacteria;Bacteria_none;Proteobacteria;Alphaproteobacteria;Rhodospirillales;Acetobacteraceae;Belnapia;Belnapia arida	3	0	0	0	0	0	0	0	3
Bacteria;Bacteria_none;Proteobacteria;Deltaproteobacteria;Myxococcales;Nannocystaceae;Pseudenhygromyxa;Pseudenhygromyxa salsuginis	3	0	0	0	0	0	0	0	3
Bacteria;Bacteria_none;Firmicutes;Clostridia;Eubacteriales;Oscillospiraceae;Ruminococcus;Ruminococcus gauvreauii	0	3	0	0	0	0	0	0	3
Bacteria;Bacteria_none;Proteobacteria;Gammaproteobacteria;Enterobacterales;Enterobacteriaceae;Phytobacter;Phytobacter ursingii	3	0	0	0	0	0	0	0	3
Bacteria;Bacteria_none;Actinobacteria;Actinomycetia;Micrococcales;Microbacteriaceae;Microbacterium;Microbacterium gorillae	0	2	0	1	0	0	0	0	3
Bacteria;Bacteria_none;Firmicutes;Bacilli;Bacillales;Bacillaceae;Paraliobacillus;Paraliobacillus ryukyuensis	1	0	1	0	0	1	0	0	3
Bacteria;Bacteria_none;Firmicutes;Bacilli;Bacillales;Paenibacillaceae;Paenibacillus;Paenibacillus pasadenensis	0	0	0	3	0	0	0	0	3
Bacteria;Bacteria_none;Firmicutes;Bacilli;Bacillales;Bacillaceae;Paucisalibacillus;Paucisalibacillus globulus	0	1	0	1	1	0	0	0	3
Bacteria;Bacteria_none;Firmicutes;Bacilli;Bacillales;Bacillaceae;Peribacillus;Peribacillus asahii	0	0	0	0	0	2	0	1	3
Bacteria;Bacteria_none;Proteobacteria;Alphaproteobacteria;Rhodospirillales;Acetobacteraceae;Falsiroseomonas;Falsiroseomonas algicola	0	2	1	0	0	0	0	0	3
Bacteria;Bacteria_none;Proteobacteria;Deltaproteobacteria;Myxococcales;Polyangiaceae;Racemicystis;Racemicystis crocea	0	3	0	0	0	0	0	0	3
Bacteria;Bacteria_none;Proteobacteria;Alphaproteobacteria;Rhodospirillales;Acetobacteraceae;Crenalkalicoccus;Crenalkalicoccus roseus	1	2	0	0	0	0	0	0	3
Bacteria;Bacteria_none;Proteobacteria;Alphaproteobacteria;Rhodospirillales;Acetobacteraceae;Bombella;Bombella apis	0	2	1	0	0	0	0	0	3
Bacteria;Bacteria_none;Firmicutes;Clostridia;Eubacteriales;Clostridiaceae;Anaeromicrobium;Anaeromicrobium sediminis	1	0	1	1	0	0	0	0	3
Bacteria;Bacteria_none;Proteobacteria;Gammaproteobacteria;Chromatiales;Ectothiorhodospiraceae;Acidihalobacter;Acidihalobacter aeolianus	3	0	0	0	0	0	0	0	3
Bacteria;Bacteria_none;Proteobacteria;Gammaproteobacteria;Gammaproteobacteria_Incertae_sedis;Gammaproteobacteria_Incertae_sedis;Halospina;Halospina denitrificans	0	1	2	0	0	0	0	0	3
Bacteria;Bacteria_none;Proteobacteria;Gammaproteobacteria;Enterobacterales;Erwiniaceae;Erwinia;Erwinia persicina	3	0	0	0	0	0	0	0	3
Bacteria;Bacteria_none;Actinobacteria;Actinomycetia;Corynebacteriales;Segniliparaceae;Segniliparus;Segniliparus rotundus	0	3	0	0	0	0	0	0	3
Bacteria;Bacteria_none;Actinobacteria;Actinomycetia;Propionibacteriales;Propionibacteriaceae;Propionibacterium;Propionibacterium acidifaciens	1	0	0	1	1	0	0	0	3
Bacteria;Bacteria_none;Actinobacteria;Acidimicrobiia;Acidimicrobiales;Acidimicrobiaceae;Aciditerrimonas;Aciditerrimonas ferrireducens	1	0	2	0	0	0	0	0	3
Bacteria;Bacteria_none;Proteobacteria;Alphaproteobacteria;Rhodobacterales;Rhodobacteraceae;Sinirhodobacter;Sinirhodobacter huangdaonensis	1	0	1	1	0	0	0	0	3
Bacteria;Bacteria_none;Actinobacteria;Actinomycetia;Micrococcales;Microbacteriaceae;Microbacterium;Microbacterium luteolum	0	0	0	0	3	0	0	0	3
Bacteria;Bacteria_none;Proteobacteria;Alphaproteobacteria;Rhodobacterales;Rhodobacteraceae;Rubrimonas;Rubrimonas shengliensis	0	0	0	1	0	0	0	2	3
Bacteria;Bacteria_none;Proteobacteria;Epsilonproteobacteria;Campylobacterales;Sulfurospirillaceae;Sulfurospirillum;Sulfurospirillum multivorans	1	0	0	2	0	0	0	0	3
Bacteria;Bacteria_none;Proteobacteria;Gammaproteobacteria;Enterobacterales;Yersiniaceae;Yersinia;Yersinia similis	3	0	0	0	0	0	0	0	3
Bacteria;Bacteria_none;Proteobacteria;Alphaproteobacteria;Hyphomicrobiales;Methylocystaceae;Methylopila;Methylopila turkensis	0	1	0	1	0	0	0	1	3
Bacteria;Bacteria_none;Firmicutes;Clostridia;Eubacteriales;Lachnospiraceae;Dorea;Dorea formicigenerans	2	1	0	0	0	0	0	0	3
Bacteria;Bacteria_none;Bacteroidota;Cytophagia;Cytophagales;Microscillaceae;Microscilla;Microscilla marina	0	0	0	3	0	0	0	0	3
Bacteria;Bacteria_none;Proteobacteria;Alphaproteobacteria;Rhodobacterales;Rhodobacteraceae;Rhodovulum;Rhodovulum tesquicola	1	1	1	0	0	0	0	0	3
Bacteria;Bacteria_none;Firmicutes;Bacilli;Lactobacillales;Streptococcaceae;Streptococcus;Streptococcus cuniculi	2	0	0	1	0	0	0	0	3
Bacteria;Bacteria_none;Actinobacteria;Actinomycetia;Streptomycetales;Streptomycetaceae;Streptomyces;Streptomyces fildesensis	0	1	1	0	0	0	0	1	3
Bacteria;Bacteria_none;Actinobacteria;Actinomycetia;Micrococcales;Microbacteriaceae;Microbacterium;Microbacterium mitrae	1	1	0	0	0	0	1	0	3
Bacteria;Bacteria_none;Bacteroidota;Cytophagia;Cytophagales;Raineyaceae;Raineya;Raineya orbicola	0	0	2	1	0	0	0	0	3
Bacteria;Bacteria_none;Acidobacteria;Acidobacteriia;Acidobacteriales;Acidobacteriaceae;Alloacidobacterium;Alloacidobacterium dinghuense	0	3	0	0	0	0	0	0	3
Bacteria;Bacteria_none;Proteobacteria;Gammaproteobacteria;Gammaproteobacteria_Incertae_sedis;Gammaproteobacteria_Incertae_sedis;Gallaecimonas;Gallaecimonas pentaromativorans	2	0	0	0	0	1	0	0	3
Bacteria;Bacteria_none;Proteobacteria;Epsilonproteobacteria;Campylobacterales;Thiovulaceae;Sulfuricurvum;Sulfuricurvum kujiense	1	0	0	1	1	0	0	0	3
Bacteria;Bacteria_none;Bacteroidota;Flavobacteriia;Flavobacteriales;Flavobacteriaceae;Sinomicrobium;Sinomicrobium oceani	0	1	1	0	0	0	0	1	3
Bacteria;Bacteria_none;Firmicutes;Clostridia;Eubacteriales;Lachnospiraceae;Anaerotignum;Anaerotignum lactatifermentans	1	0	0	0	0	0	1	0	2
Bacteria;Bacteria_none;Firmicutes;Clostridia;Eubacteriales;Lachnospiraceae;Caecibacterium;Caecibacterium sporoformans	2	0	0	0	0	0	0	0	2
Bacteria;Bacteria_none;Proteobacteria;Gammaproteobacteria;Oceanospirillales;Endozoicomonadaceae;Endozoicomonas;Endozoicomonas ascidiicola	0	0	0	2	0	0	0	0	2
Bacteria;Bacteria_none;Firmicutes;Clostridia;Eubacteriales;Lachnospiraceae;Enterocloster;Enterocloster asparagiformis	2	0	0	0	0	0	0	0	2
Bacteria;Bacteria_none;Actinobacteria;Actinomycetia;Propionibacteriales;Propionibacteriaceae;Naumannella;Naumannella huperziae	0	2	0	0	0	0	0	0	2
Bacteria;Bacteria_none;Actinobacteria;Coriobacteriia;Eggerthellales;Eggerthellaceae;Slackia;Slackia faecicanis	0	0	2	0	0	0	0	0	2
Bacteria;Bacteria_none;Actinobacteria;Actinomycetia;Pseudonocardiales;Pseudonocardiaceae;Pseudonocardia;Pseudonocardia kunmingensis	0	2	0	0	0	0	0	0	2
Bacteria;Bacteria_none;Proteobacteria;Betaproteobacteria;Neisseriales;Chromobacteriaceae;Aquitalea;Aquitalea aquatilis	2	0	0	0	0	0	0	0	2
Bacteria;Bacteria_none;Firmicutes;Clostridia;Eubacteriales;Clostridiaceae;Salimesophilobacter;Salimesophilobacter vulgaris	0	1	0	0	0	1	0	0	2
Bacteria;Bacteria_none;Proteobacteria;Gammaproteobacteria;Enterobacterales;Enterobacteriaceae;Entomohabitans;Entomohabitans teleogrylli	2	0	0	0	0	0	0	0	2
Bacteria;Bacteria_none;Proteobacteria;Betaproteobacteria;Burkholderiales;Oxalobacteraceae;Noviherbaspirillum;Noviherbaspirillum massiliense	0	1	0	0	0	1	0	0	2
Bacteria;Bacteria_none;Bacteroidota;Bacteroidia;Bacteroidales;Bacteroidaceae;Phocaeicola;Phocaeicola barnesiae	0	0	1	0	0	0	1	0	2
Bacteria;Bacteria_none;Firmicutes;Bacilli;Bacillales;Paenibacillaceae;Paenibacillus;Paenibacillus hordei	0	1	0	1	0	0	0	0	2
Bacteria;Bacteria_none;Proteobacteria;Betaproteobacteria;Neisseriales;Chromobacteriaceae;Chitinibacter;Chitinibacter bivalviorum	1	0	0	1	0	0	0	0	2
Bacteria;Bacteria_none;Firmicutes;Clostridia;Eubacteriales;Clostridiaceae;Hathewaya;Hathewaya proteolytica	0	0	0	1	0	0	0	1	2
Bacteria;Bacteria_none;Proteobacteria;Gammaproteobacteria;Nevskiales;Sinobacteraceae;Hydrocarboniphaga;Hydrocarboniphaga effusa	0	0	2	0	0	0	0	0	2
Bacteria;Bacteria_none;Firmicutes;Clostridia;Eubacteriales;Lachnospiraceae;Anaerobium;Anaerobium acetethylicum	0	1	1	0	0	0	0	0	2
Bacteria;Bacteria_none;Firmicutes;Bacilli;Bacillales;Bacillaceae;Bacillus;Bacillus niameyensis	0	0	2	0	0	0	0	0	2
Bacteria;Bacteria_none;Actinobacteria;Actinomycetia;Streptomycetales;Streptomycetaceae;Kitasatospora;Kitasatospora aureofaciens	0	0	0	2	0	0	0	0	2
Bacteria;Bacteria_none;Actinobacteria;Actinomycetia;Actinomycetales;Actinomycetaceae;Arcanobacterium;Arcanobacterium phocae	0	2	0	0	0	0	0	0	2
Bacteria;Bacteria_none;Actinobacteria;Actinomycetia;Propionibacteriales;Propionibacteriaceae;Microlunatus;Microlunatus ginsengiterrae	0	1	1	0	0	0	0	0	2
Bacteria;Bacteria_none;Actinobacteria;Rubrobacteria;Rubrobacterales;Rubrobacteraceae;Rubrobacter;Rubrobacter marinus	0	0	0	0	2	0	0	0	2
Bacteria;Bacteria_none;Firmicutes;Bacilli;Bacillales;Paenibacillaceae;Paenibacillus;Paenibacillus septentrionalis	0	0	1	0	1	0	0	0	2
Bacteria;Bacteria_none;Firmicutes;Negativicutes;Veillonellales;Veillonellaceae;Massilibacillus;Massilibacillus massiliensis	1	0	1	0	0	0	0	0	2
Bacteria;Bacteria_none;Firmicutes;Tissierellia;Tissierellales;Peptoniphilaceae;Anaerococcus;Anaerococcus lactolyticus	1	0	1	0	0	0	0	0	2
Bacteria;Bacteria_none;Firmicutes;Bacilli;Bacillales;Bacillaceae;Bacillus;Bacillus massiliglaciei	1	1	0	0	0	0	0	0	2
Bacteria;Bacteria_none;Proteobacteria;Gammaproteobacteria;Oceanospirillales;Halomonadaceae;Kushneria;Kushneria endophytica	0	2	0	0	0	0	0	0	2
Bacteria;Bacteria_none;Proteobacteria;Gammaproteobacteria;Enterobacterales;Erwiniaceae;Pantoea;Pantoea allii	1	0	0	1	0	0	0	0	2
Bacteria;Bacteria_none;Firmicutes;Clostridia;Eubacteriales;Lachnospiraceae;Lachnoclostridium;Lachnoclostridium phocaeense	2	0	0	0	0	0	0	0	2
Bacteria;Bacteria_none;Actinobacteria;Actinomycetia;Streptomycetales;Streptomycetaceae;Actinacidiphila;Actinacidiphila rubida	0	0	1	0	0	0	0	1	2
Bacteria;Bacteria_none;Firmicutes;Tissierellia;Tissierellales;Peptoniphilaceae;Peptoniphilus;Peptoniphilus harei	2	0	0	0	0	0	0	0	2
Bacteria;Bacteria_none;Firmicutes;Bacilli;Bacillales;Paenibacillaceae;Paenibacillus;Paenibacillus chondroitinus	0	0	2	0	0	0	0	0	2
Bacteria;Bacteria_none;Actinobacteria;Actinomycetia;Micrococcales;Microbacteriaceae;Leucobacter;Leucobacter humi	0	0	1	0	0	1	0	0	2
Bacteria;Bacteria_none;Proteobacteria;Betaproteobacteria;Burkholderiales;Sutterellaceae;Sutterella;Sutterella wadsworthensis	1	1	0	0	0	0	0	0	2
Bacteria;Bacteria_none;Firmicutes;Bacilli;Bacillales;Bacillaceae;Amphibacillus;Amphibacillus xylanus	0	1	0	1	0	0	0	0	2
Bacteria;Bacteria_none;Proteobacteria;Betaproteobacteria;Burkholderiales;Oxalobacteraceae;Noviherbaspirillum;Noviherbaspirillum arenae	0	2	0	0	0	0	0	0	2
Bacteria;Bacteria_none;Proteobacteria;Gammaproteobacteria;Enterobacterales;Erwiniaceae;Pantoea;Pantoea deleyi	1	0	0	1	0	0	0	0	2
Bacteria;Bacteria_none;Proteobacteria;Gammaproteobacteria;Chromatiales;Ectothiorhodospiraceae;Halorhodospira;Halorhodospira neutriphila	0	2	0	0	0	0	0	0	2
Bacteria;Bacteria_none;Firmicutes;Negativicutes;Veillonellales;Veillonellaceae;Veillonella;Veillonella atypica	1	1	0	0	0	0	0	0	2
Bacteria;Bacteria_none;Bacteroidota;Bacteroidia;Bacteroidales;Bacteroidaceae;Bacteroides;Bacteroides gallinaceum	0	1	0	1	0	0	0	0	2
Bacteria;Bacteria_none;Firmicutes;Tissierellia;Tissierellales;Peptoniphilaceae;Peptoniphilus;Peptoniphilus pacaensis	0	0	0	0	0	2	0	0	2
Bacteria;Bacteria_none;Firmicutes;Tissierellia;Tissierellales;Peptoniphilaceae;Anaerococcus;Anaerococcus prevotii	0	1	0	1	0	0	0	0	2
Bacteria;Bacteria_none;Firmicutes;Firmicutes_Incertae_sedis;Firmicutes_Incertae_sedis;Firmicutes_Incertae_sedis;Negativibacillus;Negativibacillus massiliensis	2	0	0	0	0	0	0	0	2
Bacteria;Bacteria_none;Proteobacteria;Gammaproteobacteria;Enterobacterales;Erwiniaceae;Erwinia;[Pantoea] beijingensis	1	0	0	1	0	0	0	0	2
Bacteria;Bacteria_none;Firmicutes;Clostridia;Eubacteriales;Lachnospiraceae;Blautia;Blautia schinkii	2	0	0	0	0	0	0	0	2
Bacteria;Bacteria_none;Proteobacteria;Gammaproteobacteria;Chromatiales;Ectothiorhodospiraceae;Thioalkalivibrio;Thioalkalivibrio jannaschii	0	1	1	0	0	0	0	0	2
Bacteria;Bacteria_none;Proteobacteria;Gammaproteobacteria;Enterobacterales;Morganellaceae;Photorhabdus;Photorhabdus thracensis	2	0	0	0	0	0	0	0	2
Bacteria;Bacteria_none;Proteobacteria;Gammaproteobacteria;Moraxellales;Moraxellaceae;Psychrobacter;Psychrobacter arenosus	0	0	0	2	0	0	0	0	2
Bacteria;Bacteria_none;Actinobacteria;Actinomycetia;Streptomycetales;Streptomycetaceae;Kitasatospora;Kitasatospora sampliensis	0	1	0	0	1	0	0	0	2
Bacteria;Bacteria_none;Actinobacteria;Actinomycetia;Micromonosporales;Micromonosporaceae;Micromonospora;Micromonospora yangpuensis	0	2	0	0	0	0	0	0	2
Bacteria;Bacteria_none;Proteobacteria;Gammaproteobacteria;Oceanospirillales;Hahellaceae;Hahella;Hahella chejuensis	1	1	0	0	0	0	0	0	2
Bacteria;Bacteria_none;Proteobacteria;Betaproteobacteria;Neisseriales;Neisseriaceae;Craterilacuibacter;Craterilacuibacter sinensis	0	1	0	1	0	0	0	0	2
Bacteria;Bacteria_none;Proteobacteria;Betaproteobacteria;Neisseriales;Chromobacteriaceae;Pseudogulbenkiania;Pseudogulbenkiania subflava	0	0	1	1	0	0	0	0	2
Bacteria;Bacteria_none;Actinobacteria;Actinomycetia;Streptomycetales;Streptomycetaceae;Kitasatospora;Kitasatospora cinereorecta	0	1	1	0	0	0	0	0	2
Bacteria;Bacteria_none;Firmicutes;Bacilli;Bacillales;Bacillaceae;Bacillus;Bacillus taeanensis	0	0	1	1	0	0	0	0	2
Bacteria;Bacteria_none;Actinobacteria;Coriobacteriia;Eggerthellales;Eggerthellaceae;Enteroscipio;Enteroscipio rubneri	0	0	0	1	1	0	0	0	2
Bacteria;Bacteria_none;Actinobacteria;Actinomycetia;Kineosporiales;Kineosporiaceae;Thalassiella;Thalassiella azotivora	0	0	1	0	0	0	1	0	2
Bacteria;Bacteria_none;Bacteroidota;Bacteroidia;Bacteroidales;Bacteroidaceae;Bacteroides;Bacteroides helcogenes	0	0	0	2	0	0	0	0	2
Bacteria;Bacteria_none;Proteobacteria;Betaproteobacteria;Neisseriales;Chromobacteriaceae;Leeia;Leeia aquatica	2	0	0	0	0	0	0	0	2
Bacteria;Bacteria_none;Proteobacteria;Gammaproteobacteria;Moraxellales;Moraxellaceae;Psychrobacter;Psychrobacter phenylpyruvicus	0	1	0	1	0	0	0	0	2
Bacteria;Bacteria_none;Proteobacteria;Gammaproteobacteria;Oceanospirillales;Halomonadaceae;Chromohalobacter;Chromohalobacter sarecensis	2	0	0	0	0	0	0	0	2
Bacteria;Bacteria_none;Actinobacteria;Actinomycetia;Micromonosporales;Micromonosporaceae;Micromonospora;Micromonospora globbae	0	0	0	2	0	0	0	0	2
Bacteria;Bacteria_none;Actinobacteria;Actinomycetia;Micrococcales;Microbacteriaceae;Leucobacter;Leucobacter chironomi	0	1	0	1	0	0	0	0	2
Bacteria;Bacteria_none;Proteobacteria;Gammaproteobacteria;Oceanospirillales;Alcanivoracaceae;Alcanivorax;Alcanivorax balearicus	1	1	0	0	0	0	0	0	2
Bacteria;Bacteria_none;Firmicutes;Tissierellia;Tissierellales;Peptoniphilaceae;Peptoniphilus;Peptoniphilus nemausensis	2	0	0	0	0	0	0	0	2
Bacteria;Bacteria_none;Proteobacteria;Gammaproteobacteria;Chromatiales;Ectothiorhodospiraceae;Thioalbus;Thioalbus denitrificans	1	0	1	0	0	0	0	0	2
Bacteria;Bacteria_none;Firmicutes;Clostridia;Eubacteriales;Lachnospiraceae;Bariatricus;Bariatricus massiliensis	1	0	0	0	0	1	0	0	2
Bacteria;Bacteria_none;Proteobacteria;Gammaproteobacteria;Moraxellales;Moraxellaceae;Psychrobacter;Psychrobacter sanguinis	2	0	0	0	0	0	0	0	2
Bacteria;Bacteria_none;Firmicutes;Bacilli;Bacillales;Paenibacillaceae;Paenibacillus;Paenibacillus oralis	0	0	0	0	2	0	0	0	2
Bacteria;Bacteria_none;Firmicutes;Bacilli;Bacillales;Bacillaceae;Bacillus;Bacillus infantis	0	0	2	0	0	0	0	0	2
Bacteria;Bacteria_none;Proteobacteria;Gammaproteobacteria;Chromatiales;Thioalkalispiraceae;Sulfurivermis;Sulfurivermis fontis	0	0	2	0	0	0	0	0	2
Bacteria;Bacteria_none;Proteobacteria;Betaproteobacteria;Burkholderiales;Comamonadaceae;Pseudorhodoferax;Pseudorhodoferax aquiterrae	1	0	1	0	0	0	0	0	2
Bacteria;Bacteria_none;Firmicutes;Bacilli;Bacillales;Paenibacillaceae;Paenibacillus;Paenibacillus etheri	0	0	0	1	0	0	0	1	2
Bacteria;Bacteria_none;Proteobacteria;Betaproteobacteria;Burkholderiales;Oxalobacteraceae;Undibacterium;Undibacterium baiyunense	0	2	0	0	0	0	0	0	2
Bacteria;Bacteria_none;Firmicutes;Tissierellia;Tissierellales;Peptoniphilaceae;Anaerosphaera;Anaerosphaera aminiphila	0	0	0	0	0	2	0	0	2
Bacteria;Bacteria_none;Actinobacteria;Actinomycetia;Micromonosporales;Micromonosporaceae;Micromonospora;Micromonospora jinlongensis	0	0	1	0	1	0	0	0	2
Bacteria;Bacteria_none;Proteobacteria;Betaproteobacteria;Burkholderiales;Oxalobacteraceae;Undibacterium;Undibacterium hunanense	2	0	0	0	0	0	0	0	2
Bacteria;Bacteria_none;Actinobacteria;Thermoleophilia;Solirubrobacterales;Solirubrobacteraceae;Solirubrobacter;Solirubrobacter taibaiensis	2	0	0	0	0	0	0	0	2
Bacteria;Bacteria_none;Proteobacteria;Gammaproteobacteria;Chromatiales;Ectothiorhodospiraceae;Alkalispirillum;Alkalispirillum mobile	0	0	2	0	0	0	0	0	2
Bacteria;Bacteria_none;Proteobacteria;Betaproteobacteria;Burkholderiales;Oxalobacteraceae;Massilia;Massilia rhizosphaerae	0	2	0	0	0	0	0	0	2
Bacteria;Bacteria_none;Proteobacteria;Gammaproteobacteria;Oceanospirillales;Halomonadaceae;Halomonas;Halomonas salicampi	0	1	0	1	0	0	0	0	2
Bacteria;Bacteria_none;Firmicutes;Bacilli;Bacillales;Bacillaceae;Bacillus;Bacillus amyloliquefaciens	0	0	0	2	0	0	0	0	2
Bacteria;Bacteria_none;Proteobacteria;Betaproteobacteria;Burkholderiales;Oxalobacteraceae;Massilia;Massilia putida	2	0	0	0	0	0	0	0	2
Bacteria;Bacteria_none;Firmicutes;Bacilli;Bacillales;Paenibacillaceae;Paenibacillus;Paenibacillus phytorum	0	0	2	0	0	0	0	0	2
Bacteria;Bacteria_none;Firmicutes;Bacilli;Bacillales;Bacillaceae;Bacillus;Bacillus andreraoultii	1	0	0	0	0	0	0	1	2
Bacteria;Bacteria_none;Actinobacteria;Actinomycetia;Pseudonocardiales;Pseudonocardiaceae;Saccharopolyspora;Saccharopolyspora cebuensis	0	2	0	0	0	0	0	0	2
Bacteria;Bacteria_none;Firmicutes;Bacilli;Bacillales;Bacillaceae;Anoxybacillus;Anoxybacillus pushchinoensis	0	1	0	0	0	1	0	0	2
Bacteria;Bacteria_none;Firmicutes;Tissierellia;Tissierellales;Peptoniphilaceae;Khoudiadiopia;Khoudiadiopia massiliensis	0	0	1	0	0	0	0	1	2
Bacteria;Bacteria_none;Firmicutes;Bacilli;Bacillales;Paenibacillaceae;Paenibacillus;Paenibacillus pinihumi	0	0	2	0	0	0	0	0	2
Bacteria;Bacteria_none;Firmicutes;Bacilli;Bacillales;Paenibacillaceae;Paenibacillus;Paenibacillus puernese	0	1	1	0	0	0	0	0	2
Bacteria;Bacteria_none;Aquificae;Aquificae;Aquificales;Aquificales_Incertae_sedis;Thermosulfidibacter;Thermosulfidibacter takaii	0	0	2	0	0	0	0	0	2
Bacteria;Bacteria_none;Actinobacteria;Actinomycetia;Corynebacteriales;Gordoniaceae;Skermania;Skermania piniformis	1	0	1	0	0	0	0	0	2
Bacteria;Bacteria_none;Actinobacteria;Actinomycetia;Micrococcales;Microbacteriaceae;Leucobacter;Leucobacter salsicius	0	0	2	0	0	0	0	0	2
Bacteria;Bacteria_none;Bacteroidota;Bacteroidia;Bacteroidales;Bacteroidaceae;Phocaeicola;Phocaeicola massiliensis	0	0	0	0	0	1	0	1	2
Bacteria;Bacteria_none;Proteobacteria;Betaproteobacteria;Burkholderiales;Oxalobacteraceae;Telluria;Telluria chitinolytica	2	0	0	0	0	0	0	0	2
Bacteria;Bacteria_none;Bacteroidota;Bacteroidia;Bacteroidales;Barnesiellaceae;Coprobacter;Coprobacter fastidiosus	0	0	1	0	0	1	0	0	2
Bacteria;Bacteria_none;Firmicutes;Bacilli;Lactobacillales;Aerococcaceae;Aerococcus;Aerococcus viridans	2	0	0	0	0	0	0	0	2
Bacteria;Bacteria_none;Proteobacteria;Betaproteobacteria;Burkholderiales;Comamonadaceae;Rhodoferax;Rhodoferax lacus	2	0	0	0	0	0	0	0	2
Bacteria;Bacteria_none;Firmicutes;Bacilli;Bacillales;Paenibacillaceae;Paenibacillus;Paenibacillus periandrae	0	0	2	0	0	0	0	0	2
Bacteria;Bacteria_none;Acidobacteria;Thermoanaerobaculia;Thermoanaerobaculales;Thermoanaerobaculaceae;Thermoanaerobaculum;Thermoanaerobaculum aquaticum	1	0	0	1	0	0	0	0	2
Bacteria;Bacteria_none;Actinobacteria;Actinomycetia;Pseudonocardiales;Pseudonocardiaceae;Saccharopolyspora;Saccharopolyspora terrae	0	2	0	0	0	0	0	0	2
Bacteria;Bacteria_none;Proteobacteria;Betaproteobacteria;Burkholderiales;Comamonadaceae;Rhodoferax;Rhodoferax sediminis	0	0	0	0	0	0	2	0	2
Bacteria;Bacteria_none;Proteobacteria;Gammaproteobacteria;Enterobacterales;Enterobacteriaceae;Cedecea;Cedecea colo	1	0	0	1	0	0	0	0	2
Bacteria;Bacteria_none;Proteobacteria;Gammaproteobacteria;Oceanospirillales;Halomonadaceae;Halomonas;Halomonas qijiaojingensis	2	0	0	0	0	0	0	0	2
Bacteria;Bacteria_none;Bacteroidota;Bacteroidia;Bacteroidales;Bacteroidaceae;Bacteroides;Bacteroides timonensis	0	0	0	0	0	0	0	2	2
Bacteria;Bacteria_none;Proteobacteria;Gammaproteobacteria;Oceanospirillales;Halomonadaceae;Halomonas;Halomonas halodenitrificans	1	0	1	0	0	0	0	0	2
Bacteria;Bacteria_none;Actinobacteria;Actinomycetia;Micrococcales;Intrasporangiaceae;Tetrasphaera;Tetrasphaera jenkinsii	2	0	0	0	0	0	0	0	2
Bacteria;Bacteria_none;Actinobacteria;Thermoleophilia;Solirubrobacterales;Solirubrobacteraceae;Solirubrobacter;Solirubrobacter pauli	0	0	1	0	0	0	1	0	2
Bacteria;Bacteria_none;Actinobacteria;Actinomycetia;Micrococcales;Microbacteriaceae;Microbacterium;Microbacterium arabinogalactanolyticum	2	0	0	0	0	0	0	0	2
Bacteria;Bacteria_none;Firmicutes;Bacilli;Bacillales;Paenibacillaceae;Paenibacillus;Paenibacillus edaphicus	0	1	0	0	0	1	0	0	2
Bacteria;Bacteria_none;Proteobacteria;Gammaproteobacteria;Enterobacterales;Erwiniaceae;Mixta;Mixta gaviniae	2	0	0	0	0	0	0	0	2
Bacteria;Bacteria_none;Proteobacteria;Gammaproteobacteria;Chromatiales;Thioprofundaceae;Thioprofundum;Thioprofundum hispidum	2	0	0	0	0	0	0	0	2
Bacteria;Bacteria_none;Actinobacteria;Actinomycetia;Pseudonocardiales;Pseudonocardiaceae;Haloechinothrix;Haloechinothrix alba	0	0	2	0	0	0	0	0	2
Bacteria;Bacteria_none;Bacteroidota;Bacteroidia;Bacteroidales;Bacteroidaceae;Bacteroides;Bacteroides xylanisolvens	2	0	0	0	0	0	0	0	2
Bacteria;Bacteria_none;Actinobacteria;Actinomycetia;Micrococcales;Microbacteriaceae;Agrococcus;Agrococcus citreus	0	1	1	0	0	0	0	0	2
Bacteria;Bacteria_none;Firmicutes;Negativicutes;Selenomonadales;Sporomusaceae;Anaeromusa;Anaeromusa acidaminophila	0	0	0	2	0	0	0	0	2
Bacteria;Bacteria_none;Proteobacteria;Betaproteobacteria;Burkholderiales;Sphaerotilaceae;Azohydromonas;Azohydromonas riparia	2	0	0	0	0	0	0	0	2
Bacteria;Bacteria_none;Proteobacteria;Gammaproteobacteria;Enterobacterales;Enterobacteriaceae;Yokenella;Yokenella regensburgei	2	0	0	0	0	0	0	0	2
Bacteria;Bacteria_none;Firmicutes;Negativicutes;Selenomonadales;Selenomonadaceae;Selenomonas;Selenomonas timonae	0	0	0	0	0	0	1	1	2
Bacteria;Bacteria_none;Firmicutes;Bacilli;Bacillales;Bacillaceae;Alkalihalobacillus;Alkalihalobacillus trypoxylicola	0	0	1	0	0	1	0	0	2
Bacteria;Bacteria_none;Actinobacteria;Actinomycetia;Pseudonocardiales;Pseudonocardiaceae;Pseudonocardia;Pseudonocardia nantongensis	0	1	1	0	0	0	0	0	2
Bacteria;Bacteria_none;Actinobacteria;Rubrobacteria;Rubrobacterales;Rubrobacteraceae;Rubrobacter;Rubrobacter xylanophilus	0	0	0	2	0	0	0	0	2
Bacteria;Bacteria_none;Firmicutes;Clostridia;Eubacteriales;Clostridiaceae;Haloimpatiens;Haloimpatiens lingqiaonensis	2	0	0	0	0	0	0	0	2
Bacteria;Bacteria_none;Actinobacteria;Actinomycetia;Propionibacteriales;Propionibacteriaceae;Naumannella;Naumannella halotolerans	0	1	0	0	0	1	0	0	2
Bacteria;Bacteria_none;Actinobacteria;Actinomycetia;Pseudonocardiales;Pseudonocardiaceae;Saccharomonospora;Saccharomonospora cyanea	0	2	0	0	0	0	0	0	2
Bacteria;Bacteria_none;Actinobacteria;Actinomycetia;Actinomycetales;Actinomycetaceae;Actinomyces;Actinomyces respiraculi	0	0	0	2	0	0	0	0	2
Bacteria;Bacteria_none;Actinobacteria;Actinomycetia;Micrococcales;Microbacteriaceae;Microbacterium;Microbacterium aurantiacum	0	0	0	0	0	0	0	2	2
Bacteria;Bacteria_none;Firmicutes;Bacilli;Bacillales;Bacillaceae;Bacillus;Bacillus ectoiniformans	0	0	2	0	0	0	0	0	2
Bacteria;Bacteria_none;Firmicutes;Bacilli;Bacillales;Bacillaceae;Bacillus;Bacillus carboniphilus	0	0	2	0	0	0	0	0	2
Bacteria;Bacteria_none;Firmicutes;Bacilli;Bacillales;Paenibacillaceae;Paenibacillus;Paenibacillus ehimensis	0	2	0	0	0	0	0	0	2
Bacteria;Bacteria_none;Actinobacteria;Actinomycetia;Pseudonocardiales;Pseudonocardiaceae;Actinomycetospora;Actinomycetospora lutea	0	0	2	0	0	0	0	0	2
Bacteria;Bacteria_none;Firmicutes;Clostridia;Eubacteriales;Lachnospiraceae;Faecalicatena;Faecalicatena contorta	0	1	0	1	0	0	0	0	2
Bacteria;Bacteria_none;Actinobacteria;Actinomycetia;Corynebacteriales;Mycobacteriaceae;Mycobacterium;Mycobacterium cookii	0	1	0	0	0	1	0	0	2
Bacteria;Bacteria_none;Proteobacteria;Gammaproteobacteria;Oceanospirillales;Alcanivoracaceae;Alcanivorax;Alcanivorax pacificus	1	0	0	1	0	0	0	0	2
Bacteria;Bacteria_none;Actinobacteria;Actinomycetia;Micrococcales;Microbacteriaceae;Microbacterium;Microbacterium azadirachtae	0	0	0	2	0	0	0	0	2
Bacteria;Bacteria_none;Actinobacteria;Actinomycetia;Pseudonocardiales;Pseudonocardiaceae;Tamaricihabitans;Tamaricihabitans halophyticus	0	0	0	0	2	0	0	0	2
Bacteria;Bacteria_none;Firmicutes;Tissierellia;Tissierellales;Peptoniphilaceae;Peptoniphilus;Peptoniphilus catoniae	0	2	0	0	0	0	0	0	2
Bacteria;Bacteria_none;Firmicutes;Negativicutes;Veillonellales;Veillonellaceae;Dialister;Dialister propionicifaciens	1	0	0	0	0	0	1	0	2
Bacteria;Bacteria_none;Actinobacteria;Actinomycetia;Actinomycetales;Actinomycetaceae;Actinomyces;Actinomyces slackii	2	0	0	0	0	0	0	0	2
Bacteria;Bacteria_none;Firmicutes;Negativicutes;Selenomonadales;Sporomusaceae;Sporomusa;Sporomusa intestinalis	0	0	0	1	0	1	0	0	2
Bacteria;Bacteria_none;Firmicutes;Bacilli;Bacillales;Paenibacillaceae;Paenibacillus;Paenibacillus peoriae	0	0	0	2	0	0	0	0	2
Bacteria;Bacteria_none;Firmicutes;Bacilli;Bacillales;Planococcaceae;Ureibacillus;Ureibacillus defluvii	0	2	0	0	0	0	0	0	2
Bacteria;Bacteria_none;Firmicutes;Bacilli;Bacillales;Paenibacillaceae;Paenibacillus;Paenibacillus arachidis	0	0	2	0	0	0	0	0	2
Bacteria;Bacteria_none;Proteobacteria;Gammaproteobacteria;Chromatiales;Chromatiaceae;Thiospirillum;Thiospirillum jenense	0	0	0	2	0	0	0	0	2
Bacteria;Bacteria_none;Firmicutes;Bacilli;Bacillales;Bacillaceae;Lysinibacillus;Lysinibacillus odysseyi	0	1	1	0	0	0	0	0	2
Bacteria;Bacteria_none;Proteobacteria;Gammaproteobacteria;Acidiferrobacterales;Acidiferrobacteraceae;Sulfurifustis;Sulfurifustis variabilis	0	2	0	0	0	0	0	0	2
Bacteria;Bacteria_none;Firmicutes;Bacilli;Bacillales;Planococcaceae;Sporosarcina;Sporosarcina beigongshangi	1	0	0	0	0	0	0	1	2
Bacteria;Bacteria_none;Proteobacteria;Deltaproteobacteria;Desulfovibrionales;Desulfomicrobiaceae;Desulfomicrobium;Desulfomicrobium orale	1	0	1	0	0	0	0	0	2
Bacteria;Bacteria_none;Proteobacteria;Gammaproteobacteria;Methylococcales;Methylococcaceae;Methylomonas;Methylomonas rubra	1	0	0	1	0	0	0	0	2
Bacteria;Bacteria_none;Proteobacteria;Deltaproteobacteria;Desulfovibrionales;Desulfomicrobiaceae;Desulfoplanes;Desulfoplanes formicivorans	1	0	0	0	0	1	0	0	2
Bacteria;Bacteria_none;Proteobacteria;Gammaproteobacteria;Methylococcales;Methylococcaceae;Methylomonas;Methylomonas methanica	2	0	0	0	0	0	0	0	2
Bacteria;Bacteria_none;Proteobacteria;Epsilonproteobacteria;Nautiliales;Nitratiruptoraceae;Nitratiruptor;Nitratiruptor tergarcus	0	0	1	1	0	0	0	0	2
Bacteria;Bacteria_none;Firmicutes;Bacilli;Bacillales;Staphylococcaceae;Jeotgalicoccus;Jeotgalicoccus pinnipedialis	0	1	0	1	0	0	0	0	2
Bacteria;Bacteria_none;Firmicutes;Bacilli;Bacillales;Bacillaceae;Salinibacillus;Salinibacillus aidingensis	0	1	1	0	0	0	0	0	2
Bacteria;Bacteria_none;Actinobacteria;Actinomycetia;Cryptosporangiales;Cryptosporangiaceae;Cryptosporangium;Cryptosporangium aurantiacum	0	0	0	2	0	0	0	0	2
Bacteria;Bacteria_none;Proteobacteria;Epsilonproteobacteria;Campylobacterales;Thiovulaceae;Sulfurimonas;Sulfurimonas gotlandica	0	0	0	0	2	0	0	0	2
Bacteria;Bacteria_none;Actinobacteria;Actinomycetia;Corynebacteriales;Mycobacteriaceae;Mycolicibacterium;Mycolicibacterium alvei	0	0	0	0	0	0	0	2	2
Bacteria;Bacteria_none;Firmicutes;Clostridia;Eubacteriales;Proteinivoraceae;Alkalicella;Alkalicella caledoniensis	0	0	0	2	0	0	0	0	2
Bacteria;Bacteria_none;Actinobacteria;Actinomycetia;Streptosporangiales;Nocardiopsaceae;Streptomonospora;Streptomonospora nanhaiensis	0	0	0	2	0	0	0	0	2
Bacteria;Bacteria_none;Proteobacteria;Gammaproteobacteria;Methylococcales;Methylococcaceae;Methylococcus;Methylococcus thermophilus	0	0	2	0	0	0	0	0	2
Bacteria;Bacteria_none;Firmicutes;Bacilli;Bacillales;Bacillaceae;Lysinibacillus;Lysinibacillus xylanilyticus	0	0	0	0	0	0	2	0	2
Bacteria;Bacteria_none;Proteobacteria;Gammaproteobacteria;Methylococcales;Methylococcaceae;Methylococcus;Methylococcus capsulatus	2	0	0	0	0	0	0	0	2
Bacteria;Bacteria_none;Actinobacteria;Actinomycetia;Corynebacteriales;Mycobacteriaceae;Mycolicibacterium;Mycolicibacterium brisbanense	0	0	0	0	0	2	0	0	2
Bacteria;Bacteria_none;Actinobacteria;Actinomycetia;Streptomycetales;Streptomycetaceae;Streptomyces;Streptomyces flavovirens	0	0	0	0	0	0	2	0	2
Bacteria;Bacteria_none;Actinobacteria;Actinomycetia;Corynebacteriales;Tsukamurellaceae;Tsukamurella;Tsukamurella soli	0	2	0	0	0	0	0	0	2
Bacteria;Bacteria_none;Actinobacteria;Actinomycetia;Corynebacteriales;Segniliparaceae;Segniliparus;Segniliparus rugosus	0	0	2	0	0	0	0	0	2
Bacteria;Bacteria_none;Actinobacteria;Actinomycetia;Streptosporangiales;Nocardiopsaceae;Nocardiopsis;Nocardiopsis fildesensis	0	0	1	1	0	0	0	0	2
Bacteria;Bacteria_none;Firmicutes;Bacilli;Bacillales;Bacillaceae;Marinococcus;Marinococcus salis	0	0	0	0	0	2	0	0	2
Bacteria;Bacteria_none;Actinobacteria;Actinomycetia;Streptosporangiales;Nocardiopsaceae;Nocardiopsis;Nocardiopsis akesuensis	0	0	1	0	0	0	0	1	2
Bacteria;Bacteria_none;Proteobacteria;Deltaproteobacteria;Desulfovibrionales;Desulfohalobiaceae;Desulfonatronovibrio;Desulfonatronovibrio hydrogenovorans	1	1	0	0	0	0	0	0	2
Bacteria;Bacteria_none;Proteobacteria;Gammaproteobacteria;Aeromonadales;Aeromonadaceae;Aeromonas;Aeromonas lusitana	2	0	0	0	0	0	0	0	2
Bacteria;Bacteria_none;Firmicutes;Bacilli;Bacillales;Bacillaceae;Lysinibacillus;Lysinibacillus composti	2	0	0	0	0	0	0	0	2
Bacteria;Bacteria_none;Proteobacteria;Gammaproteobacteria;Aeromonadales;Succinivibrionaceae;Succinivibrio;Succinivibrio dextrinosolvens	0	0	0	2	0	0	0	0	2
Bacteria;Bacteria_none;Firmicutes;Bacilli;Bacillales;Bacillaceae;Virgibacillus;Virgibacillus proomii	0	1	0	1	0	0	0	0	2
Bacteria;Bacteria_none;Proteobacteria;Gammaproteobacteria;Alteromonadales;Alteromonadaceae;Marinifaba;Marinifaba aquimaris	0	2	0	0	0	0	0	0	2
Bacteria;Bacteria_none;Proteobacteria;Gammaproteobacteria;Alteromonadales;Alteromonadaceae;Alteromonas;Alteromonas stellipolaris	0	1	0	0	0	1	0	0	2
Bacteria;Bacteria_none;Proteobacteria;Deltaproteobacteria;Desulfobacterales;Desulfobacteraceae;Desulfococcus;Desulfococcus biacutus	0	2	0	0	0	0	0	0	2
Bacteria;Bacteria_none;Proteobacteria;Gammaproteobacteria;Alteromonadales;Alteromonadaceae;Alteromonas;Alteromonas gracilis	0	0	0	2	0	0	0	0	2
Bacteria;Bacteria_none;Firmicutes;Bacilli;Bacillales;Planococcaceae;Savagea;Savagea faecisuis	0	0	0	0	0	2	0	0	2
Bacteria;Bacteria_none;Proteobacteria;Deltaproteobacteria;Desulfobacterales;Desulfobacteraceae;Desulfoconvexum;Desulfoconvexum algidum	0	2	0	0	0	0	0	0	2
Bacteria;Bacteria_none;Proteobacteria;Deltaproteobacteria;Desulfobacterales;Desulfobacteraceae;Desulfofrigus;Desulfofrigus oceanense	0	2	0	0	0	0	0	0	2
Bacteria;Bacteria_none;Actinobacteria;Actinomycetia;Propionibacteriales;Nocardioidaceae;Aeromicrobium;Aeromicrobium terrae	0	0	0	1	0	1	0	0	2
Bacteria;Bacteria_none;Proteobacteria;Deltaproteobacteria;Desulfobacterales;Desulfobacteraceae;Desulfonema;Desulfonema magnum	0	0	0	2	0	0	0	0	2
Bacteria;Bacteria_none;Proteobacteria;Gammaproteobacteria;Alteromonadales;Alteromonadaceae;Agaribacter;Agaribacter flavus	0	0	0	2	0	0	0	0	2
Bacteria;Bacteria_none;Firmicutes;Clostridia;Eubacteriales;Vallitaleaceae;Vallitalea;Vallitalea okinawensis	1	0	1	0	0	0	0	0	2
Bacteria;Bacteria_none;Actinobacteria;Actinomycetia;Propionibacteriales;Nocardioidaceae;Nocardioides;Nocardioides suum	0	1	1	0	0	0	0	0	2
Bacteria;Bacteria_none;Proteobacteria;Gammaproteobacteria;Enterobacterales;Yersiniaceae;Serratia;Serratia rhizosphaerae	0	0	0	0	0	0	0	2	2
Bacteria;Bacteria_none;Actinobacteria;Actinomycetia;Actinomycetales;Actinomycetaceae;Actinomyces;Actinomyces glycerinitolerans	0	0	0	0	2	0	0	0	2
Bacteria;Bacteria_none;Bacteroidota;Flavobacteriia;Flavobacteriales;Weeksellaceae;Chryseobacterium;Chryseobacterium formosus	1	1	0	0	0	0	0	0	2
Bacteria;Bacteria_none;Actinobacteria;Actinomycetia;Propionibacteriales;Nocardioidaceae;Marmoricola;Marmoricola aequoreus	1	1	0	0	0	0	0	0	2
Bacteria;Bacteria_none;Firmicutes;Bacilli;Bacillales;Staphylococcaceae;Nosocomiicoccus;Nosocomiicoccus massiliensis	0	0	2	0	0	0	0	0	2
Bacteria;Bacteria_none;Actinobacteria;Actinomycetia;Streptosporangiales;Streptosporangiaceae;Nonomuraea;Nonomuraea ferruginea	1	1	0	0	0	0	0	0	2
Bacteria;Bacteria_none;Proteobacteria;Deltaproteobacteria;Desulfobacterales;Desulfocapsaceae;Desulfopila;Desulfopila aestuarii	0	1	0	1	0	0	0	0	2
Bacteria;Bacteria_none;Firmicutes;Bacilli;Bacillales;Bacillaceae;Thermolongibacillus;Thermolongibacillus altinsuensis	0	1	0	1	0	0	0	0	2
Bacteria;Bacteria_none;Proteobacteria;Deltaproteobacteria;Desulfobacterales;Desulfofabaceae;Desulfofaba;Desulfofaba gelida	1	0	0	1	0	0	0	0	2
Bacteria;Bacteria_none;Proteobacteria;Gammaproteobacteria;Methylococcales;Methylococcaceae;Methylovulum;Methylovulum psychrotolerans	1	0	0	1	0	0	0	0	2
Bacteria;Bacteria_none;Actinobacteria;Actinomycetia;Propionibacteriales;Nocardioidaceae;Marmoricola;Marmoricola korecus	0	1	0	0	0	1	0	0	2
Bacteria;Bacteria_none;Proteobacteria;Gammaproteobacteria;Methylococcales;Methylococcaceae;Methylobacter;Methylobacter psychrophilus	0	1	0	1	0	0	0	0	2
Bacteria;Bacteria_none;Actinobacteria;Actinomycetia;Streptomycetales;Streptomycetaceae;Streptomyces;Streptomyces heilongjiangensis	0	0	2	0	0	0	0	0	2
Bacteria;Bacteria_none;Actinobacteria;Actinomycetia;Streptosporangiales;Nocardiopsaceae;Haloactinospora;Haloactinospora alba	0	0	0	1	0	0	1	0	2
Bacteria;Bacteria_none;Actinobacteria;Actinomycetia;Propionibacteriales;Nocardioidaceae;Nocardioides;Nocardioides daphniae	0	0	1	1	0	0	0	0	2
Bacteria;Bacteria_none;Actinobacteria;Actinomycetia;Streptomycetales;Streptomycetaceae;Streptomyces;Streptomyces nigra	0	1	0	1	0	0	0	0	2
Bacteria;Bacteria_none;Proteobacteria;Gammaproteobacteria;Legionellales;Legionellaceae;Legionella;Legionella busanensis	0	0	0	2	0	0	0	0	2
Bacteria;Bacteria_none;Firmicutes;Bacilli;Bacillales;Bacillaceae;Peribacillus;Peribacillus huizhouensis	0	0	0	2	0	0	0	0	2
Bacteria;Bacteria_none;Firmicutes;Bacilli;Bacillales;Bacillaceae;Peribacillus;Peribacillus cavernae	2	0	0	0	0	0	0	0	2
Bacteria;Bacteria_none;Proteobacteria;Deltaproteobacteria;Desulfurellales;Desulfurellaceae;Hippea;Hippea alviniae	0	2	0	0	0	0	0	0	2
Bacteria;Bacteria_none;Proteobacteria;Gammaproteobacteria;Legionellales;Legionellaceae;Legionella;Legionella rowbothamii	0	0	0	1	0	0	1	0	2
Bacteria;Bacteria_none;Actinobacteria;Actinomycetia;Propionibacteriales;Nocardioidaceae;Nocardioides;Nocardioides jensenii	0	0	0	2	0	0	0	0	2
Bacteria;Bacteria_none;Actinobacteria;Actinomycetia;Corynebacteriales;Nocardiaceae;Nocardia;Nocardia tengchongensis	1	0	0	0	0	0	0	1	2
Bacteria;Bacteria_none;Actinobacteria;Actinomycetia;Propionibacteriales;Nocardioidaceae;Nocardioides;Nocardioides conyzicola	1	1	0	0	0	0	0	0	2
Bacteria;Bacteria_none;Firmicutes;Bacilli;Bacillales;Bacillaceae;Parageobacillus;Parageobacillus yumthangensis	0	1	1	0	0	0	0	0	2
Bacteria;Bacteria_none;Proteobacteria;Deltaproteobacteria;Myxococcales;Polyangiaceae;Chondromyces;Chondromyces crocatus	2	0	0	0	0	0	0	0	2
Bacteria;Bacteria_none;Firmicutes;Bacilli;Bacillales;Planococcaceae;Sporosarcina;Sporosarcina ureae	1	0	1	0	0	0	0	0	2
Bacteria;Bacteria_none;Firmicutes;Bacilli;Bacillales;Planococcaceae;Sporosarcina;Sporosarcina siberiensis	0	0	0	1	0	0	0	1	2
Bacteria;Bacteria_none;Firmicutes;Bacilli;Bacillales;Planococcaceae;Ureibacillus;Ureibacillus xyleni	0	1	0	1	0	0	0	0	2
Bacteria;Bacteria_none;Actinobacteria;Actinomycetia;Corynebacteriales;Nocardiaceae;Nocardia;Nocardia fluminea	0	1	1	0	0	0	0	0	2
Bacteria;Bacteria_none;Actinobacteria;Actinomycetia;Corynebacteriales;Mycobacteriaceae;Mycolicibacterium;Mycolicibacterium sarraceniae	1	0	1	0	0	0	0	0	2
Bacteria;Bacteria_none;Actinobacteria;Actinomycetia;Streptomycetales;Streptomycetaceae;Streptomyces;Streptomyces sclerotialus	0	0	0	2	0	0	0	0	2
Bacteria;Bacteria_none;Proteobacteria;Deltaproteobacteria;Myxococcales;Myxococcaceae;Pyxidicoccus;Pyxidicoccus fallax	0	0	0	0	1	0	1	0	2
Bacteria;Bacteria_none;Firmicutes;Bacilli;Bacillales;Bacillaceae;Oceanobacillus;Oceanobacillus halotolerans	0	0	1	0	0	0	0	1	2
Bacteria;Bacteria_none;Firmicutes;Bacilli;Bacillales;Bacillaceae;Oceanobacillus;Oceanobacillus picturae	0	0	2	0	0	0	0	0	2
Bacteria;Bacteria_none;Proteobacteria;Deltaproteobacteria;Desulfuromonadales;Syntrophotaleaceae;Syntrophotalea;Syntrophotalea acetylenica	0	1	1	0	0	0	0	0	2
Bacteria;Bacteria_none;Proteobacteria;Deltaproteobacteria;Myxococcales;Archangiaceae;Archangium;Archangium disciforme	2	0	0	0	0	0	0	0	2
Bacteria;Bacteria_none;Actinobacteria;Actinomycetia;Corynebacteriales;Nocardiaceae;Nocardia;Nocardia bovistercoris	0	0	2	0	0	0	0	0	2
Bacteria;Bacteria_none;Firmicutes;Bacilli;Bacillales;Bacillaceae;Oceanobacillus;Oceanobacillus massiliensis	1	0	0	1	0	0	0	0	2
Bacteria;Bacteria_none;Proteobacteria;Gammaproteobacteria;Legionellales;Legionellaceae;Legionella;Legionella brunensis	0	1	0	1	0	0	0	0	2
Bacteria;Bacteria_none;Actinobacteria;Actinomycetia;Corynebacteriales;Nocardiaceae;Prescottella;Prescottella agglutinans	0	0	0	0	2	0	0	0	2
Bacteria;Bacteria_none;Firmicutes;Bacilli;Bacillales;Bacillaceae;Salibacterium;Salibacterium nitratireducens	0	0	2	0	0	0	0	0	2
Bacteria;Bacteria_none;Actinobacteria;Actinomycetia;Corynebacteriales;Mycobacteriaceae;Mycolicibacterium;Mycolicibacterium novocastrense	0	2	0	0	0	0	0	0	2
Bacteria;Bacteria_none;Actinobacteria;Actinomycetia;Corynebacteriales;Nocardiaceae;Williamsia;Williamsia soli	0	2	0	0	0	0	0	0	2
Bacteria;Bacteria_none;Proteobacteria;Epsilonproteobacteria;Campylobacterales;Campylobacteraceae;Campylobacter;Campylobacter portucalensis	0	0	0	0	2	0	0	0	2
Bacteria;Bacteria_none;Firmicutes;Clostridia;Eubacteriales;Peptostreptococcaceae;Peptostreptococcus;Peptostreptococcus canis	0	0	0	2	0	0	0	0	2
Bacteria;Bacteria_none;Proteobacteria;Epsilonproteobacteria;Campylobacterales;Campylobacteraceae;Campylobacter;Campylobacter hominis	0	2	0	0	0	0	0	0	2
Bacteria;Bacteria_none;Proteobacteria;Gammaproteobacteria;Legionellales;Legionellaceae;Legionella;Legionella waltersii	0	0	1	1	0	0	0	0	2
Bacteria;Bacteria_none;Firmicutes;Bacilli;Bacillales;Planococcaceae;Sporosarcina;Sporosarcina newyorkensis	1	1	0	0	0	0	0	0	2
Bacteria;Bacteria_none;Proteobacteria;Epsilonproteobacteria;Campylobacterales;Arcobacteraceae;Malaciobacter;Malaciobacter pacificus	0	0	2	0	0	0	0	0	2
Bacteria;Bacteria_none;Actinobacteria;Actinomycetia;Propionibacteriales;Nocardioidaceae;Nocardioides;Nocardioides phosphati	1	0	0	0	0	0	1	0	2
Bacteria;Bacteria_none;Proteobacteria;Epsilonproteobacteria;Campylobacterales;Arcobacteraceae;Malaciobacter;Malaciobacter canalis	0	0	2	0	0	0	0	0	2
Bacteria;Bacteria_none;Proteobacteria;Epsilonproteobacteria;Campylobacterales;Arcobacteraceae;Arcobacter;Arcobacter venerupis	0	0	0	0	0	0	0	2	2
Bacteria;Bacteria_none;Firmicutes;Bacilli;Bacillales;Bacillaceae;Metabacillus;Metabacillus bambusae	0	0	1	1	0	0	0	0	2
Bacteria;Bacteria_none;Actinobacteria;Actinomycetia;Propionibacteriales;Nocardioidaceae;Nocardioides;Nocardioides perillae	1	1	0	0	0	0	0	0	2
Bacteria;Bacteria_none;Firmicutes;Bacilli;Bacillales;Bacillaceae;Pseudoneobacillus;Pseudoneobacillus rhizosphaerae	0	0	2	0	0	0	0	0	2
Bacteria;Bacteria_none;Actinobacteria;Actinomycetia;Micrococcales;Cellulomonadaceae;Cellulomonas;Cellulomonas flavigena	0	2	0	0	0	0	0	0	2
Bacteria;Bacteria_none;Firmicutes;Bacilli;Bacillales;Bacillaceae;Metabacillus;Metabacillus halosaccharovorans	0	0	2	0	0	0	0	0	2
Bacteria;Bacteria_none;Proteobacteria;Epsilonproteobacteria;Campylobacterales;Arcobacteraceae;Aliarcobacter;Aliarcobacter trophiarum	0	0	0	1	0	0	0	1	2
Bacteria;Bacteria_none;Actinobacteria;Actinomycetia;Streptomycetales;Streptomycetaceae;Streptomyces;Streptomyces libani	0	0	0	1	0	1	0	0	2
Bacteria;Bacteria_none;Actinobacteria;Actinomycetia;Streptomycetales;Streptomycetaceae;Streptomyces;Streptomyces litoralis	0	0	1	1	0	0	0	0	2
Bacteria;Bacteria_none;Actinobacteria;Actinomycetia;Streptomycetales;Streptomycetaceae;Streptomyces;Streptomyces termitum	0	1	0	0	0	0	0	1	2
Bacteria;Bacteria_none;Actinobacteria;Actinomycetia;Streptomycetales;Streptomycetaceae;Streptomyces;Streptomyces longispororuber	0	2	0	0	0	0	0	0	2
Bacteria;Bacteria_none;Actinobacteria;Actinomycetia;Corynebacteriales;Nocardiaceae;Rhodococcus;Rhodococcus humicola	1	1	0	0	0	0	0	0	2
Bacteria;Bacteria_none;Actinobacteria;Actinomycetia;Streptomycetales;Streptomycetaceae;Streptomyces;Streptomyces lucensis	0	1	0	1	0	0	0	0	2
Bacteria;Bacteria_none;Firmicutes;Bacilli;Bacillales;Bacillaceae;Neobacillus;Neobacillus massiliamazoniensis	0	0	1	1	0	0	0	0	2
Bacteria;Bacteria_none;Firmicutes;Bacilli;Bacillales;Staphylococcaceae;Corticicoccus;Corticicoccus populi	0	0	0	0	0	1	1	0	2
Bacteria;Bacteria_none;Proteobacteria;Deltaproteobacteria;Desulfobacterales;Desulfobacteraceae;Desulfobacula;Desulfobacula toluolica	0	0	0	0	2	0	0	0	2
Bacteria;Bacteria_none;Proteobacteria;Gammaproteobacteria;Alteromonadales;Alteromonadaceae;Saccharobesus;Saccharobesus litoralis	1	1	0	0	0	0	0	0	2
Bacteria;Bacteria_none;Proteobacteria;Gammaproteobacteria;Alteromonadales;Alteromonadaceae;Salinimonas;Salinimonas marina	1	0	1	0	0	0	0	0	2
Bacteria;Bacteria_none;Firmicutes;Bacilli;Bacillales;Staphylococcaceae;Staphylococcus;Staphylococcus simiae	0	0	0	0	0	0	2	0	2
Bacteria;Bacteria_none;Proteobacteria;Betaproteobacteria;Nitrosomonadales;Nitrosomonadaceae;Nitrosomonas;Nitrosomonas marina	1	1	0	0	0	0	0	0	2
Bacteria;Bacteria_none;Firmicutes;Bacilli;Bacillales;Thermoactinomycetaceae;Marinithermofilum;Marinithermofilum abyssi	0	0	1	0	0	1	0	0	2
Bacteria;Bacteria_none;Firmicutes;Bacilli;Bacillales;Thermoactinomycetaceae;Laceyella;Laceyella putida	0	0	2	0	0	0	0	0	2
Bacteria;Bacteria_none;Firmicutes;Bacilli;Bacillales;Paenibacillaceae;Paenibacillus;Paenibacillus tianmuensis	0	0	0	2	0	0	0	0	2
Bacteria;Bacteria_none;Proteobacteria;Betaproteobacteria;Nitrosomonadales;Nitrosomonadaceae;Nitrosospira;Nitrosospira tenuis	2	0	0	0	0	0	0	0	2
Bacteria;Bacteria_none;Firmicutes;Erysipelotrichia;Erysipelotrichales;Erysipelotrichaceae;Erysipelatoclostridium;Erysipelatoclostridium ramosum	2	0	0	0	0	0	0	0	2
Bacteria;Bacteria_none;Actinobacteria;Coriobacteriia;Coriobacteriales;Atopobiaceae;Olsenella;Olsenella intestinalis	1	0	0	0	1	0	0	0	2
Bacteria;Bacteria_none;Actinobacteria;Coriobacteriia;Coriobacteriales;Atopobiaceae;Atopobium;Atopobium massiliense	0	0	0	0	0	1	0	1	2
Bacteria;Bacteria_none;Firmicutes;Erysipelotrichia;Erysipelotrichales;Erysipelotrichaceae;Catenisphaera;Catenisphaera adipataccumulans	1	0	1	0	0	0	0	0	2
Bacteria;Bacteria_none;Proteobacteria;Betaproteobacteria;Nitrosomonadales;Sterolibacteriaceae;Sterolibacterium;Sterolibacterium denitrificans	2	0	0	0	0	0	0	0	2
Bacteria;Bacteria_none;Actinobacteria;Actinomycetia;Actinomycetales;Actinomycetaceae;Actinomyces;Actinomyces naeslundii	0	2	0	0	0	0	0	0	2
Bacteria;Bacteria_none;Firmicutes;Erysipelotrichia;Erysipelotrichales;Erysipelotrichaceae;Breznakia;Breznakia blatticola	0	0	1	0	0	0	1	0	2
Bacteria;Bacteria_none;Proteobacteria;Gammaproteobacteria;Chromatiales;Chromatiaceae;Lamprocystis;Lamprocystis purpurea	0	0	0	2	0	0	0	0	2
Bacteria;Bacteria_none;Actinobacteria;Actinomycetia;Streptosporangiales;Thermomonosporaceae;Thermostaphylospora;Thermostaphylospora chromogena	0	1	0	1	0	0	0	0	2
Bacteria;Bacteria_none;Proteobacteria;Gammaproteobacteria;Moraxellales;Moraxellaceae;Acinetobacter;Acinetobacter schindleri	2	0	0	0	0	0	0	0	2
Bacteria;Bacteria_none;Firmicutes;Desulfuribacillia;Desulfuribacillales;Desulfuribacillaceae;Desulfuribacillus;Desulfuribacillus stibiiarsenatis	0	0	2	0	0	0	0	0	2
Bacteria;Bacteria_none;Actinobacteria;Actinomycetia;Glycomycetales;Glycomycetaceae;Stackebrandtia;Stackebrandtia albiflava	1	0	0	0	0	1	0	0	2
Bacteria;Bacteria_none;Firmicutes;Clostridia;Thermosediminibacterales;Thermosediminibacteraceae;Thermovenabulum;Thermovenabulum ferriorganovorum	1	0	0	0	0	0	1	0	2
Bacteria;Bacteria_none;Firmicutes;Bacilli;Bacillales;Paenibacillaceae;Cohnella;Cohnella collisoli	1	0	0	0	1	0	0	0	2
Bacteria;Bacteria_none;Actinobacteria;Actinomycetia;Propionibacteriales;Kribbellaceae;Kribbella;Kribbella koreensis	0	0	0	2	0	0	0	0	2
Bacteria;Bacteria_none;Proteobacteria;Gammaproteobacteria;Enterobacterales;Morganellaceae;Xenorhabdus;Xenorhabdus koppenhoeferi	2	0	0	0	0	0	0	0	2
Bacteria;Bacteria_none;Firmicutes;Bacilli;Bacillales;Staphylococcaceae;Staphylococcus;Staphylococcus pseudintermedius	2	0	0	0	0	0	0	0	2
Bacteria;Bacteria_none;Actinobacteria;Actinomycetia;Streptosporangiales;Thermomonosporaceae;Actinomadura;Actinomadura napierensis	0	0	2	0	0	0	0	0	2
Bacteria;Bacteria_none;Actinobacteria;Actinomycetia;Streptosporangiales;Thermomonosporaceae;Actinomadura;Actinomadura namibiensis	0	0	1	1	0	0	0	0	2
Bacteria;Bacteria_none;Firmicutes;Erysipelotrichia;Erysipelotrichales;Erysipelotrichaceae;Erysipelothrix;Erysipelothrix larvae	0	0	2	0	0	0	0	0	2
Bacteria;Bacteria_none;Firmicutes;Erysipelotrichia;Erysipelotrichales;Erysipelotrichaceae;Faecalibacillus;Faecalibacillus faecis	2	0	0	0	0	0	0	0	2
Bacteria;Bacteria_none;Actinobacteria;Actinomycetia;Propionibacteriales;Kribbellaceae;Kribbella;Kribbella pittospori	0	0	1	1	0	0	0	0	2
Bacteria;Bacteria_none;Firmicutes;Bacilli;Bacillales;Paenibacillaceae;Paenibacillus;Paenibacillus albicereus	0	0	1	0	0	1	0	0	2
Bacteria;Bacteria_none;Proteobacteria;Gammaproteobacteria;Moraxellales;Moraxellaceae;Moraxella;Moraxella porci	2	0	0	0	0	0	0	0	2
Bacteria;Bacteria_none;Actinobacteria;Coriobacteriia;Eggerthellales;Eggerthellaceae;Adlercreutzia;Adlercreutzia hattorii	2	0	0	0	0	0	0	0	2
Bacteria;Bacteria_none;Firmicutes;Bacilli;Bacillales;Paenibacillaceae;Paenibacillus;Paenibacillus alvei	0	2	0	0	0	0	0	0	2
Bacteria;Bacteria_none;Firmicutes;Clostridia;Eubacteriales;Lachnospiraceae;Mediterraneibacter;Mediterraneibacter butyricigenes	1	0	0	1	0	0	0	0	2
Bacteria;Bacteria_none;Proteobacteria;Gammaproteobacteria;Chromatiales;Chromatiaceae;Thiorhodococcus;Thiorhodococcus kakinadensis	0	0	0	2	0	0	0	0	2
Bacteria;Bacteria_none;Proteobacteria;Gammaproteobacteria;Chromatiales;Chromatiaceae;Thiophaeococcus;Thiophaeococcus mangrovi	0	0	1	0	1	0	0	0	2
Bacteria;Bacteria_none;Firmicutes;Erysipelotrichia;Erysipelotrichales;Erysipelotrichaceae;Massilimicrobiota;Massilimicrobiota timonensis	0	0	0	0	0	0	0	2	2
Bacteria;Bacteria_none;Proteobacteria;Betaproteobacteria;Neisseriales;Neisseriaceae;Neisseria;Neisseria weaveri	1	0	0	1	0	0	0	0	2
Bacteria;Bacteria_none;Actinobacteria;Coriobacteriia;Coriobacteriales;Coriobacteriaceae;Olegusella;Olegusella massiliensis	1	0	0	0	0	0	1	0	2
Bacteria;Bacteria_none;Actinobacteria;Actinomycetia;Streptomycetales;Streptomycetaceae;Streptacidiphilus;Streptacidiphilus albus	0	1	0	1	0	0	0	0	2
Bacteria;Bacteria_none;Proteobacteria;Betaproteobacteria;Neisseriales;Neisseriaceae;Snodgrassella;Snodgrassella gandavensis	0	0	0	0	0	2	0	0	2
Bacteria;Bacteria_none;Firmicutes;Bacilli;Bacillales;Bacillaceae;Caldibacillus;Caldibacillus lycopersici	0	0	1	0	0	0	0	1	2
Bacteria;Bacteria_none;Actinobacteria;Coriobacteriia;Coriobacteriales;Atopobiaceae;Tractidigestivibacter;Tractidigestivibacter scatoligenes	0	0	0	1	0	0	0	1	2
Bacteria;Bacteria_none;Firmicutes;Bacilli;Bacillales;Paenibacillaceae;Paenibacillus;Paenibacillus thiaminolyticus	0	0	0	0	0	2	0	0	2
Bacteria;Bacteria_none;Firmicutes;Clostridia;Eubacteriales;Heliobacteriaceae;Heliomicrobium;[Heliobacterium] sulfidophilum	0	0	0	0	1	1	0	0	2
Bacteria;Bacteria_none;Firmicutes;Erysipelotrichia;Erysipelotrichales;Erysipelotrichaceae;Intestinibaculum;Intestinibaculum porci	0	0	1	0	1	0	0	0	2
Bacteria;Bacteria_none;Proteobacteria;Betaproteobacteria;Neisseriales;Neisseriaceae;Uruburuella;Uruburuella testudinis	2	0	0	0	0	0	0	0	2
Bacteria;Bacteria_none;Firmicutes;Bacilli;Bacillales;Paenibacillaceae;Oxalophagus;Oxalophagus oxalicus	0	0	0	2	0	0	0	0	2
Bacteria;Bacteria_none;Proteobacteria;Betaproteobacteria;Nitrosomonadales;Gallionellaceae;Sideroxyarcus;Sideroxyarcus emersonii	2	0	0	0	0	0	0	0	2
Bacteria;Bacteria_none;Firmicutes;Bacilli;Bacillales;Paenibacillaceae;Cohnella;Cohnella terricola	0	0	2	0	0	0	0	0	2
Bacteria;Bacteria_none;Firmicutes;Bacilli;Bacillales;Bacillaceae;Calidifontibacillus;Calidifontibacillus oryziterrae	1	0	1	0	0	0	0	0	2
Bacteria;Bacteria_none;Firmicutes;Bacilli;Bacillales;Bacillaceae;Cerasibacillus;Cerasibacillus quisquiliarum	0	2	0	0	0	0	0	0	2
Bacteria;Bacteria_none;Firmicutes;Bacilli;Bacillales;Paenibacillaceae;Cohnella;Cohnella humi	0	0	2	0	0	0	0	0	2
Bacteria;Bacteria_none;Proteobacteria;Gammaproteobacteria;Enterobacterales;Morganellaceae;Xenorhabdus;Xenorhabdus beddingii	2	0	0	0	0	0	0	0	2
Bacteria;Bacteria_none;Firmicutes;Bacilli;Bacillales;Paenibacillaceae;Brevibacillus;Brevibacillus fulvus	2	0	0	0	0	0	0	0	2
Bacteria;Bacteria_none;Actinobacteria;Actinomycetia;Micrococcales;Beutenbergiaceae;Serinibacter;Serinibacter arcticus	1	1	0	0	0	0	0	0	2
Bacteria;Bacteria_none;Firmicutes;Clostridia;Halanaerobiales;Halobacteroidaceae;Fuchsiella;Fuchsiella ferrireducens	0	0	1	0	1	0	0	0	2
Bacteria;Bacteria_none;Actinobacteria;Actinomycetia;Streptomycetales;Streptomycetaceae;Streptomyces;Streptomyces capparidis	0	1	0	1	0	0	0	0	2
Bacteria;Bacteria_none;Actinobacteria;Actinomycetia;Streptosporangiales;Streptosporangiaceae;Streptosporangium;Streptosporangium violaceochromogenes	0	0	0	1	0	0	0	1	2
Bacteria;Bacteria_none;Proteobacteria;Gammaproteobacteria;Enterobacterales;Pectobacteriaceae;Pectobacterium;Pectobacterium wasabiae	2	0	0	0	0	0	0	0	2
Bacteria;Bacteria_none;Proteobacteria;Gammaproteobacteria;Enterobacterales;Pectobacteriaceae;Pectobacterium;Pectobacterium zantedeschiae	1	0	0	0	0	0	1	0	2
Bacteria;Bacteria_none;Actinobacteria;Actinomycetia;Micrococcales;Kytococcaceae;Kytococcus;Kytococcus sedentarius	0	2	0	0	0	0	0	0	2
Bacteria;Bacteria_none;Firmicutes;Clostridia;Natranaerobiales;Natranaerobiaceae;Natranaerobius;Natranaerobius trueperi	0	1	0	0	1	0	0	0	2
Bacteria;Bacteria_none;Firmicutes;Bacilli;Bacillales;Bacillales Family X. Incertae Sedis;Hydrogenibacillus;Hydrogenibacillus schlegelii	0	1	1	0	0	0	0	0	2
Bacteria;Bacteria_none;Actinobacteria;Actinomycetia;Micrococcales;Brevibacteriaceae;Brevibacterium;Brevibacterium limosum	1	1	0	0	0	0	0	0	2
Bacteria;Bacteria_none;Firmicutes;Clostridia;Halanaerobiales;Halobacteroidaceae;Orenia;Orenia metallireducens	0	0	1	0	0	0	1	0	2
Bacteria;Bacteria_none;Firmicutes;Bacilli;Bacillales;Bacillaceae;Halolactibacillus;Halolactibacillus alkaliphilus	0	1	1	0	0	0	0	0	2
Bacteria;Bacteria_none;Firmicutes;Clostridia;Eubacteriales;Desulfitobacteriaceae;Desulfosporosinus;Desulfosporosinus burensis	2	0	0	0	0	0	0	0	2
Bacteria;Bacteria_none;Actinobacteria;Actinomycetia;Actinomycetales;Actinomycetaceae;Actinomyces;Actinomyces howellii	2	0	0	0	0	0	0	0	2
Bacteria;Bacteria_none;Proteobacteria;Gammaproteobacteria;Alteromonadales;Idiomarinaceae;Pseudidiomarina;Pseudidiomarina indica	0	0	0	2	0	0	0	0	2
Bacteria;Bacteria_none;Proteobacteria;Gammaproteobacteria;Enterobacterales;Pectobacteriaceae;Pectobacterium;Pectobacterium peruviense	2	0	0	0	0	0	0	0	2
Bacteria;Bacteria_none;Proteobacteria;Gammaproteobacteria;Alteromonadales;Idiomarinaceae;Idiomarina;Idiomarina ramblicola	0	2	0	0	0	0	0	0	2
Bacteria;Bacteria_none;Proteobacteria;Gammaproteobacteria;Alteromonadales;Idiomarinaceae;Idiomarina;Idiomarina andamanensis	2	0	0	0	0	0	0	0	2
Bacteria;Bacteria_none;Firmicutes;Bacilli;Bacillales;Bacillaceae;Virgibacillus;Virgibacillus soli	1	0	0	0	0	1	0	0	2
Bacteria;Bacteria_none;Actinobacteria;Actinomycetia;Streptosporangiales;Streptosporangiaceae;Streptosporangium;Streptosporangium jiaoheense	0	0	0	0	2	0	0	0	2
Bacteria;Bacteria_none;Proteobacteria;Deltaproteobacteria;Desulfarculales;Desulfarculaceae;Desulfarculus;Desulfarculus baarsii	0	1	0	0	1	0	0	0	2
Bacteria;Bacteria_none;Actinobacteria;Actinomycetia;Streptosporangiales;Streptosporangiaceae;Streptosporangium;Streptosporangium album	0	0	0	2	0	0	0	0	2
Bacteria;Bacteria_none;Proteobacteria;Gammaproteobacteria;Alteromonadales;Idiomarinaceae;Aliidiomarina;Aliidiomarina minuta	1	1	0	0	0	0	0	0	2
Bacteria;Bacteria_none;Proteobacteria;Deltaproteobacteria;Desulfobacterales;Desulfobacteraceae;Desulfatiferula;Desulfatiferula berrensis	0	1	0	0	1	0	0	0	2
Bacteria;Bacteria_none;Firmicutes;Clostridia;Halanaerobiales;Halobacteroidaceae;Halanaerobacter;Halanaerobacter jeridensis	1	0	0	0	0	1	0	0	2
Bacteria;Bacteria_none;Proteobacteria;Gammaproteobacteria;Alteromonadales;Colwelliaceae;Thalassotalea;Thalassotalea coralli	0	1	1	0	0	0	0	0	2
Bacteria;Bacteria_none;Proteobacteria;Gammaproteobacteria;Alteromonadales;Colwelliaceae;Colwellia;Colwellia rossensis	0	0	0	2	0	0	0	0	2
Bacteria;Bacteria_none;Actinobacteria;Actinomycetia;Corynebacteriales;Mycobacteriaceae;Mycobacterium;Mycobacterium ulcerans	0	0	2	0	0	0	0	0	2
Bacteria;Bacteria_none;Actinobacteria;Actinomycetia;Streptosporangiales;Thermomonosporaceae;Actinomadura;Actinomadura atramentaria	0	2	0	0	0	0	0	0	2
Bacteria;Bacteria_none;Firmicutes;Clostridia;Eubacteriales;Desulfallaceae;Desulfotruncus;Desulfotruncus arcticus	0	1	0	0	0	1	0	0	2
Bacteria;Bacteria_none;Proteobacteria;Gammaproteobacteria;Enterobacterales;Pectobacteriaceae;Dickeya;Dickeya fangzhongdai	2	0	0	0	0	0	0	0	2
Bacteria;Bacteria_none;Actinobacteria;Actinomycetia;Micrococcales;Bogoriellaceae;Bogoriella;Bogoriella caseilytica	0	0	1	0	1	0	0	0	2
Bacteria;Bacteria_none;Proteobacteria;Gammaproteobacteria;Cellvibrionales;Halieaceae;Kineobactrum;Kineobactrum sediminis	0	0	0	0	0	0	0	2	2
Bacteria;Bacteria_none;Firmicutes;Bacilli;Bacillales;Paenibacillaceae;Paenibacillus;Paenibacillus xanthanilyticus	0	0	2	0	0	0	0	0	2
Bacteria;Bacteria_none;Firmicutes;Bacilli;Bacillales;Paenibacillaceae;Aneurinibacillus;Aneurinibacillus migulanus	1	0	1	0	0	0	0	0	2
Bacteria;Bacteria_none;Firmicutes;Bacilli;Bacillales;Staphylococcaceae;Staphylococcus;Staphylococcus haemolyticus	0	0	2	0	0	0	0	0	2
Bacteria;Bacteria_none;Firmicutes;Bacilli;Bacillales;Bacillaceae;Fictibacillus;Fictibacillus enclensis	0	0	1	1	0	0	0	0	2
Bacteria;Bacteria_none;Proteobacteria;Gammaproteobacteria;Enterobacterales;Pectobacteriaceae;Brenneria;Brenneria populi Li et al. 2015	1	0	0	1	0	0	0	0	2
Bacteria;Bacteria_none;Firmicutes;Clostridia;Eubacteriales;Lachnospiraceae;Sellimonas;Sellimonas intestinalis	2	0	0	0	0	0	0	0	2
Bacteria;Bacteria_none;Firmicutes;Bacilli;Bacillales;Bacillaceae;Fredinandcohnia;Fredinandcohnia aciditolerans	1	1	0	0	0	0	0	0	2
Bacteria;Bacteria_none;Firmicutes;Bacilli;Bacillales;Paenibacillaceae;Saccharibacillus;Saccharibacillus alkalitolerans	0	1	0	0	0	1	0	0	2
Bacteria;Bacteria_none;Firmicutes;Clostridia;Thermoanaerobacterales;Thermoanaerobacteraceae;Thermoanaerobacter;Thermoanaerobacter sulfurigignens	0	0	2	0	0	0	0	0	2
Bacteria;Bacteria_none;Firmicutes;Bacilli;Bacillales;Bacillaceae;Fredinandcohnia;Fredinandcohnia humi	0	0	0	2	0	0	0	0	2
Bacteria;Bacteria_none;Firmicutes;Clostridia;Eubacteriales;Desulfitobacteriaceae;Desulfitobacterium;Desulfitobacterium hafniense	0	1	1	0	0	0	0	0	2
Bacteria;Bacteria_none;Actinobacteria;Actinomycetia;Streptosporangiales;Thermomonosporaceae;Actinomadura;Actinomadura chokoriensis	0	1	1	0	0	0	0	0	2
Bacteria;Bacteria_none;Actinobacteria;Actinomycetia;Streptosporangiales;Thermomonosporaceae;Actinomadura;Actinomadura catellatispora	0	2	0	0	0	0	0	0	2
Bacteria;Bacteria_none;Proteobacteria;Gammaproteobacteria;Alteromonadales;Shewanellaceae;Shewanella;Shewanella sedimentimangrovi	1	0	0	1	0	0	0	0	2
Bacteria;Bacteria_none;Firmicutes;Bacilli;Bacillales;Staphylococcaceae;Staphylococcus;Staphylococcus equorum	0	0	0	0	2	0	0	0	2
Bacteria;Bacteria_none;Proteobacteria;Gammaproteobacteria;Alteromonadales;Shewanellaceae;Shewanella;Shewanella psychrophila	0	1	1	0	0	0	0	0	2
Bacteria;Bacteria_none;Proteobacteria;Gammaproteobacteria;Alteromonadales;Shewanellaceae;Shewanella;Shewanella piezotolerans	2	0	0	0	0	0	0	0	2
Bacteria;Bacteria_none;Proteobacteria;Betaproteobacteria;Rhodocyclales;Zoogloeaceae;Parazoarcus;Parazoarcus communis	1	0	0	1	0	0	0	0	2
Bacteria;Bacteria_none;Proteobacteria;Gammaproteobacteria;Enterobacterales;Pectobacteriaceae;Lonsdalea;Lonsdalea populi	2	0	0	0	0	0	0	0	2
Bacteria;Bacteria_none;Actinobacteria;Actinomycetia;Streptosporangiales;Thermomonosporaceae;Actinomadura;Actinomadura bangladeshensis	1	1	0	0	0	0	0	0	2
Bacteria;Bacteria_none;Proteobacteria;Gammaproteobacteria;Enterobacterales;Pectobacteriaceae;Pectobacterium;Pectobacterium betavasculorum	1	1	0	0	0	0	0	0	2
Bacteria;Bacteria_none;Actinobacteria;Actinomycetia;Micrococcales;Brevibacteriaceae;Brevibacterium;Brevibacterium ammoniilyticum	1	1	0	0	0	0	0	0	2
Bacteria;Bacteria_none;Proteobacteria;Deltaproteobacteria;Desulfovibrionales;Desulfovibrionaceae;Paradesulfovibrio (ex Waite et al. 2020);Paradesulfovibrio bizertensis	1	1	0	0	0	0	0	0	2
Bacteria;Bacteria_none;Actinobacteria;Actinomycetia;Micrococcales;Microbacteriaceae;Homoserinimonas;Homoserinimonas aerilata	1	1	0	0	0	0	0	0	2
Bacteria;Bacteria_none;Firmicutes;Bacilli;Lactobacillales;Lactobacillaceae;Lactiplantibacillus;Lactiplantibacillus fabifermentans	2	0	0	0	0	0	0	0	2
Bacteria;Bacteria_none;Proteobacteria;Alphaproteobacteria;Rhodobacterales;Rhodobacteraceae;Halovulum;Halovulum marinum	0	0	0	0	1	0	1	0	2
Bacteria;Bacteria_none;Proteobacteria;Gammaproteobacteria;Xanthomonadales;Xanthomonadaceae;Pseudoxanthomonas;Pseudoxanthomonas sangjuensis	0	0	1	1	0	0	0	0	2
Bacteria;Bacteria_none;Actinobacteria;Actinomycetia;Micrococcales;Promicromonosporaceae;Promicromonospora;Promicromonospora panici	0	0	1	1	0	0	0	0	2
Bacteria;Bacteria_none;Proteobacteria;Alphaproteobacteria;Sphingomonadales;Sphingomonadaceae;Sphingobium;Sphingobium soli	0	0	1	1	0	0	0	0	2
Bacteria;Bacteria_none;Proteobacteria;Gammaproteobacteria;Xanthomonadales;Xanthomonadaceae;Pseudoxanthomonas;Pseudoxanthomonas spadix	1	1	0	0	0	0	0	0	2
Bacteria;Bacteria_none;Proteobacteria;Alphaproteobacteria;Sphingomonadales;Sphingomonadaceae;Sphingobium;Sphingobium terrigena	1	0	0	0	0	0	1	0	2
Bacteria;Bacteria_none;Proteobacteria;Gammaproteobacteria;Xanthomonadales;Rhodanobacteraceae;Aquimonas;Aquimonas voraii	1	0	1	0	0	0	0	0	2
Bacteria;Bacteria_none;Proteobacteria;Alphaproteobacteria;Sphingomonadales;Sphingomonadaceae;Sphingobium;Sphingobium vulgare	0	0	1	1	0	0	0	0	2
Bacteria;Bacteria_none;Bacteroidota;Chitinophagia;Chitinophagales;Chitinophagaceae;Niabella;Niabella ginsenosidivorans	2	0	0	0	0	0	0	0	2
Bacteria;Bacteria_none;Cyanobacteria;Cyanobacteria_Incertae_sedis;Oscillatoriales;Microcoleaceae;Planktothricoides;Planktothricoides raciborskii	1	0	1	0	0	0	0	0	2
Bacteria;Bacteria_none;Firmicutes;Bacilli;Lactobacillales;Lactobacillaceae;Bombilactobacillus;Bombilactobacillus apium	2	0	0	0	0	0	0	0	2
Bacteria;Bacteria_none;Cyanobacteria;Cyanobacteria_Incertae_sedis;Oscillatoriales;Oscillatoriaceae;Lyngbya;Lyngbya aestuarii	1	1	0	0	0	0	0	0	2
Bacteria;Bacteria_none;Proteobacteria;Alphaproteobacteria;Sphingomonadales;Sphingomonadaceae;Sphingomonas;Sphingomonas aestuarii	0	2	0	0	0	0	0	0	2
Bacteria;Bacteria_none;Cyanobacteria;Cyanobacteria_Incertae_sedis;Oscillatoriales;Oscillatoriaceae;Moorena;Moorena producens	1	1	0	0	0	0	0	0	2
Bacteria;Bacteria_none;Proteobacteria;Gammaproteobacteria;Vibrionales;Vibrionaceae;Vibrio;Vibrio zhuhaiensis	1	0	1	0	0	0	0	0	2
Bacteria;Bacteria_none;Proteobacteria;Alphaproteobacteria;Sphingomonadales;Sphingomonadaceae;Sphingomonas;Sphingomonas arenae	1	1	0	0	0	0	0	0	2
Bacteria;Bacteria_none;Proteobacteria;Alphaproteobacteria;Rhodospirillales;Acetobacteraceae;Novacetimonas;Novacetimonas hansenii	0	2	0	0	0	0	0	0	2
Bacteria;Bacteria_none;Chloroflexi;Chloroflexia;Chloroflexales;Oscillochloridaceae;Oscillochloris;Oscillochloris trichoides	1	1	0	0	0	0	0	0	2
Bacteria;Bacteria_none;Firmicutes;Clostridia;Eubacteriales;Clostridiaceae;Clostridium;Clostridium frigoris	0	0	0	1	0	0	1	0	2
Bacteria;Bacteria_none;Proteobacteria;Alphaproteobacteria;Hyphomicrobiales;Bartonellaceae;Bartonella;Bartonella fuyuanensis	2	0	0	0	0	0	0	0	2
Bacteria;Bacteria_none;Proteobacteria;Alphaproteobacteria;Hyphomicrobiales;Bartonellaceae;Bartonella;Bartonella clarridgeiae	0	2	0	0	0	0	0	0	2
Bacteria;Bacteria_none;Actinobacteria;Actinomycetia;Micrococcales;Micrococcaceae;Glutamicibacter;Glutamicibacter protophormiae	0	0	2	0	0	0	0	0	2
Bacteria;Bacteria_none;Proteobacteria;Alphaproteobacteria;Rhodobacterales;Rhodobacteraceae;Gemmobacter;Gemmobacter megaterium	1	0	1	0	0	0	0	0	2
Bacteria;Bacteria_none;Bacteroidota;Flavobacteriia;Flavobacteriales;Flavobacteriaceae;Flavobacterium;Flavobacterium notoginsengisoli	2	0	0	0	0	0	0	0	2
Bacteria;Bacteria_none;Proteobacteria;Alphaproteobacteria;Sphingomonadales;Sphingomonadaceae;Sphingobium;Sphingobium limneticum	0	0	1	0	0	0	1	0	2
Bacteria;Bacteria_none;Firmicutes;Bacilli;Lactobacillales;Lactobacillaceae;Ligilactobacillus;Ligilactobacillus faecis	1	0	0	0	1	0	0	0	2
Bacteria;Bacteria_none;Bacteroidota;Cytophagia;Cytophagales;Spirosomaceae;Fibrella;Fibrella aestuarina	0	1	1	0	0	0	0	0	2
Bacteria;Bacteria_none;Synergistetes;Synergistia;Synergistales;Synergistaceae;Pyramidobacter;Pyramidobacter piscolens	0	2	0	0	0	0	0	0	2
Bacteria;Bacteria_none;Cyanobacteria;Cyanobacteria_Incertae_sedis;Chroococcales;Aphanothecaceae;Gloeothece;Gloeothece aequatorialis	0	0	0	0	0	1	1	0	2
Bacteria;Bacteria_none;Actinobacteria;Actinomycetia;Micrococcales;Ornithinimicrobiaceae;Ornithinimicrobium;Ornithinimicrobium pratense	0	1	1	0	0	0	0	0	2
Bacteria;Bacteria_none;Proteobacteria;Alphaproteobacteria;Sphingomonadales;Sphingomonadaceae;Novosphingobium;Novosphingobium kunmingense	1	0	0	0	0	1	0	0	2
Bacteria;Bacteria_none;Proteobacteria;Alphaproteobacteria;Rhodobacterales;Rhodobacteraceae;Pseudorhodobacter;Pseudorhodobacter aquimaris	2	0	0	0	0	0	0	0	2
Bacteria;Bacteria_none;Proteobacteria;Alphaproteobacteria;Sphingomonadales;Sphingomonadaceae;Novosphingobium;Novosphingobium marinum	0	0	1	1	0	0	0	0	2
Bacteria;Bacteria_none;Proteobacteria;Gammaproteobacteria;Xanthomonadales;Rhodanobacteraceae;Luteibacter;Luteibacter yeojuensis	0	1	0	0	1	0	0	0	2
Bacteria;Bacteria_none;Bacteroidota;Sphingobacteriia;Sphingobacteriales;Sphingobacteriaceae;Sphingobacterium;Sphingobacterium mucilaginosum	0	0	0	0	0	2	0	0	2
Bacteria;Bacteria_none;Bacteroidota;Flavobacteriia;Flavobacteriales;Flavobacteriaceae;Flavobacterium;Flavobacterium croceum	0	1	0	1	0	0	0	0	2
Bacteria;Bacteria_none;Proteobacteria;Alphaproteobacteria;Rhodospirillales;Acetobacteraceae;Roseomonas;Roseomonas aquatica	1	0	1	0	0	0	0	0	2
Bacteria;Bacteria_none;Spirochaetes;Spirochaetia;Spirochaetales;Sphaerochaetaceae;Sphaerochaeta;Sphaerochaeta pleomorpha	0	1	1	0	0	0	0	0	2
Bacteria;Bacteria_none;Bacteroidota;Sphingobacteriia;Sphingobacteriales;Sphingobacteriaceae;Daejeonella;Daejeonella composti	0	1	0	0	1	0	0	0	2
Bacteria;Bacteria_none;Actinobacteria;Actinomycetia;Micrococcales;Promicromonosporaceae;Isoptericola;Isoptericola jiangsuensis	2	0	0	0	0	0	0	0	2
Bacteria;Bacteria_none;Proteobacteria;Gammaproteobacteria;Xanthomonadales;Rhodanobacteraceae;Dyella;Dyella monticola	2	0	0	0	0	0	0	0	2
Bacteria;Bacteria_none;Proteobacteria;Alphaproteobacteria;Hyphomicrobiales;Beijerinckiaceae;Methylovirgula;Methylovirgula ligni	1	1	0	0	0	0	0	0	2
Bacteria;Bacteria_none;Proteobacteria;Alphaproteobacteria;Rhodobacterales;Rhodobacteraceae;Monaibacterium;Monaibacterium marinum	0	0	1	0	0	1	0	0	2
Bacteria;Bacteria_none;Proteobacteria;Alphaproteobacteria;Rhodospirillales;Acetobacteraceae;Roseomonas;Roseomonas alkaliterrae	0	0	1	1	0	0	0	0	2
Bacteria;Bacteria_none;Cyanobacteria;Cyanobacteria_Incertae_sedis;Oscillatoriales;Microcoleaceae;Kamptonema;Kamptonema animale	0	1	0	0	1	0	0	0	2
Bacteria;Bacteria_none;Actinobacteria;Actinomycetia;Corynebacteriales;Corynebacteriaceae;Corynebacterium;Corynebacterium halotolerans	0	2	0	0	0	0	0	0	2
Bacteria;Bacteria_none;Actinobacteria;Actinomycetia;Micrococcales;Promicromonosporaceae;Isoptericola;Isoptericola rhizophila	0	0	2	0	0	0	0	0	2
Bacteria;Bacteria_none;Proteobacteria;Gammaproteobacteria;Xanthomonadales;Xanthomonadaceae;Pseudoxanthomonas;Pseudoxanthomonas sacheonensis	1	0	1	0	0	0	0	0	2
Bacteria;Bacteria_none;Proteobacteria;Gammaproteobacteria;Xanthomonadales;Rhodanobacteraceae;Dyella;Dyella agri	1	0	0	1	0	0	0	0	2
Bacteria;Bacteria_none;Bacteroidota;Flavobacteriia;Flavobacteriales;Flavobacteriaceae;Flavobacterium;Flavobacterium lacus	0	0	0	0	2	0	0	0	2
Bacteria;Bacteria_none;Bacteroidota;Flavobacteriia;Flavobacteriales;Flavobacteriaceae;Flavobacterium;Flavobacterium macacae	0	0	0	0	0	0	0	2	2
Bacteria;Bacteria_none;Bacteroidota;Flavobacteriia;Flavobacteriales;Flavobacteriaceae;Flavobacterium;Flavobacterium palustre	0	0	0	1	0	0	1	0	2
Bacteria;Bacteria_none;Proteobacteria;Alphaproteobacteria;Hyphomicrobiales;Aurantimonadaceae;Jiella;Jiella pacifica	0	1	1	0	0	0	0	0	2
Bacteria;Bacteria_none;Bacteroidota;Sphingobacteriia;Sphingobacteriales;Sphingobacteriaceae;Sphingobacterium;Sphingobacterium thermophilum	0	2	0	0	0	0	0	0	2
Bacteria;Bacteria_none;Proteobacteria;Alphaproteobacteria;Sphingomonadales;Sphingomonadaceae;Sphingomonas;Sphingomonas flavalba	0	0	1	1	0	0	0	0	2
Bacteria;Bacteria_none;Proteobacteria;Gammaproteobacteria;Thiotrichales;Thiotrichaceae;Thiothrix;Thiothrix eikelboomii	2	0	0	0	0	0	0	0	2
Bacteria;Bacteria_none;Cyanobacteria;Cyanobacteria_Incertae_sedis;Oscillatoriales;Oscillatoriales_Incertae_sedis;Ammassolinea;Ammassolinea attenuata	0	0	0	1	1	0	0	0	2
Bacteria;Bacteria_none;Cyanobacteria;Cyanobacteria_Incertae_sedis;Oscillatoriales;Sirenicapillariaceae;Affixifilum;Affixifilum granulosum	1	0	0	0	0	0	1	0	2
Bacteria;Bacteria_none;Proteobacteria;Alphaproteobacteria;Rhodobacterales;Rhodobacteraceae;Defluviimonas;Defluviimonas aestuarii	2	0	0	0	0	0	0	0	2
Bacteria;Bacteria_none;Proteobacteria;Alphaproteobacteria;Hyphomicrobiales;Phyllobacteriaceae;Nitratireductor;Nitratireductor arenosus	0	0	1	0	0	1	0	0	2
Bacteria;Bacteria_none;Proteobacteria;Alphaproteobacteria;Rhodospirillales;Acetobacteraceae;Formicincola;Formicincola oecophyllae	2	0	0	0	0	0	0	0	2
Bacteria;Bacteria_none;Bacteroidota;Chitinophagia;Chitinophagales;Chitinophagaceae;Hydrobacter;Hydrobacter penzbergensis	0	0	0	1	1	0	0	0	2
Bacteria;Bacteria_none;Cyanobacteria;Cyanobacteria_Incertae_sedis;Pleurocapsales;Dermocarpellaceae;Stanieria;Stanieria cyanosphaera	0	1	1	0	0	0	0	0	2
Bacteria;Bacteria_none;Firmicutes;Bacilli;Lactobacillales;Lactobacillaceae;Lactobacillus;Lactobacillus intestinalis	0	1	0	1	0	0	0	0	2
Bacteria;Bacteria_none;Bacteroidota;Chitinophagia;Chitinophagales;Chitinophagaceae;Heliimonas;Heliimonas saccharivorans	1	1	0	0	0	0	0	0	2
Bacteria;Bacteria_none;Firmicutes;Clostridia;Eubacteriales;Clostridiaceae;Clostridium;Clostridium kogasense	0	0	0	2	0	0	0	0	2
Bacteria;Bacteria_none;Proteobacteria;Alphaproteobacteria;Hyphomicrobiales;Ahrensiaceae;Ahrensia;Ahrensia kielensis	1	0	1	0	0	0	0	0	2
Bacteria;Bacteria_none;Proteobacteria;Gammaproteobacteria;Thiotrichales;Piscirickettsiaceae;Thiosulfatimonas;Thiosulfatimonas sediminis	0	0	2	0	0	0	0	0	2
Bacteria;Bacteria_none;Cyanobacteria;Cyanobacteria_Incertae_sedis;Pleurocapsales;Pleurocapsales_Incertae_sedis;Odorella;Odorella benthonica	2	0	0	0	0	0	0	0	2
Bacteria;Bacteria_none;Proteobacteria;Gammaproteobacteria;Thiotrichales;Piscirickettsiaceae;Thiomicrospira;Thiomicrospira cyclica	0	0	0	2	0	0	0	0	2
Bacteria;Bacteria_none;Proteobacteria;Alphaproteobacteria;Rhodobacterales;Rhodobacteraceae;Chachezhania;Chachezhania sediminis	1	0	0	0	1	0	0	0	2
Bacteria;Bacteria_none;Bacteroidota;Cytophagia;Cytophagales;Fulvivirgaceae;Chryseolinea;Chryseolinea soli	2	0	0	0	0	0	0	0	2
Bacteria;Bacteria_none;Bacteroidota;Cytophagia;Cytophagales;Cytophagaceae;Cytophaga;Cytophaga aurantiaca	0	0	0	0	0	0	0	2	2
Bacteria;Bacteria_none;Proteobacteria;Alphaproteobacteria;Rhodobacterales;Rhodobacteraceae;Cereibacter;Cereibacter azotoformans	0	1	0	0	1	0	0	0	2
Bacteria;Bacteria_none;Proteobacteria;Alphaproteobacteria;Sphingomonadales;Sphingomonadaceae;Stakelama;Stakelama flava	1	0	1	0	0	0	0	0	2
Bacteria;Bacteria_none;Spirochaetes;Spirochaetia;Spirochaetales;Breznakiellaceae;Zuelzera;Zuelzera stenostrepta	0	1	1	0	0	0	0	0	2
Bacteria;Bacteria_none;Proteobacteria;Alphaproteobacteria;Rhodospirillales;Acetobacteraceae;Falsiroseomonas;Falsiroseomonas bella	1	0	0	1	0	0	0	0	2
Bacteria;Bacteria_none;Firmicutes;Bacilli;Lactobacillales;Enterococcaceae;Vagococcus;Vagococcus allomyrinae	2	0	0	0	0	0	0	0	2
Bacteria;Bacteria_none;Proteobacteria;Alphaproteobacteria;Rhodospirillales;Acetobacteraceae;Gluconacetobacter;Gluconacetobacter diazotrophicus	0	0	0	0	2	0	0	0	2
Bacteria;Bacteria_none;Proteobacteria;Alphaproteobacteria;Sphingomonadales;Sphingomonadaceae;Sphingomonas;Sphingomonas silvisoli	0	2	0	0	0	0	0	0	2
Bacteria;Bacteria_none;Bacteroidota;Flavobacteriia;Flavobacteriales;Flavobacteriaceae;Flavobacterium;Flavobacterium tibetense	0	0	0	1	0	0	0	1	2
Bacteria;Bacteria_none;Cyanobacteria;Cyanobacteria_Incertae_sedis;Oscillatoriales;Oscillatoriaceae;Phormidium;Phormidium irriguum	0	2	0	0	0	0	0	0	2
Bacteria;Bacteria_none;Tenericutes;Mollicutes;Acholeplasmatales;Acholeplasmataceae;Paracholeplasma;Paracholeplasma brassicae	0	0	1	1	0	0	0	0	2
Bacteria;Bacteria_none;Proteobacteria;Alphaproteobacteria;Rhodospirillales;Acetobacteraceae;Lichenicoccus;Lichenicoccus roseus	1	0	0	1	0	0	0	0	2
Bacteria;Bacteria_none;Proteobacteria;Alphaproteobacteria;Sphingomonadales;Sphingomonadaceae;Sphingomonas;Sphingomonas gimensis	1	0	0	1	0	0	0	0	2
Bacteria;Bacteria_none;Bacteroidota;Flavobacteriia;Flavobacteriales;Weeksellaceae;Spongiimonas;Spongiimonas flava	0	0	0	1	0	0	0	1	2
Bacteria;Bacteria_none;Proteobacteria;Alphaproteobacteria;Sphingomonadales;Sphingomonadaceae;Sphingomonas;Sphingomonas haloaromaticamans	0	1	0	1	0	0	0	0	2
Bacteria;Bacteria_none;Bacteroidota;Flavobacteriia;Flavobacteriales;Weeksellaceae;Ornithobacterium;Ornithobacterium rhinotracheale	0	1	1	0	0	0	0	0	2
Bacteria;Bacteria_none;Tenericutes;Mollicutes;Anaeroplasmatales;Anaeroplasmataceae;Asteroleplasma;Asteroleplasma anaerobium	0	1	0	0	1	0	0	0	2
Bacteria;Bacteria_none;Proteobacteria;Alphaproteobacteria;Hyphomicrobiales;Aurantimonadaceae;Aureimonas;Aureimonas leprariae	1	0	0	1	0	0	0	0	2
Bacteria;Bacteria_none;Proteobacteria;Alphaproteobacteria;Rhodobacterales;Rhodobacteraceae;Puniceibacterium;Puniceibacterium confluentis	1	0	0	1	0	0	0	0	2
Bacteria;Bacteria_none;Proteobacteria;Alphaproteobacteria;Rhodobacterales;Rhodobacteraceae;Frigidibacter;Frigidibacter oleivorans	0	2	0	0	0	0	0	0	2
Bacteria;Bacteria_none;Proteobacteria;Alphaproteobacteria;Sphingomonadales;Sphingomonadaceae;Sphingomonas;Sphingomonas morindae	0	0	0	2	0	0	0	0	2
Bacteria;Bacteria_none;Proteobacteria;Alphaproteobacteria;Rhodobacterales;Rhodobacteraceae;Defluviimonas;Defluviimonas nitratireducens	0	0	0	0	0	2	0	0	2
Bacteria;Bacteria_none;Chloroflexi;Ktedonobacteria;Ktedonobacterales;Ktedonosporobacteraceae;Ktedonosporobacter;Ktedonosporobacter rubrisoli	0	0	0	1	1	0	0	0	2
Bacteria;Bacteria_none;Proteobacteria;Alphaproteobacteria;Rhodobacterales;Rhodobacteraceae;Fertoeibacter;Fertoeibacter niger	1	0	0	0	0	1	0	0	2
Bacteria;Bacteria_none;Proteobacteria;Alphaproteobacteria;Sphingomonadales;Sphingomonadaceae;Sphingomonas;Sphingomonas oryziterrae	0	1	1	0	0	0	0	0	2
Bacteria;Bacteria_none;Firmicutes;Bacilli;Lactobacillales;Lactobacillaceae;Limosilactobacillus;Limosilactobacillus ingluviei	0	1	1	0	0	0	0	0	2
Bacteria;Bacteria_none;Proteobacteria;Alphaproteobacteria;Rhodobacterales;Rhodobacteraceae;Falsigemmobacter;Falsigemmobacter faecalis	0	0	2	0	0	0	0	0	2
Bacteria;Bacteria_none;Proteobacteria;Gammaproteobacteria;Vibrionales;Vibrionaceae;Photobacterium;Photobacterium alginatilyticum	0	0	1	1	0	0	0	0	2
Bacteria;Bacteria_none;Proteobacteria;Alphaproteobacteria;Sphingomonadales;Sphingomonadaceae;Sphingomonas;Sphingomonas parvus	1	0	0	1	0	0	0	0	2
Bacteria;Bacteria_none;Firmicutes;Bacilli;Lactobacillales;Enterococcaceae;Vagococcus;Vagococcus carniphilus	2	0	0	0	0	0	0	0	2
Bacteria;Bacteria_none;Firmicutes;Bacilli;Lactobacillales;Lactobacillaceae;Lentilactobacillus;Lentilactobacillus parafarraginis	0	1	1	0	0	0	0	0	2
Bacteria;Bacteria_none;Proteobacteria;Alphaproteobacteria;Hyphomicrobiales;Aurantimonadaceae;Aureimonas;Aureimonas ferruginea	1	0	0	0	0	1	0	0	2
Bacteria;Bacteria_none;Firmicutes;Bacilli;Lactobacillales;Streptococcaceae;Streptococcus;Streptococcus periodonticum	0	1	1	0	0	0	0	0	2
Bacteria;Bacteria_none;Proteobacteria;Alphaproteobacteria;Sphingomonadales;Sphingomonadaceae;Novosphingobium;Novosphingobium colocasiae	1	0	1	0	0	0	0	0	2
Bacteria;Bacteria_none;Proteobacteria;Alphaproteobacteria;Sphingomonadales;Sphingosinicellaceae;Thermaurantiacus;Thermaurantiacus tibetensis	1	1	0	0	0	0	0	0	2
Bacteria;Bacteria_none;Proteobacteria;Alphaproteobacteria;Hyphomicrobiales;Devosiaceae;Pelagibacterium;Pelagibacterium lentulum	0	0	0	2	0	0	0	0	2
Bacteria;Bacteria_none;Proteobacteria;Alphaproteobacteria;Rhodospirillales;Rhodospirillaceae;Inquilinus;Inquilinus ginsengisoli	0	0	0	2	0	0	0	0	2
Bacteria;Bacteria_none;Cyanobacteria;Cyanobacteria_Incertae_sedis;Nostocales;Hapalosiphonaceae;Mastigocoleus;Mastigocoleus testarum	0	0	0	2	0	0	0	0	2
Bacteria;Bacteria_none;Proteobacteria;Alphaproteobacteria;Rhodospirillales;Rhodospirillaceae;Magnetospirillum;Magnetospirillum bellicum	0	0	1	0	0	1	0	0	2
Bacteria;Bacteria_none;Proteobacteria;Gammaproteobacteria;Xanthomonadales;Xanthomonadaceae;Lysobacter;Lysobacter erysipheiresistens	1	0	0	1	0	0	0	0	2
Bacteria;Bacteria_none;Spirochaetes;Spirochaetia;Spirochaetales;Treponemataceae;Treponema;Treponema lecithinolyticum	0	2	0	0	0	0	0	0	2
Bacteria;Bacteria_none;Bacteroidota;Cytophagia;Cytophagales;Spirosomaceae;Telluribacter;Telluribacter humicola	1	0	1	0	0	0	0	0	2
Bacteria;Bacteria_none;Bacteroidota;Chitinophagia;Chitinophagales;Chitinophagaceae;Terrimonas;Terrimonas pekingensis	2	0	0	0	0	0	0	0	2
Bacteria;Bacteria_none;Proteobacteria;Alphaproteobacteria;Hyphomicrobiales;Parvibaculaceae;Pyruvatibacter;Pyruvatibacter mobilis	1	0	1	0	0	0	0	0	2
Bacteria;Bacteria_none;Proteobacteria;Gammaproteobacteria;Xanthomonadales;Xanthomonadaceae;Lysobacter;Lysobacter concretionis	2	0	0	0	0	0	0	0	2
Bacteria;Bacteria_none;Proteobacteria;Alphaproteobacteria;Hyphomicrobiales;Devosiaceae;Devosia;Devosia nitrariae	1	0	0	1	0	0	0	0	2
Bacteria;Bacteria_none;Spirochaetes;Spirochaetia;Spirochaetales;Treponemataceae;Treponema;Treponema maltophilum	0	2	0	0	0	0	0	0	2
Bacteria;Bacteria_none;Proteobacteria;Gammaproteobacteria;Xanthomonadales;Xanthomonadaceae;Lysobacter;Lysobacter caseinilyticus	1	0	0	0	0	0	1	0	2
Bacteria;Bacteria_none;Proteobacteria;Alphaproteobacteria;Rhodospirillales;Rhodospirillaceae;Roseospira;Roseospira visakhapatnamensis	0	0	0	2	0	0	0	0	2
Bacteria;Bacteria_none;Proteobacteria;Alphaproteobacteria;Rhodobacterales;Rhodobacteraceae;Paracoccus;Paracoccus sanguinis	2	0	0	0	0	0	0	0	2
Bacteria;Bacteria_none;Proteobacteria;Alphaproteobacteria;Rhodospirillales;Acetobacteraceae;Roseomonas;Roseomonas soli	0	0	2	0	0	0	0	0	2
Bacteria;Bacteria_none;Bacteroidota;Flavobacteriia;Flavobacteriales;Cryomorphaceae;Acidiluteibacter;Acidiluteibacter ferrifornacis	0	2	0	0	0	0	0	0	2
Bacteria;Bacteria_none;Bacteroidota;Chitinophagia;Chitinophagales;Chitinophagaceae;Segetibacter;Segetibacter koreensis	1	0	0	1	0	0	0	0	2
Bacteria;Bacteria_none;Bacteroidota;Chitinophagia;Chitinophagales;Chitinophagaceae;Sediminibacterium;Sediminibacterium soli	2	0	0	0	0	0	0	0	2
Bacteria;Bacteria_none;Proteobacteria;Alphaproteobacteria;Rhodobacterales;Rhodobacteraceae;Pontibrevibacter;Pontibrevibacter nitratireducens	1	0	0	1	0	0	0	0	2
Bacteria;Bacteria_none;Firmicutes;Bacilli;Lactobacillales;Lactobacillaceae;Furfurilactobacillus;Furfurilactobacillus siliginis	0	0	0	2	0	0	0	0	2
Bacteria;Bacteria_none;Actinobacteria;Actinomycetia;Micrococcales;Micrococcaceae;Renibacterium;Renibacterium salmoninarum	0	1	1	0	0	0	0	0	2
Bacteria;Bacteria_none;Bacteroidota;Sphingobacteriia;Sphingobacteriales;Sphingobacteriaceae;Sphingobacterium;Sphingobacterium composti Yoo et al. 2007 non Ten et al. 2007	0	0	0	1	0	0	1	0	2
Bacteria;Bacteria_none;Proteobacteria;Alphaproteobacteria;Rhodobacterales;Rhodobacteraceae;Pseudohalocynthiibacter;Pseudohalocynthiibacter aestuariivivens	0	1	1	0	0	0	0	0	2
Bacteria;Bacteria_none;Bacteroidota;Sphingobacteriia;Sphingobacteriales;Sphingobacteriaceae;Pedobacter;Pedobacter nanyangensis	1	0	0	0	1	0	0	0	2
Bacteria;Bacteria_none;Actinobacteria;Actinomycetia;Micrococcales;Microbacteriaceae;Agromyces;Agromyces humi	2	0	0	0	0	0	0	0	2
Bacteria;Bacteria_none;Proteobacteria;Alphaproteobacteria;Rhodobacterales;Rhodobacteraceae;Pseudopuniceibacterium;Pseudopuniceibacterium antarcticum	0	0	0	2	0	0	0	0	2
Bacteria;Bacteria_none;Proteobacteria;Alphaproteobacteria;Hyphomicrobiales;Notoacmeibacteraceae;Notoacmeibacter;Notoacmeibacter ruber	0	1	0	1	0	0	0	0	2
Bacteria;Bacteria_none;Actinobacteria;Actinomycetia;Micrococcales;Intrasporangiaceae;Aquipuribacter;Aquipuribacter hungaricus	0	1	0	1	0	0	0	0	2
Bacteria;Bacteria_none;Bacteroidota;Cytophagia;Cytophagales;Cytophagaceae;Chryseosolibacter;Chryseosolibacter histidini	0	1	1	0	0	0	0	0	2
Bacteria;Bacteria_none;Proteobacteria;Alphaproteobacteria;Rhodobacterales;Rhodobacteraceae;Phaeovulum;Phaeovulum vinaykumarii	2	0	0	0	0	0	0	0	2
Bacteria;Bacteria_none;Proteobacteria;Alphaproteobacteria;Rhodospirillales;Azospirillaceae;Azospirillum;Azospirillum lipoferum	0	0	0	0	0	2	0	0	2
Bacteria;Bacteria_none;Cyanobacteria;Cyanobacteria_Incertae_sedis;Chroococcidiopsidales;Chroococcidiopsidaceae;Haliplanktos;Haliplanktos anthonyquinnii	1	1	0	0	0	0	0	0	2
Bacteria;Bacteria_none;Actinobacteria;Actinomycetia;Micrococcales;Micrococcaceae;Micrococcus;Micrococcus lylae	0	1	1	0	0	0	0	0	2
Bacteria;Bacteria_none;Proteobacteria;Alphaproteobacteria;Rhodospirillales;Azospirillaceae;Desertibacter;Desertibacter xinjiangensis	0	1	1	0	0	0	0	0	2
Bacteria;Bacteria_none;Spirochaetes;Spirochaetia;Spirochaetales;Spirochaetaceae;Spirochaeta;Spirochaeta halophila	2	0	0	0	0	0	0	0	2
Bacteria;Bacteria_none;Bacteroidota;Sphingobacteriia;Sphingobacteriales;Sphingobacteriaceae;Pseudopedobacter;Pseudopedobacter saltans	0	2	0	0	0	0	0	0	2
Bacteria;Bacteria_none;Proteobacteria;Gammaproteobacteria;Xanthomonadales;Xanthomonadaceae;Lysobacter;Lysobacter soli	0	0	0	0	2	0	0	0	2
Bacteria;Bacteria_none;Spirochaetes;Spirochaetia;Spirochaetales;Treponemataceae;Treponema;Treponema amylovorum	0	1	1	0	0	0	0	0	2
Bacteria;Bacteria_none;Firmicutes;Bacilli;Lactobacillales;Lactobacillaceae;Lactobacillus;Lactobacillus apis	2	0	0	0	0	0	0	0	2
Bacteria;Bacteria_none;Bacteroidota;Cytophagia;Cytophagales;Spirosomaceae;Pseudarcicella;Pseudarcicella hirudinis	2	0	0	0	0	0	0	0	2
Bacteria;Bacteria_none;Firmicutes;Clostridia;Eubacteriales;Clostridiaceae;Clostridium;Clostridium carboxidivorans	2	0	0	0	0	0	0	0	2
Bacteria;Bacteria_none;Proteobacteria;Alphaproteobacteria;Hyphomicrobiales;Nitrobacteraceae;Rhodopseudomonas;Rhodopseudomonas rhenobacensis	1	1	0	0	0	0	0	0	2
Bacteria;Bacteria_none;Actinobacteria;Actinomycetia;Micrococcales;Micrococcaceae;Kocuria;Kocuria varians	0	1	0	0	0	0	0	1	2
Bacteria;Bacteria_none;Bacteroidota;Cytophagia;Cytophagales;Spirosomaceae;Ravibacter;Ravibacter arvi	0	0	0	2	0	0	0	0	2
Bacteria;Bacteria_none;Bacteroidota;Cytophagia;Cytophagales;Spirosomaceae;Runella;Runella limosa	0	2	0	0	0	0	0	0	2
Bacteria;Bacteria_none;Bacteroidota;Cytophagia;Cytophagales;Cesiribacteraceae;Cesiribacter;Cesiribacter roseus	0	0	1	1	0	0	0	0	2
Bacteria;Bacteria_none;Bacteroidota;Cytophagia;Cytophagales;Catalimonadaceae;Catalinimonas;Catalinimonas alkaloidigena	0	0	1	1	0	0	0	0	2
Bacteria;Bacteria_none;Bacteroidota;Sphingobacteriia;Sphingobacteriales;Sphingobacteriaceae;Pedobacter;Pedobacter vanadiisoli	2	0	0	0	0	0	0	0	2
Bacteria;Bacteria_none;Proteobacteria;Alphaproteobacteria;Hyphomicrobiales;Devosiaceae;Youhaiella;Youhaiella tibetensis	0	0	0	2	0	0	0	0	2
Bacteria;Bacteria_none;Actinobacteria;Actinomycetia;Micrococcales;Microbacteriaceae;Agromyces;Agromyces salentinus	0	1	0	1	0	0	0	0	2
Bacteria;Bacteria_none;Bacteroidota;Chitinophagia;Chitinophagales;Chitinophagaceae;Parasegetibacter;Parasegetibacter terrae	2	0	0	0	0	0	0	0	2
Bacteria;Bacteria_none;Proteobacteria;Alphaproteobacteria;Hyphomicrobiales;Devosiaceae;Devosia;Devosia glacialis	0	1	0	0	0	1	0	0	2
Bacteria;Bacteria_none;Bacteroidota;Flavobacteriia;Flavobacteriales;Flavobacteriaceae;Aquimarina;Aquimarina celericrescens	0	2	0	0	0	0	0	0	2
Bacteria;Bacteria_none;Firmicutes;Bacilli;Lactobacillales;Lactobacillaceae;Fructobacillus;Fructobacillus durionis	0	2	0	0	0	0	0	0	2
Bacteria;Bacteria_none;Proteobacteria;Alphaproteobacteria;Sphingomonadales;Erythrobacteraceae;Erythrobacter;Erythrobacter ramosus	0	0	1	0	0	0	1	0	2
Bacteria;Bacteria_none;Proteobacteria;Alphaproteobacteria;Rhodospirillales;Acetobacteraceae;Roseomonas;Roseomonas marmotae	0	1	0	1	0	0	0	0	2
Bacteria;Bacteria_none;Proteobacteria;Alphaproteobacteria;Sphingomonadales;Erythrobacteraceae;Paraurantiacibacter;Paraurantiacibacter namhicola	0	0	1	0	0	1	0	0	2
Bacteria;Bacteria_none;Firmicutes;Bacilli;Lactobacillales;Lactobacillaceae;Levilactobacillus;Levilactobacillus senmaizukei	1	0	0	1	0	0	0	0	2
Bacteria;Bacteria_none;Proteobacteria;Gammaproteobacteria;Xanthomonadales;Xanthomonadaceae;Arenimonas;Arenimonas taoyuanensis	2	0	0	0	0	0	0	0	2
Bacteria;Bacteria_none;Spirochaetes;Spirochaetia;Spirochaetales;Spirochaetaceae;Salinispira;Salinispira pacifica	0	0	2	0	0	0	0	0	2
Bacteria;Bacteria_none;Proteobacteria;Alphaproteobacteria;Rhodobacterales;Rhodobacteraceae;Paracoccus;Paracoccus ferrooxidans	1	1	0	0	0	0	0	0	2
Bacteria;Bacteria_none;Actinobacteria;Actinomycetia;Micrococcales;Microbacteriaceae;Microbacterium;Microbacterium tumbae	0	0	2	0	0	0	0	0	2
Bacteria;Bacteria_none;Cyanobacteria;Cyanobacteria_Incertae_sedis;Nostocales;Rivulariaceae;Nunduva;Nunduva sanagustinensis	0	1	1	0	0	0	0	0	2
Bacteria;Bacteria_none;Actinobacteria;Actinomycetia;Corynebacteriales;Corynebacteriaceae;Corynebacterium;Corynebacterium atypicum	0	2	0	0	0	0	0	0	2
Bacteria;Bacteria_none;Bacteroidota;Sphingobacteriia;Sphingobacteriales;Sphingobacteriaceae;Mucilaginibacter;Mucilaginibacter kameinonensis	0	0	0	1	1	0	0	0	2
Bacteria;Bacteria_none;Firmicutes;Bacilli;Lactobacillales;Streptococcaceae;Streptococcus;Streptococcus porcinus	1	0	0	0	0	0	1	0	2
Bacteria;Bacteria_none;Proteobacteria;Alphaproteobacteria;Hyphomicrobiales;Phyllobacteriaceae;Hoeflea;Hoeflea anabaenae	0	2	0	0	0	0	0	0	2
Bacteria;Bacteria_none;Firmicutes;Bacilli;Lactobacillales;Lactobacillaceae;Levilactobacillus;Levilactobacillus spicheri	1	0	0	0	0	0	1	0	2
Bacteria;Bacteria_none;Proteobacteria;Gammaproteobacteria;Xanthomonadales;Xanthomonadaceae;Arenimonas;Arenimonas aquatica	2	0	0	0	0	0	0	0	2
Bacteria;Bacteria_none;Bacteroidota;Cytophagia;Cytophagales;Spirosomaceae;Fibrisoma;Fibrisoma limi	0	0	0	1	0	0	1	0	2
Bacteria;Bacteria_none;Actinobacteria;Actinomycetia;Micrococcales;Micrococcales_Incertae_sedis;Timonella;Timonella senegalensis	0	1	0	1	0	0	0	0	2
Bacteria;Bacteria_none;Actinobacteria;Actinomycetia;Micrococcales;Micrococcaceae;Kocuria;Kocuria coralli	0	0	0	1	0	0	1	0	2
Bacteria;Bacteria_none;Cyanobacteria;Cyanobacteria_Incertae_sedis;Nostocales;Rivulariaceae;Phyllonema;Phyllonema aviceniicola	0	1	0	1	0	0	0	0	2
Bacteria;Bacteria_none;Proteobacteria;Alphaproteobacteria;Rhodobacterales;Rhodobacteraceae;Pseudophaeobacter;Pseudophaeobacter arcticus	0	1	0	1	0	0	0	0	2
Bacteria;Bacteria_none;Bacteroidota;Chitinophagia;Chitinophagales;Chitinophagaceae;Niastella;Niastella populi	0	1	1	0	0	0	0	0	2
Bacteria;Bacteria_none;Firmicutes;Bacilli;Lactobacillales;Streptococcaceae;Streptococcus;Streptococcus pluranimalium	2	0	0	0	0	0	0	0	2
Bacteria;Bacteria_none;Firmicutes;Bacilli;Lactobacillales;Lactobacillaceae;Levilactobacillus;Levilactobacillus suantsaii	2	0	0	0	0	0	0	0	2
Bacteria;Bacteria_none;Proteobacteria;Gammaproteobacteria;Xanthomonadales;Xanthomonadaceae;Coralloluteibacterium;Coralloluteibacterium thermophilus	2	0	0	0	0	0	0	0	2
Bacteria;Bacteria_none;Bacteroidota;Chitinophagia;Chitinophagales;Chitinophagaceae;Parafilimonas;Parafilimonas rhizosphaerae	2	0	0	0	0	0	0	0	2
Bacteria;Bacteria_none;Firmicutes;Bacilli;Lactobacillales;Lactobacillaceae;Leuconostoc;Leuconostoc rapi	2	0	0	0	0	0	0	0	2
Bacteria;Bacteria_none;Spirochaetes;Spirochaetia;Spirochaetales;Treponemataceae;Treponema;Treponema porcinum	0	0	2	0	0	0	0	0	2
Bacteria;Bacteria_none;Cyanobacteria;Cyanobacteria_Incertae_sedis;Chroococcales;Chroococcaceae;Cryptochroococcus;Cryptochroococcus tibeticus	0	0	2	0	0	0	0	0	2
Bacteria;Bacteria_none;Bacteroidota;Sphingobacteriia;Sphingobacteriales;Sphingobacteriaceae;Pedobacter;Pedobacter frigiditerrae	2	0	0	0	0	0	0	0	2
Bacteria;Bacteria_none;Proteobacteria;Alphaproteobacteria;Hyphomicrobiales;Devosiaceae;Devosia;Devosia faecipullorum	1	0	0	0	1	0	0	0	2
Bacteria;Bacteria_none;Proteobacteria;Alphaproteobacteria;Rickettsiales;Anaplasmataceae;Ehrlichia;Ehrlichia muris	0	0	2	0	0	0	0	0	2
Bacteria;Bacteria_none;Proteobacteria;Gammaproteobacteria;Xanthomonadales;Xanthomonadaceae;Luteimonas;Luteimonas pelagia	1	0	1	0	0	0	0	0	2
Bacteria;Bacteria_none;Cyanobacteria;Cyanobacteria_Incertae_sedis;Nostocales;Nostocaceae;Desmonostoc;Desmonostoc lechangense	0	0	1	1	0	0	0	0	2
Bacteria;Bacteria_none;Proteobacteria;Gammaproteobacteria;Xanthomonadales;Xanthomonadaceae;Luteimonas;Luteimonas padinae	0	2	0	0	0	0	0	0	2
Bacteria;Bacteria_none;Proteobacteria;Alphaproteobacteria;Rickettsiales;Rickettsiaceae;Rickettsia;Rickettsia asiatica	2	0	0	0	0	0	0	0	2
Bacteria;Bacteria_none;Proteobacteria;Alphaproteobacteria;Rickettsiales;Rickettsiaceae;Rickettsia;Rickettsia australis	2	0	0	0	0	0	0	0	2
Bacteria;Bacteria_none;Bacteroidota;Flavobacteriia;Flavobacteriales;Flavobacteriaceae;Aurantibacter;Aurantibacter crassamenti	0	0	2	0	0	0	0	0	2
Bacteria;Bacteria_none;Cyanobacteria;Cyanobacteria_Incertae_sedis;Nostocales;Nostocaceae;Desmonostoc;Desmonostoc punense	0	1	1	0	0	0	0	0	2
Bacteria;Bacteria_none;Cyanobacteria;Cyanobacteria_Incertae_sedis;Nostocales;Nostocaceae;Minunostoc;Minunostoc cylindricum	0	0	1	1	0	0	0	0	2
Bacteria;Bacteria_none;Bacteroidota;Cytophagia;Cytophagales;Cytophagaceae;Siphonobacter;Siphonobacter curvatus	0	0	0	1	0	0	1	0	2
Bacteria;Bacteria_none;Proteobacteria;Alphaproteobacteria;Hyphomicrobiales;Phyllobacteriaceae;Aquamicrobium;Aquamicrobium aerolatum	0	0	2	0	0	0	0	0	2
Bacteria;Bacteria_none;Proteobacteria;Alphaproteobacteria;Rickettsiales;Rickettsiaceae;Rickettsia;Rickettsia parkeri	0	2	0	0	0	0	0	0	2
Bacteria;Bacteria_none;Proteobacteria;Alphaproteobacteria;Rickettsiales;Rickettsiaceae;Rickettsia;Rickettsia sibirica	2	0	0	0	0	0	0	0	2
Bacteria;Bacteria_none;Proteobacteria;Gammaproteobacteria;Xanthomonadales;Xanthomonadaceae;Luteimonas;Luteimonas huabeiensis	2	0	0	0	0	0	0	0	2
Bacteria;Bacteria_none;Proteobacteria;Alphaproteobacteria;Rhodobacterales;Rhodobacteraceae;Paracoccus;Paracoccus isoporae	1	0	0	1	0	0	0	0	2
Bacteria;Bacteria_none;Cyanobacteria;Cyanobacteria_Incertae_sedis;Chroococcales;Chroococcaceae;Chalicogloea;Chalicogloea cavernicola	0	1	0	0	0	0	1	0	2
Bacteria;Bacteria_none;Proteobacteria;Gammaproteobacteria;Xanthomonadales;Xanthomonadaceae;Luteimonas;Luteimonas dalianensis	1	1	0	0	0	0	0	0	2
Bacteria;Bacteria_none;Proteobacteria;Alphaproteobacteria;Sphingomonadales;Erythrobacteraceae;Altererythrobacter;Altererythrobacter xiamenensis	1	0	0	0	0	0	0	1	2
Bacteria;Bacteria_none;Actinobacteria;Actinomycetia;Micrococcales;Micrococcaceae;Rothia;Rothia halotolerans	1	0	0	1	0	0	0	0	2
Bacteria;Bacteria_none;Firmicutes;Bacilli;Lactobacillales;Enterococcaceae;Vagococcus;Vagococcus acidifermentans	2	0	0	0	0	0	0	0	2
Bacteria;Bacteria_none;Bacteroidota;Cytophagia;Cytophagales;Fulvivirgaceae;Ohtaekwangia;Ohtaekwangia koreensis	2	0	0	0	0	0	0	0	2
Bacteria;Bacteria_none;Proteobacteria;Alphaproteobacteria;Rhodobacterales;Rhodobacteraceae;Amylibacter;Amylibacter marinus	1	1	0	0	0	0	0	0	2
Bacteria;Bacteria_none;Deferribacteres;Deferribacteres;Deferribacterales;Deferribacterales_Incertae_sedis;Petrothermobacter;Petrothermobacter organivorans	0	2	0	0	0	0	0	0	2
Bacteria;Bacteria_none;Firmicutes;Bacilli;Lactobacillales;Carnobacteriaceae;Carnobacterium;Carnobacterium gallinarum	2	0	0	0	0	0	0	0	2
Bacteria;Bacteria_none;Firmicutes;Bacilli;Lactobacillales;Streptococcaceae;Streptococcus;Streptococcus fryi	2	0	0	0	0	0	0	0	2
Bacteria;Bacteria_none;Proteobacteria;Alphaproteobacteria;Hyphomicrobiales;Salinarimonadaceae;Salinarimonas;Salinarimonas rosea	0	0	1	1	0	0	0	0	2
Bacteria;Bacteria_none;Proteobacteria;Betaproteobacteria;Burkholderiales;Burkholderiales_Incertae_sedis;Thiomonas;Thiomonas perometabolis	0	0	0	2	0	0	0	0	2
Bacteria;Bacteria_none;Actinobacteria;Actinomycetia;Micrococcales;Microbacteriaceae;Gulosibacter;Gulosibacter sediminis	1	0	0	0	0	0	1	0	2
Bacteria;Bacteria_none;Actinobacteria;Actinomycetia;Micrococcales;Intrasporangiaceae;Knoellia;Knoellia aerolata	0	1	0	1	0	0	0	0	2
Bacteria;Bacteria_none;Actinobacteria;Actinomycetia;Micrococcales;Micrococcaceae;Acaricomes;Acaricomes phytoseiuli	0	0	2	0	0	0	0	0	2
Bacteria;Bacteria_none;Actinobacteria;Actinomycetia;Actinomycetales;Actinomycetaceae;Winkia;Winkia neuii	1	0	0	1	0	0	0	0	2
Bacteria;Bacteria_none;Actinobacteria;Actinomycetia;Propionibacteriales;Propionibacteriaceae;Tessaracoccus;Tessaracoccus coleopterorum	0	2	0	0	0	0	0	0	2
Bacteria;Bacteria_none;Firmicutes;Bacilli;Lactobacillales;Streptococcaceae;Streptococcus;Streptococcus devriesei	1	1	0	0	0	0	0	0	2
Bacteria;Bacteria_none;Firmicutes;Bacilli;Lactobacillales;Lactobacillaceae;Latilactobacillus;Latilactobacillus sakei	0	0	1	1	0	0	0	0	2
Bacteria;Bacteria_none;Firmicutes;Bacilli;Lactobacillales;Aerococcaceae;Suicoccus;Suicoccus acidiformans	1	0	1	0	0	0	0	0	2
Bacteria;Bacteria_none;Actinobacteria;Actinomycetia;Actinomycetales;Actinomycetaceae;Schaalia;Schaalia vaccimaxillae	0	1	1	0	0	0	0	0	2
Bacteria;Bacteria_none;Proteobacteria;Alphaproteobacteria;Hyphomicrobiales;Rhizobiaceae;Sinorhizobium;Sinorhizobium saheli	2	0	0	0	0	0	0	0	2
Bacteria;Bacteria_none;Proteobacteria;Betaproteobacteria;Burkholderiales;Comamonadaceae;Albitalea;Albitalea terrae	1	0	1	0	0	0	0	0	2
Bacteria;Bacteria_none;Proteobacteria;Gammaproteobacteria;Pasteurellales;Pasteurellaceae;Pasteurella;Pasteurella langaaensis	1	0	0	0	1	0	0	0	2
Bacteria;Bacteria_none;Proteobacteria;Alphaproteobacteria;Hyphomicrobiales;Rhizobiaceae;Sinorhizobium;Sinorhizobium chiapanecum	0	0	0	0	1	1	0	0	2
Bacteria;Bacteria_none;Proteobacteria;Alphaproteobacteria;Rhodobacterales;Roseobacteraceae;Primorskyibacter;Primorskyibacter flagellatus	1	1	0	0	0	0	0	0	2
Bacteria;Bacteria_none;Bacteroidota;Bacteroidia;Bacteroidales;Prevotellaceae;Prevotella;Prevotella shahii	0	0	0	0	0	1	0	1	2
Bacteria;Bacteria_none;Actinobacteria;Actinomycetia;Micromonosporales;Micromonosporaceae;Luedemannella;Luedemannella flava	1	0	0	1	0	0	0	0	2
Bacteria;Bacteria_none;Firmicutes;Bacilli;Bacillales;Alicyclobacillaceae;Alicyclobacillus;Alicyclobacillus aeris	1	0	1	0	0	0	0	0	2
Bacteria;Bacteria_none;Firmicutes;Bacilli;Bacillales;Alicyclobacillaceae;Alicyclobacillus;Alicyclobacillus macrosporangiidus	0	0	2	0	0	0	0	0	2
Bacteria;Bacteria_none;Bacteroidota;Flavobacteriia;Flavobacteriales;Weeksellaceae;Chryseobacterium;Chryseobacterium indologenes	0	2	0	0	0	0	0	0	2
Bacteria;Bacteria_none;Firmicutes;Bacilli;Lactobacillales;Carnobacteriaceae;Carnobacterium;Carnobacterium maltaromaticum	2	0	0	0	0	0	0	0	2
Bacteria;Bacteria_none;Proteobacteria;Alphaproteobacteria;Hyphomicrobiales;Stappiaceae;Pannonibacter;Pannonibacter indicus	0	2	0	0	0	0	0	0	2
Bacteria;Bacteria_none;Bacteroidota;Flavobacteriia;Flavobacteriales;Weeksellaceae;Chryseobacterium;Chryseobacterium oncorhynchi	2	0	0	0	0	0	0	0	2
Bacteria;Bacteria_none;Deinococcus-Thermus;Deinococci;Deinococcales;Deinococcaceae;Deinococcus;Deinococcus roseus	1	0	1	0	0	0	0	0	2
Bacteria;Bacteria_none;Deferribacteres;Deferribacteres;Deferribacterales;Geovibrionaceae;Seleniivibrio;Seleniivibrio woodruffii	2	0	0	0	0	0	0	0	2
Bacteria;Bacteria_none;Proteobacteria;Betaproteobacteria;Burkholderiales;Burkholderiaceae;Paraburkholderia;Paraburkholderia sabiae	1	1	0	0	0	0	0	0	2
Bacteria;Bacteria_none;Bacteroidota;Flavobacteriia;Flavobacteriales;Weeksellaceae;Empedobacter;Empedobacter brevis	1	0	0	0	0	0	1	0	2
Bacteria;Bacteria_none;Actinobacteria;Actinomycetia;Corynebacteriales;Gordoniaceae;Gordonia;Gordonia amarae	0	2	0	0	0	0	0	0	2
Bacteria;Bacteria_none;Proteobacteria;Alphaproteobacteria;Hyphomicrobiales;Pleomorphomonadaceae;Methylobrevis;Methylobrevis pamukkalensis	0	0	1	1	0	0	0	0	2
Bacteria;Bacteria_none;Spirochaetes;Spirochaetia;Spirochaetales;Breznakiellaceae;Leadbettera;Leadbettera azotonutricia	0	0	0	0	0	1	1	0	2
Bacteria;Bacteria_none;Proteobacteria;Alphaproteobacteria;Hyphomicrobiales;Xanthobacteraceae;Ancylobacter;Ancylobacter vacuolatus	0	0	0	2	0	0	0	0	2
Bacteria;Bacteria_none;Proteobacteria;Alphaproteobacteria;Hyphomicrobiales;Xanthobacteraceae;Ancylobacter;Ancylobacter sonchi	0	0	2	0	0	0	0	0	2
Bacteria;Bacteria_none;Proteobacteria;Alphaproteobacteria;Hyphomicrobiales;Xanthobacteraceae;Ancylobacter;Ancylobacter pratisalsi	1	0	0	0	0	1	0	0	2
Bacteria;Bacteria_none;Bacteroidota;Flavobacteriia;Flavobacteriales;Weeksellaceae;Chryseobacterium;Chryseobacterium salipaludis	2	0	0	0	0	0	0	0	2
Bacteria;Bacteria_none;Bacteroidota;Cytophagia;Cytophagales;Hymenobacteraceae;Pontibacter;Pontibacter brevis	0	0	2	0	0	0	0	0	2
Bacteria;Bacteria_none;Proteobacteria;Alphaproteobacteria;Hyphomicrobiales;Stappiaceae;Pseudovibrio;Pseudovibrio japonicus	0	0	2	0	0	0	0	0	2
Bacteria;Bacteria_none;Firmicutes;Bacilli;Lactobacillales;Carnobacteriaceae;Jeotgalibaca;Jeotgalibaca arthritidis	0	0	2	0	0	0	0	0	2
Bacteria;Bacteria_none;Deinococcus-Thermus;Deinococci;Deinococcales;Deinococcaceae;Deinococcus;Deinococcus xinjiangensis	0	0	2	0	0	0	0	0	2
Bacteria;Bacteria_none;Deinococcus-Thermus;Deinococci;Thermales;Thermaceae;Oceanithermus;Oceanithermus profundus	0	0	2	0	0	0	0	0	2
Bacteria;Bacteria_none;Actinobacteria;Actinomycetia;Corynebacteriales;Gordoniaceae;Gordonia;Gordonia desulfuricans	0	0	2	0	0	0	0	0	2
Bacteria;Bacteria_none;Actinobacteria;Actinomycetia;Corynebacteriales;Gordoniaceae;Gordonia;Gordonia hirsuta	0	1	0	1	0	0	0	0	2
Bacteria;Bacteria_none;Proteobacteria;Betaproteobacteria;Burkholderiales;Burkholderiales_Incertae_sedis;Paucibacter;Paucibacter toxinivorans	1	0	1	0	0	0	0	0	2
Bacteria;Bacteria_none;Proteobacteria;Betaproteobacteria;Burkholderiales;Burkholderiales_Incertae_sedis;Rhizobacter;Rhizobacter fulvus	0	2	0	0	0	0	0	0	2
Bacteria;Bacteria_none;Actinobacteria;Actinomycetia;Micrococcales;Microbacteriaceae;Microbacterium;Microbacterium oleivorans	0	1	0	1	0	0	0	0	2
Bacteria;Bacteria_none;Firmicutes;Bacilli;Lactobacillales;Lactobacillaceae;Pediococcus;Pediococcus claussenii	2	0	0	0	0	0	0	0	2
Bacteria;Bacteria_none;Proteobacteria;Gammaproteobacteria;Pseudomonadales;Pseudomonadaceae;Azorhizophilus;Azorhizophilus paspali	1	1	0	0	0	0	0	0	2
Bacteria;Bacteria_none;Actinobacteria;Actinomycetia;Micrococcales;Microbacteriaceae;Subtercola;Subtercola lobariae	0	0	0	0	2	0	0	0	2
Bacteria;Bacteria_none;Actinobacteria;Actinomycetia;Actinomycetales;Actinomycetaceae;Schaalia;Schaalia naturae	2	0	0	0	0	0	0	0	2
Bacteria;Bacteria_none;Firmicutes;Clostridia;Eubacteriales;Clostridiaceae;Clostridium;Clostridium zeae	0	1	0	0	0	0	1	0	2
Bacteria;Bacteria_none;Actinobacteria;Actinomycetia;Actinomycetales;Actinomycetaceae;Flaviflexus;Flaviflexus equikiangi	0	1	1	0	0	0	0	0	2
Bacteria;Bacteria_none;Proteobacteria;Alphaproteobacteria;Rhodobacterales;Roseobacteraceae;Oceaniovalibus;Oceaniovalibus guishaninsula	1	0	0	1	0	0	0	0	2
Bacteria;Bacteria_none;Bacteroidota;Bacteroidia;Bacteroidales;Prevotellaceae;Prevotella;Prevotella dentasini	0	0	1	1	0	0	0	0	2
Bacteria;Bacteria_none;Actinobacteria;Actinomycetia;Corynebacteriales;Gordoniaceae;Jongsikchunia;Jongsikchunia kroppenstedtii	0	0	1	0	0	1	0	0	2
Bacteria;Bacteria_none;Bacteroidota;Bacteroidia;Bacteroidales;Prevotellaceae;Prevotella;Prevotella brunnea	1	0	0	1	0	0	0	0	2
Bacteria;Bacteria_none;Proteobacteria;Alphaproteobacteria;Hyphomicrobiales;Rhizobiaceae;Rhizobium;Rhizobium gei	0	0	0	2	0	0	0	0	2
Bacteria;Bacteria_none;Actinobacteria;Actinomycetia;Micrococcales;Microbacteriaceae;Agromyces;Agromyces albus	0	2	0	0	0	0	0	0	2
Bacteria;Bacteria_none;Bacteroidota;Flavobacteriia;Flavobacteriales;Weeksellaceae;Apibacter;Apibacter muscae	2	0	0	0	0	0	0	0	2
Bacteria;Bacteria_none;Actinobacteria;Actinomycetia;Micrococcales;Microbacteriaceae;Rathayibacter;Rathayibacter toxicus	0	2	0	0	0	0	0	0	2
Bacteria;Bacteria_none;Actinobacteria;Actinomycetia;Micrococcales;Microbacteriaceae;Agrococcus;Agrococcus versicolor	1	1	0	0	0	0	0	0	2
Bacteria;Bacteria_none;Firmicutes;Tissierellia;Tissierellales;Tissierellaceae;Tissierella;Tissierella carlieri	0	1	0	0	0	1	0	0	2
Bacteria;Bacteria_none;Firmicutes;Clostridia;Eubacteriales;Clostridiaceae;Alkaliphilus;Alkaliphilus pronyensis	0	0	2	0	0	0	0	0	2
Bacteria;Bacteria_none;Firmicutes;Bacilli;Lactobacillales;Streptococcaceae;Lactococcus;Lactococcus formosensis	1	1	0	0	0	0	0	0	2
Bacteria;Bacteria_none;Proteobacteria;Alphaproteobacteria;Hyphomicrobiales;Rhizobiaceae;Pseudorhizobium;Pseudorhizobium endolithicum	0	0	2	0	0	0	0	0	2
Bacteria;Bacteria_none;Bacteroidota;Flavobacteriia;Flavobacteriales;Weeksellaceae;Chryseobacterium;Chryseobacterium elymi	1	1	0	0	0	0	0	0	2
Bacteria;Bacteria_none;Proteobacteria;Gammaproteobacteria;Oceanospirillales;Oceanospirillaceae;Marinomonas;Marinomonas algicola	2	0	0	0	0	0	0	0	2
Bacteria;Bacteria_none;Firmicutes;Tissierellia;Tissierellales;Tissierellaceae;Tepidimicrobium;Tepidimicrobium xylanilyticum	0	0	2	0	0	0	0	0	2
Bacteria;Bacteria_none;Proteobacteria;Betaproteobacteria;Burkholderiales;Comamonadaceae;Kinneretia;Kinneretia asaccharophila	2	0	0	0	0	0	0	0	2
Bacteria;Bacteria_none;Actinobacteria;Actinomycetia;Corynebacteriales;Gordoniaceae;Millisia;Millisia brevis	0	1	1	0	0	0	0	0	2
Bacteria;Bacteria_none;Proteobacteria;Alphaproteobacteria;Rhodobacterales;Rhodobacteraceae;Yoonia;Yoonia vestfoldensis	0	1	0	0	0	1	0	0	2
Bacteria;Bacteria_none;Firmicutes;Bacilli;Bacillales;Bacillaceae;Alkalihalobacillus;Alkalihalobacillus bogoriensis	0	0	0	1	1	0	0	0	2
Bacteria;Bacteria_none;Bacteroidota;Bacteroidia;Bacteroidales;Porphyromonadaceae;Porphyromonas;Porphyromonas circumdentaria	0	0	0	2	0	0	0	0	2
Bacteria;Bacteria_none;Firmicutes;Tissierellia;Tissierellales;Tissierellaceae;Keratinibaculum;Keratinibaculum paraultunense	0	1	0	0	0	1	0	0	2
Bacteria;Bacteria_none;Firmicutes;Bacilli;Lactobacillales;Lactobacillaceae;Lentilactobacillus;Lentilactobacillus hilgardii	1	0	1	0	0	0	0	0	2
Bacteria;Bacteria_none;Proteobacteria;Alphaproteobacteria;Rhodobacterales;Rhodobacteraceae;Solirhodobacter;Solirhodobacter olei	1	1	0	0	0	0	0	0	2
Bacteria;Bacteria_none;Proteobacteria;Gammaproteobacteria;Pasteurellales;Pasteurellaceae;Gallibacterium;Gallibacterium melopsittaci	1	0	1	0	0	0	0	0	2
Bacteria;Bacteria_none;Proteobacteria;Alphaproteobacteria;Hyphomicrobiales;Rhizobiaceae;Mycoplana;Mycoplana azooxidifex	0	1	0	0	1	0	0	0	2
Bacteria;Bacteria_none;Actinobacteria;Actinomycetia;Actinomycetales;Actinomycetaceae;Peptidiphaga;Peptidiphaga gingivicola	0	1	0	0	1	0	0	0	2
Bacteria;Bacteria_none;Proteobacteria;Alphaproteobacteria;Rhodobacterales;Roseobacteraceae;Phaeobacter;Phaeobacter gallaeciensis	0	1	0	1	0	0	0	0	2
Bacteria;Bacteria_none;Firmicutes;Bacilli;Lactobacillales;Lactobacillaceae;Lentilactobacillus;Lentilactobacillus diolivorans	0	0	2	0	0	0	0	0	2
Bacteria;Bacteria_none;Proteobacteria;Alphaproteobacteria;Hyphomicrobiales;Rhizobiaceae;Rhizobium;Rhizobium tubonense	0	1	0	1	0	0	0	0	2
Bacteria;Bacteria_none;Proteobacteria;Gammaproteobacteria;Pasteurellales;Pasteurellaceae;Aggregatibacter;Aggregatibacter actinomycetemcomitans	1	0	1	0	0	0	0	0	2
Bacteria;Bacteria_none;Bacteroidota;Flavobacteriia;Flavobacteriales;Flavobacteriaceae;Spongiiferula;Spongiiferula fulva	0	0	2	0	0	0	0	0	2
Bacteria;Bacteria_none;Proteobacteria;Alphaproteobacteria;Hyphomicrobiales;Rhizobiaceae;Rhizobium;Rhizobium terrae	1	0	0	1	0	0	0	0	2
Bacteria;Bacteria_none;Proteobacteria;Alphaproteobacteria;Hyphomicrobiales;Rhizobiaceae;Rhizobium;Rhizobium taibaishanense	1	0	0	1	0	0	0	0	2
Bacteria;Bacteria_none;Proteobacteria;Alphaproteobacteria;Hyphomicrobiales;Methylobacteriaceae;Microvirga;Microvirga ossetica	0	2	0	0	0	0	0	0	2
Bacteria;Bacteria_none;Actinobacteria;Actinomycetia;Actinomycetales;Actinomycetaceae;Gleimia;Gleimia hominis	0	0	0	2	0	0	0	0	2
Bacteria;Bacteria_none;Bacteroidota;Flavobacteriia;Flavobacteriales;Flavobacteriaceae;Sungkyunkwania;Sungkyunkwania multivorans	0	0	1	0	0	1	0	0	2
Bacteria;Bacteria_none;Firmicutes;Bacilli;Bacillales;Alicyclobacillaceae;Tumebacillus;Tumebacillus flagellatus	0	1	0	1	0	0	0	0	2
Bacteria;Bacteria_none;Firmicutes;Bacilli;Bacillales;Alicyclobacillaceae;Effusibacillus;Effusibacillus pohliae	0	0	0	0	0	2	0	0	2
Bacteria;Bacteria_none;Bacteroidota;Bacteroidia;Bacteroidales;Prevotellaceae;Prevotella;Prevotella lascolaii	0	0	0	1	0	0	0	1	2
Bacteria;Bacteria_none;Proteobacteria;Alphaproteobacteria;Hyphomicrobiales;Rhizobiaceae;Rhizobium;Rhizobium populi	0	0	1	0	1	0	0	0	2
Bacteria;Bacteria_none;Bacteroidota;Flavobacteriia;Flavobacteriales;Flavobacteriaceae;Vaginella;Vaginella massiliensis	2	0	0	0	0	0	0	0	2
Bacteria;Bacteria_none;Firmicutes;Bacilli;Lactobacillales;Aerococcaceae;Facklamia;Facklamia languida	0	2	0	0	0	0	0	0	2
Bacteria;Bacteria_none;Fusobacteria;Fusobacteriia;Fusobacteriales;Leptotrichiaceae;Leptotrichia;Leptotrichia hofstadii	2	0	0	0	0	0	0	0	2
Bacteria;Bacteria_none;Proteobacteria;Alphaproteobacteria;Hyphomicrobiales;Rhizobiaceae;Neorhizobium;Neorhizobium galegae	1	1	0	0	0	0	0	0	2
Bacteria;Bacteria_none;Bacteroidota;Flavobacteriia;Flavobacteriales;Weeksellaceae;Chryseobacterium;Chryseobacterium frigidum	1	0	0	0	0	0	0	1	2
Bacteria;Bacteria_none;Bacteroidota;Bacteroidia;Bacteroidales;Prevotellaceae;Prevotella;Prevotella fusca	0	0	0	0	0	0	2	0	2
Bacteria;Bacteria_none;Bacteroidota;Bacteroidia;Bacteroidales;Prevotellaceae;Prevotella;Prevotella falsenii	1	0	1	0	0	0	0	0	2
Bacteria;Bacteria_none;Proteobacteria;Betaproteobacteria;Burkholderiales;Burkholderiaceae;Paraburkholderia;Paraburkholderia piptadeniae	2	0	0	0	0	0	0	0	2
Bacteria;Bacteria_none;Chloroflexi;Dehalococcoidia;Dehalococcoidia_Incertae_sedis;Dehalococcoidia_Incertae_sedis;Dehalogenimonas;Dehalogenimonas alkenigignens	0	2	0	0	0	0	0	0	2
Bacteria;Bacteria_none;Proteobacteria;Gammaproteobacteria;Pseudomonadales;Pseudomonadaceae;Pseudomonas;Pseudomonas daroniae	1	0	1	0	0	0	0	0	2
Bacteria;Bacteria_none;Proteobacteria;Alphaproteobacteria;Hyphomicrobiales;Phyllobacteriaceae;Nitratireductor;Nitratireductor pacificus	0	0	2	0	0	0	0	0	2
Bacteria;Bacteria_none;Proteobacteria;Alphaproteobacteria;Rhodobacterales;Rhodobacteraceae;Albirhodobacter;Albirhodobacter confluentis	1	1	0	0	0	0	0	0	2
Bacteria;Bacteria_none;Proteobacteria;Alphaproteobacteria;Caulobacterales;Caulobacteraceae;Brevundimonas;Brevundimonas goettingensis	0	2	0	0	0	0	0	0	2
Bacteria;Bacteria_none;Tenericutes;Mollicutes;Mycoplasmatales;Mycoplasmataceae;Mycoplasma;Mycoplasma spermatophilum	0	2	0	0	0	0	0	0	2
Bacteria;Bacteria_none;Proteobacteria;Gammaproteobacteria;Pseudomonadales;Pseudomonadaceae;Pseudomonas;Pseudomonas zeshuii	0	0	2	0	0	0	0	0	2
Bacteria;Bacteria_none;Proteobacteria;Alphaproteobacteria;Rhodospirillales;Acetobacteraceae;Acidocella;Acidocella aminolytica	2	0	0	0	0	0	0	0	2
Bacteria;Bacteria_none;Proteobacteria;Alphaproteobacteria;Hyphomicrobiales;Methylobacteriaceae;Methylobacterium;Methylobacterium oryzae	0	0	2	0	0	0	0	0	2
Bacteria;Bacteria_none;Proteobacteria;Alphaproteobacteria;Hyphomicrobiales;Methylobacteriaceae;Methylobacterium;Methylobacterium persicinum	0	0	0	1	0	1	0	0	2
Bacteria;Bacteria_none;Actinobacteria;Actinomycetia;Micrococcales;Microbacteriaceae;Puzihella;Puzihella rosea	0	2	0	0	0	0	0	0	2
Bacteria;Bacteria_none;Spirochaetes;Spirochaetia;Brachyspirales;Brachyspiraceae;Brachyspira;Brachyspira murdochii	0	1	0	1	0	0	0	0	2
Bacteria;Bacteria_none;Bacteroidota;Chitinophagia;Chitinophagales;Chitinophagaceae;Chitinophaga;Chitinophaga pinensis	2	0	0	0	0	0	0	0	2
Bacteria;Bacteria_none;Chloroflexi;Ktedonobacteria;Ktedonobacterales;Dictyobacteraceae;Tengunoibacter;Tengunoibacter tsumagoiensis	0	0	0	0	2	0	0	0	2
Bacteria;Bacteria_none;Proteobacteria;Betaproteobacteria;Burkholderiales;Burkholderiaceae;Caballeronia;Caballeronia choica	1	0	0	0	0	0	1	0	2
Bacteria;Bacteria_none;Proteobacteria;Alphaproteobacteria;Caulobacterales;Caulobacteraceae;Asticcacaulis;Asticcacaulis solisilvae	0	0	0	2	0	0	0	0	2
Bacteria;Bacteria_none;Proteobacteria;Alphaproteobacteria;Hyphomicrobiales;Phyllobacteriaceae;Oryzicola;Oryzicola mucosus	1	0	0	1	0	0	0	0	2
Bacteria;Bacteria_none;Proteobacteria;Betaproteobacteria;Burkholderiales;Burkholderiaceae;Caballeronia;Caballeronia humi	1	0	1	0	0	0	0	0	2
Bacteria;Bacteria_none;Proteobacteria;Betaproteobacteria;Burkholderiales;Burkholderiaceae;Caballeronia;Caballeronia megalochromosomata	1	0	1	0	0	0	0	0	2
Bacteria;Bacteria_none;Bacteroidota;Cytophagia;Cytophagales;Persicobacteraceae;Persicobacter;Persicobacter diffluens	0	0	0	0	0	0	0	2	2
Bacteria;Bacteria_none;Chlamydiae;Chlamydiia;Parachlamydiales;Criblamydiaceae;Criblamydia;Criblamydia sequanensis	0	2	0	0	0	0	0	0	2
Bacteria;Bacteria_none;Proteobacteria;Gammaproteobacteria;Pseudomonadales;Pseudomonadaceae;Pseudomonas;Pseudomonas schmalbachii	2	0	0	0	0	0	0	0	2
Bacteria;Bacteria_none;Proteobacteria;Gammaproteobacteria;Pseudomonadales;Pseudomonadaceae;Pseudomonas;Pseudomonas putida	0	0	0	2	0	0	0	0	2
Bacteria;Bacteria_none;Proteobacteria;Alphaproteobacteria;Micropepsales;Micropepsaceae;Rhizomicrobium;Rhizomicrobium palustre	2	0	0	0	0	0	0	0	2
Bacteria;Bacteria_none;Proteobacteria;Gammaproteobacteria;Xanthomonadales;Xanthomonadaceae;Stenotrophomonas;Stenotrophomonas panacihumi	2	0	0	0	0	0	0	0	2
Bacteria;Bacteria_none;Spirochaetes;Spirochaetia;Brachyspirales;Brachyspiraceae;Brachyspira;Brachyspira aalborgi	1	0	0	0	1	0	0	0	2
Bacteria;Bacteria_none;Bacteroidota;Chitinophagia;Chitinophagales;Chitinophagaceae;Flaviaesturariibacter;Flaviaesturariibacter aridisoli	2	0	0	0	0	0	0	0	2
Bacteria;Bacteria_none;Proteobacteria;Alphaproteobacteria;Hyphomicrobiales;Nitrobacteraceae;Bradyrhizobium;Bradyrhizobium archetypum	0	2	0	0	0	0	0	0	2
Bacteria;Bacteria_none;Firmicutes;Bacilli;Lactobacillales;Lactobacillaceae;Limosilactobacillus;[Lactobacillus] timonensis	1	0	0	0	0	1	0	0	2
Bacteria;Bacteria_none;Proteobacteria;Alphaproteobacteria;Caulobacterales;Caulobacteraceae;Brevundimonas;Brevundimonas humi	1	0	1	0	0	0	0	0	2
Bacteria;Bacteria_none;Proteobacteria;Betaproteobacteria;Burkholderiales;Alcaligenaceae;Achromobacter;Achromobacter pestifer	2	0	0	0	0	0	0	0	2
Bacteria;Bacteria_none;Cyanobacteria;Cyanobacteria_Incertae_sedis;Pseudanabaenales;Leptolyngbyaceae;Arthronema;Arthronema gygaxiana	0	0	2	0	0	0	0	0	2
Bacteria;Bacteria_none;Actinobacteria;Actinomycetia;Corynebacteriales;Corynebacteriaceae;Corynebacterium;Corynebacterium aurimucosum	0	2	0	0	0	0	0	0	2
Bacteria;Bacteria_none;Proteobacteria;Alphaproteobacteria;Rhodospirillales;Acetobacteraceae;Endobacter;Endobacter medicaginis	0	0	1	0	1	0	0	0	2
Bacteria;Bacteria_none;Firmicutes;Bacilli;Lactobacillales;Lactobacillaceae;Limosilactobacillus;Limosilactobacillus pontis	2	0	0	0	0	0	0	0	2
Bacteria;Bacteria_none;Proteobacteria;Betaproteobacteria;Burkholderiales;Alcaligenaceae;Alcaligenes;Alcaligenes endophyticus	1	0	0	0	0	0	1	0	2
Bacteria;Bacteria_none;Actinobacteria;Actinomycetia;Micrococcales;Microbacteriaceae;Amnibacterium;Amnibacterium flavum	0	2	0	0	0	0	0	0	2
Bacteria;Bacteria_none;Actinobacteria;Actinomycetia;Bifidobacteriales;Bifidobacteriaceae;Neoscardovia;Neoscardovia arbecensis	0	1	0	1	0	0	0	0	2
Bacteria;Bacteria_none;Bacteroidota;Chitinophagia;Chitinophagales;Chitinophagaceae;Flavisolibacter;Flavisolibacter carri	2	0	0	0	0	0	0	0	2
Bacteria;Bacteria_none;Proteobacteria;Betaproteobacteria;Burkholderiales;Alcaligenaceae;Basilea;Basilea psittacipulmonis	2	0	0	0	0	0	0	0	2
Bacteria;Bacteria_none;Proteobacteria;Alphaproteobacteria;Caulobacterales;Caulobacteraceae;Phenylobacterium;Phenylobacterium deserti	1	0	0	1	0	0	0	0	2
Bacteria;Bacteria_none;Proteobacteria;Alphaproteobacteria;Caulobacterales;Caulobacteraceae;Caulobacter;Caulobacter vibrioides	1	0	0	0	0	0	0	1	2
Bacteria;Bacteria_none;Tenericutes;Mollicutes;Mycoplasmatales;Mycoplasmataceae;Mycoplasma;Mycoplasma marinum	0	1	0	1	0	0	0	0	2
Bacteria;Bacteria_none;Proteobacteria;Betaproteobacteria;Burkholderiales;Alcaligenaceae;Castellaniella;Castellaniella defragrans	1	0	0	0	0	1	0	0	2
Bacteria;Bacteria_none;Cyanobacteria;Cyanobacteria_Incertae_sedis;Pseudanabaenales;Leptolyngbyaceae;Leptodesmis;Leptodesmis alaskaensis	0	0	1	0	0	0	1	0	2
Bacteria;Bacteria_none;Cyanobacteria;Cyanobacteria_Incertae_sedis;Pseudanabaenales;Leptolyngbyaceae;Leptoelongatus;Leptoelongatus litoralis	1	0	0	0	0	1	0	0	2
Bacteria;Bacteria_none;Cyanobacteria;Cyanobacteria_Incertae_sedis;Pseudanabaenales;Leptolyngbyaceae;Myxacorys;Myxacorys californica	0	2	0	0	0	0	0	0	2
Bacteria;Bacteria_none;Proteobacteria;Betaproteobacteria;Burkholderiales;Alcaligenaceae;Kerstersia;Kerstersia similis	0	0	0	0	0	1	1	0	2
Bacteria;Bacteria_none;Proteobacteria;Betaproteobacteria;Burkholderiales;Alcaligenaceae;Oligella;Oligella ureolytica	1	1	0	0	0	0	0	0	2
Bacteria;Bacteria_none;Proteobacteria;Alphaproteobacteria;Caulobacterales;Caulobacteraceae;Brevundimonas;Brevundimonas nasdae	0	2	0	0	0	0	0	0	2
Bacteria;Bacteria_none;Proteobacteria;Gammaproteobacteria;Salinisphaerales;Salinisphaeraceae;Salinisphaera;Salinisphaera japonica	0	0	0	2	0	0	0	0	2
Bacteria;Bacteria_none;Proteobacteria;Gammaproteobacteria;Salinisphaerales;Salinisphaeraceae;Halophibacterium;Halophibacterium profundimaris	0	2	0	0	0	0	0	0	2
Bacteria;Bacteria_none;Proteobacteria;Alphaproteobacteria;Hyphomicrobiales;Methylobacteriaceae;Methylobacterium;Methylobacterium indicum	2	0	0	0	0	0	0	0	2
Bacteria;Bacteria_none;Proteobacteria;Alphaproteobacteria;Hyphomicrobiales;Phyllobacteriaceae;Phyllobacterium;Phyllobacterium leguminum	1	1	0	0	0	0	0	0	2
Bacteria;Bacteria_none;Cyanobacteria;Cyanobacteria_Incertae_sedis;Pseudanabaenales;Oculatellaceae;Oculatella;Oculatella atacamensis	0	1	0	1	0	0	0	0	2
Bacteria;Bacteria_none;Thermotogae;Thermotogae;Kosmotogales;Kosmotogaceae;Kosmotoga;Kosmotoga olearia	0	0	2	0	0	0	0	0	2
Bacteria;Bacteria_none;Firmicutes;Bacilli;Lactobacillales;Enterococcaceae;Enterococcus;Enterococcus gilvus	2	0	0	0	0	0	0	0	2
Bacteria;Bacteria_none;Actinobacteria;Actinomycetia;Micrococcales;Microbacteriaceae;Chryseoglobus;Chryseoglobus frigidaquae	1	1	0	0	0	0	0	0	2
Bacteria;Bacteria_none;Firmicutes;Bacilli;Lactobacillales;Enterococcaceae;Enterococcus;Enterococcus florum	1	0	1	0	0	0	0	0	2
Bacteria;Bacteria_none;Proteobacteria;Acidithiobacillia;Acidithiobacillales;Acidithiobacillaceae;Acidithiobacillus;Acidithiobacillus caldus	1	1	0	0	0	0	0	0	2
Bacteria;Bacteria_none;Proteobacteria;Gammaproteobacteria;Pseudomonadales;Pseudomonadaceae;Pseudomonas;Pseudomonas matsuisoli	0	0	1	1	0	0	0	0	2
Bacteria;Bacteria_none;Proteobacteria;Alphaproteobacteria;Hyphomonadales;Hyphomonadaceae;Hirschia;Hirschia litorea	2	0	0	0	0	0	0	0	2
Bacteria;Bacteria_none;Cyanobacteria;Cyanobacteria_Incertae_sedis;Synechococcales;Chamaesiphonaceae;Chamaesiphon;Chamaesiphon subglobosus	1	0	1	0	0	0	0	0	2
Bacteria;Bacteria_none;Proteobacteria;Alphaproteobacteria;Hyphomicrobiales;Methylobacteriaceae;Methylorubrum;Methylorubrum salsuginis	2	0	0	0	0	0	0	0	2
Bacteria;Bacteria_none;Proteobacteria;Gammaproteobacteria;Pseudomonadales;Pseudomonadaceae;Pseudomonas;Pseudomonas mangrovi	0	0	1	1	0	0	0	0	2
Bacteria;Bacteria_none;Cyanobacteria;Cyanobacteria_Incertae_sedis;Synechococcales;Synechococcales_Incertae_sedis;Altericista;Altericista variichlora	0	1	1	0	0	0	0	0	2
Bacteria;Bacteria_none;Firmicutes;Bacilli;Lactobacillales;Lactobacillaceae;Lactobacillus;Lactobacillus xujianguonis	1	0	0	1	0	0	0	0	2
Bacteria;Bacteria_none;Proteobacteria;Gammaproteobacteria;Pseudomonadales;Pseudomonadaceae;Pseudomonas;Pseudomonas indica	0	0	1	1	0	0	0	0	2
Bacteria;Bacteria_none;Proteobacteria;Betaproteobacteria;Burkholderiales;Burkholderiaceae;Paraburkholderia;Paraburkholderia diazotrophica	2	0	0	0	0	0	0	0	2
Bacteria;Bacteria_none;Proteobacteria;Alphaproteobacteria;Rhodobacterales;Roseobacteraceae;Thalassobius;Thalassobius litorarius	0	1	1	0	0	0	0	0	2
Bacteria;Bacteria_none;Planctomycetota;Planctomycetia;Pirellulales;Pirellulaceae;Roseimaritima;Roseimaritima multifibrata	0	1	0	1	0	0	0	0	2
Bacteria;Bacteria_none;Cyanobacteria;Cyanobacteria_Incertae_sedis;Synechococcales;Synechococcales_Incertae_sedis;Gibliniella;Gibliniella alaskaensis	0	0	0	0	0	0	0	2	2
Bacteria;Bacteria_none;Bacteroidota;Cytophagia;Cytophagales;Marivirgaceae;Marivirga;Marivirga lumbricoides	0	0	0	0	0	1	0	1	2
Bacteria;Bacteria_none;Bacteroidota;Cytophagia;Cytophagales;Hymenobacteraceae;Pontibacter;Pontibacter yuliensis	0	0	0	0	0	2	0	0	2
Bacteria;Bacteria_none;Firmicutes;Bacilli;Lactobacillales;Streptococcaceae;Streptococcus;Streptococcus infantis	1	0	0	0	1	0	0	0	2
Bacteria;Bacteria_none;Thermotogae;Thermotogae;Thermotogales;Thermotogaceae;Thermotoga;Thermotoga caldifontis	1	1	0	0	0	0	0	0	2
Bacteria;Bacteria_none;Firmicutes;Bacilli;Lactobacillales;Lactobacillaceae;Oenococcus;Oenococcus oeni	0	1	1	0	0	0	0	0	2
Bacteria;Bacteria_none;Planctomycetota;Planctomycetia;Pirellulales;Pirellulaceae;Novipirellula;Novipirellula artificiosorum	0	2	0	0	0	0	0	0	2
Bacteria;Bacteria_none;Bacteroidota;Bacteroidia;Marinilabiliales;Marinilabiliaceae;Carboxylicivirga;Carboxylicivirga linearis	0	0	1	1	0	0	0	0	2
Bacteria;Bacteria_none;Proteobacteria;Alphaproteobacteria;Rhodobacterales;Rhodobacteraceae;Roseitranquillus;Roseitranquillus sediminis	0	1	1	0	0	0	0	0	2
Bacteria;Bacteria_none;Proteobacteria;Gammaproteobacteria;Pseudomonadales;Pseudomonadaceae;Pseudomonas;Pseudomonas monteilii	0	0	2	0	0	0	0	0	2
Bacteria;Bacteria_none;Proteobacteria;Alphaproteobacteria;Hyphomicrobiales;Hyphomicrobiaceae;Limoniibacter;Limoniibacter endophyticus	0	1	1	0	0	0	0	0	2
Bacteria;Bacteria_none;Firmicutes;Bacilli;Lactobacillales;Enterococcaceae;Enterococcus;Enterococcus haemoperoxidus	2	0	0	0	0	0	0	0	2
Bacteria;Bacteria_none;Actinobacteria;Actinomycetia;Micrococcales;Microbacteriaceae;Arenivirga;Arenivirga flava	0	0	1	1	0	0	0	0	2
Bacteria;Bacteria_none;Proteobacteria;Betaproteobacteria;Burkholderiales;Burkholderiaceae;Hydromonas;Hydromonas duriensis	1	0	0	1	0	0	0	0	2
Bacteria;Bacteria_none;Actinobacteria;Actinomycetia;Corynebacteriales;Corynebacteriaceae;Corynebacterium;Corynebacterium xerosis	2	0	0	0	0	0	0	0	2
Bacteria;Bacteria_none;Proteobacteria;Alphaproteobacteria;Hyphomicrobiales;Methylobacteriaceae;Methylobacterium;Methylobacterium radiotolerans	0	0	0	0	0	2	0	0	2
Bacteria;Bacteria_none;Proteobacteria;Alphaproteobacteria;Rhodobacterales;Rhodobacteraceae;Rhodovulum;Rhodovulum sulfidophilum	0	0	0	2	0	0	0	0	2
Bacteria;Bacteria_none;Proteobacteria;Gammaproteobacteria;Pseudomonadales;Pseudomonadaceae;Pseudomonas;Pseudomonas pharmacofabricae	1	0	1	0	0	0	0	0	2
Bacteria;Bacteria_none;Actinobacteria;Actinomycetia;Bifidobacteriales;Bifidobacteriaceae;Bifidobacterium;Bifidobacterium aquikefiri	0	2	0	0	0	0	0	0	2
Bacteria;Bacteria_none;Proteobacteria;Alphaproteobacteria;Maricaulales;Maricaulaceae;Marinicauda;Marinicauda algicola	0	1	0	0	1	0	0	0	2
Bacteria;Bacteria_none;Bacteroidota;Flavobacteriia;Flavobacteriales;Flavobacteriaceae;Lacinutrix;Lacinutrix mariniflava	0	2	0	0	0	0	0	0	2
Bacteria;Bacteria_none;Thermodesulfobacteria;Thermodesulfobacteria;Thermodesulfobacteriales;Thermodesulfobacteriaceae;Thermosulfuriphilus;Thermosulfuriphilus ammonigenes	0	0	2	0	0	0	0	0	2
Bacteria;Bacteria_none;Actinobacteria;Actinomycetia;Micrococcales;Microbacteriaceae;Rathayibacter;Rathayibacter iranicus	0	0	0	0	0	0	2	0	2
Bacteria;Bacteria_none;Rhodothermaeota;Rhodothermia;Rhodothermales;Salinibacteraceae;Salinivenus;Salinivenus lutea	0	0	1	0	0	0	0	0	1
Bacteria;Bacteria_none;Firmicutes;Bacilli;Lactobacillales;Lactobacillaceae;Lentilactobacillus;Lentilactobacillus otakiensis	1	0	0	0	0	0	0	0	1
Bacteria;Bacteria_none;Actinobacteria;Actinomycetia;Propionibacteriales;Nocardioidaceae;Nocardioides;Nocardioides pyridinolyticus	0	0	0	0	0	0	1	0	1
Bacteria;Bacteria_none;Firmicutes;Bacilli;Lactobacillales;Lactobacillaceae;Leuconostoc;Leuconostoc gelidum	1	0	0	0	0	0	0	0	1
Bacteria;Bacteria_none;Proteobacteria;Gammaproteobacteria;Enterobacterales;Yersiniaceae;Serratia;Serratia rubidaea	0	0	0	1	0	0	0	0	1
Bacteria;Bacteria_none;Proteobacteria;Oligoflexia;Bacteriovoracales;Halobacteriovoraceae;Halobacteriovorax;Halobacteriovorax litoralis	0	0	0	1	0	0	0	0	1
Bacteria;Bacteria_none;Firmicutes;Bacilli;Lactobacillales;Lactobacillaceae;Lentilactobacillus;Lentilactobacillus laojiaonis	0	0	1	0	0	0	0	0	1
Bacteria;Bacteria_none;Actinobacteria;Actinomycetia;Micrococcales;Microbacteriaceae;Pseudoclavibacter;Pseudoclavibacter endophyticus	0	0	1	0	0	0	0	0	1
Bacteria;Bacteria_none;Proteobacteria;Zetaproteobacteria;Zetaproteobacteria_Incertae_sedis;Zetaproteobacteria_Incertae_sedis;Ghiorsea;Ghiorsea bivora	1	0	0	0	0	0	0	0	1
Bacteria;Bacteria_none;Proteobacteria;Gammaproteobacteria;Enterobacterales;Yersiniaceae;Serratia;Serratia bozhouensis	1	0	0	0	0	0	0	0	1
Bacteria;Bacteria_none;Spirochaetes;Spirochaetia;Spirochaetales;Spirochaetaceae;Spirochaeta;Spirochaeta cellobiosiphila	0	1	0	0	0	0	0	0	1
Bacteria;Bacteria_none;Actinobacteria;Actinomycetia;Micrococcales;Brevibacteriaceae;Brevibacterium;Brevibacterium otitidis	0	0	0	1	0	0	0	0	1
Bacteria;Bacteria_none;Acidobacteria;Blastocatellia;Blastocatellales;Blastocatellaceae;Aridibacter;Aridibacter kavangonensis	1	0	0	0	0	0	0	0	1
Bacteria;Bacteria_none;Firmicutes;Bacilli;Lactobacillales;Lactobacillaceae;Leuconostoc;Leuconostoc fallax	1	0	0	0	0	0	0	0	1
Bacteria;Bacteria_none;Actinobacteria;Actinomycetia;Propionibacteriales;Nocardioidaceae;Nocardioides;Nocardioides zeicaulis	0	1	0	0	0	0	0	0	1
Bacteria;Bacteria_none;Actinobacteria;Actinomycetia;Micrococcales;Dermatophilaceae;Mobilicoccus;Mobilicoccus caccae	0	0	1	0	0	0	0	0	1
Bacteria;Bacteria_none;Spirochaetes;Spirochaetia;Spirochaetales;Sphaerochaetaceae;Sphaerochaeta;Sphaerochaeta coccoides	0	1	0	0	0	0	0	0	1
Bacteria;Bacteria_none;Firmicutes;Bacilli;Bacillales;Planococcaceae;Rummeliibacillus;Rummeliibacillus suwonensis	0	0	1	0	0	0	0	0	1
Bacteria;Bacteria_none;Actinobacteria;Actinomycetia;Micrococcales;Dermatophilaceae;Mobilicoccus;Mobilicoccus pelagius	0	0	0	1	0	0	0	0	1
Bacteria;Bacteria_none;Actinobacteria;Actinomycetia;Propionibacteriales;Nocardioidaceae;Nocardioides;Nocardioides terrae	1	0	0	0	0	0	0	0	1
Bacteria;Bacteria_none;Actinobacteria;Actinomycetia;Propionibacteriales;Nocardioidaceae;Nocardioides;Nocardioides silvaticus	1	0	0	0	0	0	0	0	1
Bacteria;Bacteria_none;Actinobacteria;Actinomycetia;Micrococcales;Dermatophilaceae;Tonsilliphilus;Tonsilliphilus suis	0	0	1	0	0	0	0	0	1
Bacteria;Bacteria_none;Spirochaetes;Spirochaetia;Spirochaetales;Spirochaetaceae;Sediminispirochaeta;Sediminispirochaeta smaragdinae	0	1	0	0	0	0	0	0	1
Bacteria;Bacteria_none;Firmicutes;Bacilli;Bacillales;Planococcaceae;Planococcus;Planococcus lenghuensis	0	1	0	0	0	0	0	0	1
Bacteria;Bacteria_none;Spirochaetes;Spirochaetia;Brachyspirales;Brachyspiraceae;Brachyspira;Brachyspira hyodysenteriae	1	0	0	0	0	0	0	0	1
Bacteria;Bacteria_none;Actinobacteria;Actinomycetia;Propionibacteriales;Nocardioidaceae;Nocardioides;Nocardioides rotundus	0	1	0	0	0	0	0	0	1
Bacteria;Bacteria_none;Actinobacteria;Actinomycetia;Micrococcales;Microbacteriaceae;Pseudoclavibacter;Pseudoclavibacter helvolus	1	0	0	0	0	0	0	0	1
Bacteria;Bacteria_none;Proteobacteria;Gammaproteobacteria;Gammaproteobacteria_Incertae_sedis;Gammaproteobacteria_Incertae_sedis;Alkalimonas;Alkalimonas collagenimarina	1	0	0	0	0	0	0	0	1
Bacteria;Bacteria_none;Actinobacteria;Actinomycetia;Propionibacteriales;Propionibacteriaceae;Cutibacterium;Cutibacterium porci	0	0	1	0	0	0	0	0	1
Bacteria;Bacteria_none;Actinobacteria;Actinomycetia;Micrococcales;Microbacteriaceae;Pontimonas;Pontimonas salivibrio	0	0	0	1	0	0	0	0	1
Bacteria;Bacteria_none;Tenericutes;Mollicutes;Mycoplasmatales;Mycoplasmataceae;Mycoplasmopsis;Mycoplasmopsis pulmonis	0	0	0	1	0	0	0	0	1
Bacteria;Bacteria_none;Firmicutes;Bacilli;Lactobacillales;Lactobacillaceae;Loigolactobacillus;Loigolactobacillus rennini	0	0	0	0	1	0	0	0	1
Bacteria;Bacteria_none;Thermotogae;Thermotogae;Petrotogales;Petrotogaceae;Marinitoga;Marinitoga piezophila	0	0	1	0	0	0	0	0	1
Bacteria;Bacteria_none;Actinobacteria;Actinomycetia;Propionibacteriales;Propionibacteriaceae;Microlunatus;Microlunatus panaciterrae	0	0	1	0	0	0	0	0	1
Bacteria;Bacteria_none;Thermotogae;Thermotogae;Mesoaciditogales;Mesoaciditogaceae;Mesoaciditoga;Mesoaciditoga lauensis	1	0	0	0	0	0	0	0	1
Bacteria;Bacteria_none;Actinobacteria;Actinomycetia;Propionibacteriales;Propionibacteriaceae;Microlunatus;Microlunatus lucidus	0	0	1	0	0	0	0	0	1
Bacteria;Bacteria_none;Tenericutes;Tenericutes_Incertae_sedis;Mycoplasmoidales;Mycoplasmoidaceae;Malacoplasma;Malacoplasma penetrans	0	1	0	0	0	0	0	0	1
Bacteria;Bacteria_none;Firmicutes;Bacilli;Lactobacillales;Lactobacillaceae;Liquorilactobacillus;Liquorilactobacillus vini	1	0	0	0	0	0	0	0	1
Bacteria;Bacteria_none;Firmicutes;Bacilli;Bacillales;Paenibacillaceae;Paenibacillus;Paenibacillus prosopidis	0	1	0	0	0	0	0	0	1
Bacteria;Bacteria_none;Tenericutes;Tenericutes_Incertae_sedis;Mycoplasmoidales;Metamycoplasmataceae;Metamycoplasma;Metamycoplasma sualvi	1	0	0	0	0	0	0	0	1
Bacteria;Bacteria_none;Tenericutes;Tenericutes_Incertae_sedis;Mycoplasmoidales;Metamycoplasmataceae;Metamycoplasma;Metamycoplasma gypis	0	0	1	0	0	0	0	0	1
Bacteria;Bacteria_none;Firmicutes;Bacilli;Bacillales;Paenibacillaceae;Paenibacillus;Paenibacillus psychroresistens	0	0	1	0	0	0	0	0	1
Bacteria;Bacteria_none;Tenericutes;Mollicutes;Mycoplasmatales;Mycoplasmataceae;Mycoplasmopsis;Mycoplasmopsis hyopharyngis	0	0	0	1	0	0	0	0	1
Bacteria;Bacteria_none;Firmicutes;Bacilli;Lactobacillales;Lactobacillaceae;Oenococcus;Oenococcus alcoholitolerans	0	0	1	0	0	0	0	0	1
Bacteria;Bacteria_none;Tenericutes;Mollicutes;Mycoplasmatales;Mycoplasmataceae;Mycoplasmopsis;Mycoplasmopsis alligatoris	0	0	0	1	0	0	0	0	1
Bacteria;Bacteria_none;Proteobacteria;Gammaproteobacteria;Enterobacterales;Erwiniaceae;Pantoea;[Curtobacterium] plantarum	1	0	0	0	0	0	0	0	1
Bacteria;Bacteria_none;Firmicutes;Bacilli;Bacillales;Paenibacillaceae;Paenibacillus;Paenibacillus qingshengii	0	0	0	0	0	0	1	0	1
Bacteria;Bacteria_none;Firmicutes;Bacilli;Bacillales;Paenibacillaceae;Paenibacillus;Paenibacillus rhizoryzae	0	0	0	1	0	0	0	0	1
Bacteria;Bacteria_none;Firmicutes;Bacilli;Lactobacillales;Streptococcaceae;Streptococcus;Streptococcus marimammalium	1	0	0	0	0	0	0	0	1
Bacteria;Bacteria_none;Firmicutes;Bacilli;Bacillales;Paenibacillaceae;Paenibacillus;Paenibacillus selenitireducens	0	0	0	1	0	0	0	0	1
Bacteria;Bacteria_none;Actinobacteria;Actinomycetia;Propionibacteriales;Propionibacteriaceae;Microlunatus;Microlunatus ginsengisoli	0	1	0	0	0	0	0	0	1
Bacteria;Bacteria_none;Firmicutes;Bacilli;Lactobacillales;Lactobacillaceae;Limosilactobacillus;Limosilactobacillus vaginalis	0	1	0	0	0	0	0	0	1
Bacteria;Bacteria_none;Proteobacteria;Gammaproteobacteria;Enterobacterales;Hafniaceae;Edwardsiella;Edwardsiella piscicida	1	0	0	0	0	0	0	0	1
Bacteria;Bacteria_none;Proteobacteria;Gammaproteobacteria;Enterobacterales;Morganellaceae;Arsenophonus;Arsenophonus nasoniae	1	0	0	0	0	0	0	0	1
Bacteria;Bacteria_none;Firmicutes;Bacilli;Bacillales;Paenibacillaceae;Paenibacillus;Paenibacillus sinopodophylli	0	0	0	1	0	0	0	0	1
Bacteria;Bacteria_none;Actinobacteria;Actinomycetia;Propionibacteriales;Propionibacteriaceae;Microlunatus;Microlunatus speluncae	0	1	0	0	0	0	0	0	1
Bacteria;Bacteria_none;Actinobacteria;Actinomycetia;Micrococcales;Intrasporangiaceae;Janibacter;Janibacter massiliensis	0	1	0	0	0	0	0	0	1
Bacteria;Bacteria_none;Tenericutes;Mollicutes;Mycoplasmatales;Mycoplasmataceae;Mycoplasma;Mycoplasma capricolum	1	0	0	0	0	0	0	0	1
Bacteria;Bacteria_none;Firmicutes;Bacilli;Lactobacillales;Lactobacillaceae;Weissella;Weissella thailandensis	0	1	0	0	0	0	0	0	1
Bacteria;Bacteria_none;Firmicutes;Bacilli;Bacillales;Paenibacillaceae;Paenibacillus;Paenibacillus nasutitermitis	0	0	0	1	0	0	0	0	1
Bacteria;Bacteria_none;Actinobacteria;Actinomycetia;Micrococcales;Microbacteriaceae;Microbacterium;Microbacterium flavescens	0	0	0	0	0	0	1	0	1
Bacteria;Bacteria_none;Acidobacteria;Acidobacteriia;Acidobacteriales;Acidobacteriaceae;Acidicapsa;Acidicapsa borealis	0	1	0	0	0	0	0	0	1
Bacteria;Bacteria_none;Actinobacteria;Actinomycetia;Micrococcales;Intrasporangiaceae;Pedococcus;Pedococcus bigeumensis	0	0	1	0	0	0	0	0	1
Bacteria;Bacteria_none;Proteobacteria;Gammaproteobacteria;Enterobacterales;Enterobacteriaceae;Superficieibacter;Superficieibacter electus	1	0	0	0	0	0	0	0	1
Bacteria;Bacteria_none;Firmicutes;Bacilli;Bacillales;Paenibacillaceae;Paenibacillus;Paenibacillus oryzae	0	1	0	0	0	0	0	0	1
Bacteria;Bacteria_none;Firmicutes;Bacilli;Lactobacillales;Streptococcaceae;Lactococcus;Lactococcus termiticola	1	0	0	0	0	0	0	0	1
Bacteria;Bacteria_none;Actinobacteria;Actinomycetia;Micrococcales;Microbacteriaceae;Microbacterium;Microbacterium halophytorum	0	1	0	0	0	0	0	0	1
Bacteria;Bacteria_none;Acidobacteria;Acidobacteriia;Acidobacteriales;Acidobacteriaceae;Acidisarcina;Acidisarcina polymorpha	1	0	0	0	0	0	0	0	1
Bacteria;Bacteria_none;Firmicutes;Bacilli;Lactobacillales;Lactobacillales_Incertae_sedis;Chungangia;Chungangia koreensis	0	1	0	0	0	0	0	0	1
Bacteria;Bacteria_none;Actinobacteria;Actinomycetia;Micrococcales;Microbacteriaceae;Microbacterium;Microbacterium koreense	0	1	0	0	0	0	0	0	1
Bacteria;Bacteria_none;Actinobacteria;Actinomycetia;Micrococcales;Microbacteriaceae;Microbacterium;Microbacterium laevaniformans	0	0	0	1	0	0	0	0	1
Bacteria;Bacteria_none;Firmicutes;Bacilli;Lactobacillales;Lactobacillaceae;Paucilactobacillus;Paucilactobacillus hokkaidonensis	1	0	0	0	0	0	0	0	1
Bacteria;Bacteria_none;Proteobacteria;Gammaproteobacteria;Enterobacterales;Erwiniaceae;Erwinia;Erwinia rhapontici	1	0	0	0	0	0	0	0	1
Bacteria;Bacteria_none;Firmicutes;Bacilli;Lactobacillales;Lactobacillaceae;Weissella;Weissella ceti	0	1	0	0	0	0	0	0	1
Bacteria;Bacteria_none;Firmicutes;Bacilli;Lactobacillales;Lactobacillaceae;Secundilactobacillus;Secundilactobacillus paracollinoides	1	0	0	0	0	0	0	0	1
Bacteria;Bacteria_none;Firmicutes;Bacilli;Lactobacillales;Lactobacillaceae;Secundilactobacillus;Secundilactobacillus angelensis	1	0	0	0	0	0	0	0	1
Bacteria;Bacteria_none;Actinobacteria;Actinomycetia;Micrococcales;Microbacteriaceae;Microbacterium;Microbacterium nanhaiense	0	1	0	0	0	0	0	0	1
Bacteria;Bacteria_none;Proteobacteria;Gammaproteobacteria;Enterobacterales;Erwiniaceae;Mixta;Mixta calida	1	0	0	0	0	0	0	0	1
Bacteria;Bacteria_none;Actinobacteria;Actinomycetia;Micrococcales;Microbacteriaceae;Microbacterium;Microbacterium neimengense	0	0	0	0	0	0	0	1	1
Bacteria;Bacteria_none;Actinobacteria;Actinomycetia;Micrococcales;Microbacteriaceae;Microbacterium;Microbacterium paludicola	0	0	0	1	0	0	0	0	1
Bacteria;Bacteria_none;Firmicutes;Bacilli;Lactobacillales;Streptococcaceae;Streptococcus;Streptococcus halichoeri	1	0	0	0	0	0	0	0	1
Bacteria;Bacteria_none;Actinobacteria;Actinomycetia;Micrococcales;Microbacteriaceae;Microbacterium;Microbacterium populi	0	0	0	0	1	0	0	0	1
Bacteria;Bacteria_none;Actinobacteria;Actinomycetia;Propionibacteriales;Propionibacteriaceae;Microlunatus;Microlunatus spumicola	0	0	1	0	0	0	0	0	1
Bacteria;Bacteria_none;Firmicutes;Bacilli;Bacillales;Paenibacillaceae;Paenibacillus;Paenibacillus soli	0	0	0	1	0	0	0	0	1
Bacteria;Bacteria_none;Proteobacteria;Gammaproteobacteria;Enterobacterales;Morganellaceae;Photorhabdus;Photorhabdus asymbiotica	1	0	0	0	0	0	0	0	1
Bacteria;Bacteria_none;Proteobacteria;Gammaproteobacteria;Enterobacterales;Yersiniaceae;Rouxiella;Rouxiella silvae	1	0	0	0	0	0	0	0	1
Bacteria;Bacteria_none;Spirochaetes;Spirochaetia;Spirochaetales;Treponemataceae;Treponema;Treponema rectale	0	0	0	0	0	0	1	0	1
Bacteria;Bacteria_none;Firmicutes;Bacilli;Bacillales;Paenibacillaceae;Paenibacillus;Paenibacillus turicensis	0	0	1	0	0	0	0	0	1
Bacteria;Bacteria_none;Proteobacteria;Gammaproteobacteria;Enterobacterales;Morganellaceae;Xenorhabdus;Xenorhabdus poinarii	0	0	0	0	0	0	0	1	1
Bacteria;Bacteria_none;Acidobacteria;Acidobacteriia;Acidobacteriales;Acidobacteriaceae;Telmatobacter;Telmatobacter bradus	0	1	0	0	0	0	0	0	1
Bacteria;Bacteria_none;Proteobacteria;Gammaproteobacteria;Enterobacterales;Morganellaceae;Xenorhabdus;Xenorhabdus romanii	0	0	0	0	1	0	0	0	1
Bacteria;Bacteria_none;Firmicutes;Bacilli;Bacillales;Paenibacillaceae;Paenibacillus;Paenibacillus xylaniclasticus	0	1	0	0	0	0	0	0	1
Bacteria;Bacteria_none;Actinobacteria;Actinomycetia;Micrococcales;Bogoriellaceae;Georgenia;Georgenia subflava	0	1	0	0	0	0	0	0	1
Bacteria;Bacteria_none;Firmicutes;Bacilli;Lactobacillales;Lactobacillaceae;Levilactobacillus;Levilactobacillus brevis	0	0	0	0	0	0	0	1	1
Bacteria;Bacteria_none;Firmicutes;Bacilli;Bacillales;Paenibacillaceae;Saccharibacillus;Saccharibacillus endophyticus	0	0	1	0	0	0	0	0	1
Bacteria;Bacteria_none;Actinobacteria;Actinomycetia;Propionibacteriales;Propionibacteriaceae;Cutibacterium;Cutibacterium avidum	1	0	0	0	0	0	0	0	1
Bacteria;Bacteria_none;Firmicutes;Bacilli;Bacillales;Paenibacillaceae;Saccharibacillus;Saccharibacillus qingshengii	0	0	1	0	0	0	0	0	1
Bacteria;Bacteria_none;Spirochaetes;Spirochaetia;Spirochaetales;Treponemataceae;Treponema;Treponema ruminis	0	1	0	0	0	0	0	0	1
Bacteria;Bacteria_none;Proteobacteria;Gammaproteobacteria;Enterobacterales;Pectobacteriaceae;Lonsdalea;Lonsdalea quercina	1	0	0	0	0	0	0	0	1
Bacteria;Bacteria_none;Firmicutes;Bacilli;Lactobacillales;Lactobacillaceae;Ligilactobacillus;Ligilactobacillus agilis	1	0	0	0	0	0	0	0	1
Bacteria;Bacteria_none;Actinobacteria;Actinomycetia;Micrococcales;Microbacteriaceae;Naasia;Naasia aerilata	0	0	0	1	0	0	0	0	1
Bacteria;Bacteria_none;Spirochaetes;Spirochaetia;Spirochaetales;Treponemataceae;Treponema;Treponema peruense	0	1	0	0	0	0	0	0	1
Bacteria;Bacteria_none;Firmicutes;Bacilli;Lactobacillales;Lactobacillaceae;Leuconostoc;Leuconostoc palmae	0	0	1	0	0	0	0	0	1
Bacteria;Bacteria_none;Firmicutes;Bacilli;Bacillales;Planococcaceae;Caryophanon;Caryophanon tenue	0	0	0	1	0	0	0	0	1
Bacteria;Bacteria_none;Firmicutes;Bacilli;Bacillales;Planococcaceae;Jeotgalibacillus;Jeotgalibacillus proteolyticus	0	0	0	1	0	0	0	0	1
Bacteria;Bacteria_none;Actinobacteria;Actinomycetia;Micrococcales;Microbacteriaceae;Okibacterium;Okibacterium fritillariae	1	0	0	0	0	0	0	0	1
Bacteria;Bacteria_none;Actinobacteria;Actinomycetia;Micrococcales;Microbacteriaceae;Planctomonas;Planctomonas psychrotolerans	0	1	0	0	0	0	0	0	1
Bacteria;Bacteria_none;Firmicutes;Bacilli;Bacillales;Planococcaceae;Kurthia;Kurthia senegalensis	0	0	0	0	0	0	0	1	1
Bacteria;Bacteria_none;Actinobacteria;Actinomycetia;Propionibacteriales;Propionibacteriaceae;Aestuariimicrobium;Aestuariimicrobium soli	0	0	1	0	0	0	0	0	1
Bacteria;Bacteria_none;Spirochaetes;Spirochaetia;Spirochaetales;Treponemataceae;Treponema;Treponema berlinense	0	0	1	0	0	0	0	0	1
Bacteria;Bacteria_none;Firmicutes;Bacilli;Bacillales;Planococcaceae;Planococcus;Planococcus antarcticus	1	0	0	0	0	0	0	0	1
Bacteria;Bacteria_none;Proteobacteria;Gammaproteobacteria;Enterobacterales;Morganellaceae;Xenorhabdus;Xenorhabdus mauleonii	1	0	0	0	0	0	0	0	1
Bacteria;Bacteria_none;Actinobacteria;Actinomycetia;Propionibacteriales;Propionibacteriaceae;Cutibacterium;Cutibacterium modestum	0	0	0	1	0	0	0	0	1
Bacteria;Bacteria_none;Tenericutes;Mollicutes;Mycoplasmatales;Mycoplasmataceae;Mesomycoplasma;Mesomycoplasma hyorhinis	1	0	0	0	0	0	0	0	1
Bacteria;Bacteria_none;Firmicutes;Clostridia;Eubacteriales;Heliobacteriaceae;Heliorestis;Heliorestis daurensis	0	1	0	0	0	0	0	0	1
Bacteria;Bacteria_none;Actinobacteria;Actinomycetia;Propionibacteriales;Propionibacteriaceae;Luteococcus;Luteococcus peritonei	1	0	0	0	0	0	0	0	1
Bacteria;Bacteria_none;Acidobacteria;Acidobacteriia;Acidobacteriales;Acidobacteriaceae;Edaphobacter;Edaphobacter acidisoli	1	0	0	0	0	0	0	0	1
Bacteria;Bacteria_none;Actinobacteria;Actinomycetia;Micrococcales;Intrasporangiaceae;Intrasporangium;Intrasporangium oryzae	0	0	0	1	0	0	0	0	1
Bacteria;Bacteria_none;Tenericutes;Mollicutes;Entomoplasmatales;Spiroplasmataceae;Spiroplasma;Spiroplasma mirum	0	1	0	0	0	0	0	0	1
Bacteria;Bacteria_none;Proteobacteria;Gammaproteobacteria;Enterobacterales;Morganellaceae;Photorhabdus;Photorhabdus laumondii	0	0	0	1	0	0	0	0	1
Bacteria;Bacteria_none;Tenericutes;Mollicutes;Entomoplasmatales;Spiroplasmataceae;Spiroplasma;Spiroplasma kunkelii	0	0	0	1	0	0	0	0	1
Bacteria;Bacteria_none;Firmicutes;Bacilli;Bacillales;Paenibacillaceae;Paenibacillus;Paenibacillus thalictri	0	1	0	0	0	0	0	0	1
Bacteria;Bacteria_none;Firmicutes;Clostridia;Eubacteriales;Lachnospiraceae;Abyssivirga;Abyssivirga alkaniphila	0	0	1	0	0	0	0	0	1
Bacteria;Bacteria_none;Tenericutes;Mollicutes;Entomoplasmatales;Entomoplasmataceae;Mesoplasma;Mesoplasma lactucae	0	0	1	0	0	0	0	0	1
Bacteria;Bacteria_none;Tenericutes;Mollicutes;Entomoplasmatales;Entomoplasmataceae;Entomoplasma;Entomoplasma freundtii	0	0	0	0	0	0	0	1	1
Bacteria;Bacteria_none;Firmicutes;Bacilli;Lactobacillales;Lactobacillaceae;Limosilactobacillus;Limosilactobacillus fastidiosus	0	0	0	0	1	0	0	0	1
Bacteria;Bacteria_none;Actinobacteria;Actinomycetia;Micrococcales;Microbacteriaceae;Microbacterium;Microbacterium soli	0	0	1	0	0	0	0	0	1
Bacteria;Bacteria_none;Firmicutes;Bacilli;Lactobacillales;Lactobacillaceae;Ligilactobacillus;Ligilactobacillus apodemi	1	0	0	0	0	0	0	0	1
Bacteria;Bacteria_none;Actinobacteria;Actinomycetia;Micrococcales;Microbacteriaceae;Microbacterium;Microbacterium suaedae	0	1	0	0	0	0	0	0	1
Bacteria;Bacteria_none;Proteobacteria;Gammaproteobacteria;Enterobacterales;Morganellaceae;Providencia;Providencia thailandensis	0	0	1	0	0	0	0	0	1
Bacteria;Bacteria_none;Tenericutes;Mollicutes;Acholeplasmatales;Acholeplasmataceae;Acholeplasma;Acholeplasma equifetale	0	0	0	0	1	0	0	0	1
Bacteria;Bacteria_none;Firmicutes;Bacilli;Lactobacillales;Lactobacillaceae;Limosilactobacillus;Limosilactobacillus caviae	1	0	0	0	0	0	0	0	1
Bacteria;Bacteria_none;Firmicutes;Bacilli;Lactobacillales;Lactobacillaceae;Limosilactobacillus;Limosilactobacillus antri	1	0	0	0	0	0	0	0	1
Bacteria;Bacteria_none;Firmicutes;Bacilli;Lactobacillales;Lactobacillaceae;Ligilactobacillus;Ligilactobacillus equi	1	0	0	0	0	0	0	0	1
Bacteria;Bacteria_none;Proteobacteria;Gammaproteobacteria;Enterobacterales;Morganellaceae;Xenorhabdus;Xenorhabdus cabanillasii	1	0	0	0	0	0	0	0	1
Bacteria;Bacteria_none;Acidobacteria;Acidobacteriia;Acidobacteriales;Acidobacteriaceae;Granulicella;Granulicella aggregans	0	1	0	0	0	0	0	0	1
Bacteria;Bacteria_none;Firmicutes;Bacilli;Bacillales;Paenibacillaceae;Paenibacillus;Paenibacillus triticisoli	0	1	0	0	0	0	0	0	1
Bacteria;Bacteria_none;Firmicutes;Bacilli;Lactobacillales;Lactobacillaceae;Ligilactobacillus;Ligilactobacillus ceti	0	1	0	0	0	0	0	0	1
Bacteria;Bacteria_none;Acidobacteria;Acidobacteriia;Acidobacteriales;Acidobacteriaceae;Silvibacterium;Silvibacterium bohemicum	1	0	0	0	0	0	0	0	1
Bacteria;Bacteria_none;Firmicutes;Bacilli;Lactobacillales;Lactobacillaceae;Lentilactobacillus;Lentilactobacillus fungorum	1	0	0	0	0	0	0	0	1
Bacteria;Bacteria_none;Proteobacteria;Gammaproteobacteria;Oceanospirillales;Halomonadaceae;Kushneria;Kushneria sinocarnis	1	0	0	0	0	0	0	0	1
Bacteria;Bacteria_none;Proteobacteria;Hydrogenophilalia;Hydrogenophilalia_Incertae_sedis;Hydrogenophilalia_Incertae_sedis;Pelomicrobium;Pelomicrobium methylotrophicum	0	0	0	1	0	0	0	0	1
Bacteria;Bacteria_none;Actinobacteria;Actinomycetia;Micromonosporales;Micromonosporaceae;Micromonospora;Micromonospora tarapacensis	0	1	0	0	0	0	0	0	1
Bacteria;Bacteria_none;Firmicutes;Bacilli;Lactobacillales;Enterococcaceae;Enterococcus;Enterococcus olivae	1	0	0	0	0	0	0	0	1
Bacteria;Bacteria_none;Proteobacteria;Gammaproteobacteria;Pseudomonadales;Pseudomonadaceae;Stutzerimonas;Stutzerimonas kunmingensis	0	0	0	0	0	0	0	1	1
Bacteria;Bacteria_none;Actinobacteria;Actinomycetia;Micromonosporales;Micromonosporaceae;Natronosporangium;Natronosporangium hydrolyticum	0	1	0	0	0	0	0	0	1
Bacteria;Bacteria_none;Proteobacteria;Gammaproteobacteria;Moraxellales;Moraxellaceae;Moraxella;Moraxella oblonga	0	0	0	1	0	0	0	0	1
Bacteria;Bacteria_none;Actinobacteria;Actinomycetia;Micromonosporales;Micromonosporaceae;Plantactinospora;Plantactinospora soyae	0	0	1	0	0	0	0	0	1
Bacteria;Bacteria_none;Firmicutes;Bacilli;Bacillales;Thermoactinomycetaceae;Shimazuella;Shimazuella alba	0	0	1	0	0	0	0	0	1
Bacteria;Bacteria_none;Actinobacteria;Actinomycetia;Micromonosporales;Micromonosporaceae;Plantactinospora;Plantactinospora veratri	0	0	1	0	0	0	0	0	1
Bacteria;Bacteria_none;Proteobacteria;Gammaproteobacteria;Moraxellales;Moraxellaceae;Fluviicoccus;Fluviicoccus keumensis	1	0	0	0	0	0	0	0	1
Bacteria;Bacteria_none;Firmicutes;Bacilli;Lactobacillales;Enterococcaceae;Enterococcus;Enterococcus ureilyticus	0	0	1	0	0	0	0	0	1
Bacteria;Bacteria_none;Actinobacteria;Actinomycetia;Micrococcales;Dermacoccaceae;Calidifontibacter;Calidifontibacter terrae	0	0	0	0	0	0	1	0	1
Bacteria;Bacteria_none;Firmicutes;Clostridia;Eubacteriales;Clostridiaceae;Youngiibacter;Youngiibacter multivorans	0	1	0	0	0	0	0	0	1
Bacteria;Bacteria_none;Proteobacteria;Gammaproteobacteria;Moraxellales;Moraxellaceae;Acinetobacter;Acinetobacter wanghuae	1	0	0	0	0	0	0	0	1
Bacteria;Bacteria_none;Proteobacteria;Gammaproteobacteria;Thiotrichales;Fastidiosibacteraceae;Cysteiniphilum;Cysteiniphilum litorale	0	1	0	0	0	0	0	0	1
Bacteria;Bacteria_none;Proteobacteria;Gammaproteobacteria;Thiotrichales;Fastidiosibacteraceae;Fangia;Fangia hongkongensis	1	0	0	0	0	0	0	0	1
Bacteria;Bacteria_none;Firmicutes;Clostridia;Eubacteriales;Clostridiaceae;Clostridium;Clostridium malenominatum	0	0	0	1	0	0	0	0	1
Bacteria;Bacteria_none;Proteobacteria;Gammaproteobacteria;Pseudomonadales;Pseudomonadaceae;Pseudomonas;Pseudomonas versuta	0	0	1	0	0	0	0	0	1
Bacteria;Bacteria_none;Proteobacteria;Gammaproteobacteria;Pseudomonadales;Pseudomonadaceae;Pseudomonas;Pseudomonas toyotomiensis	0	0	0	1	0	0	0	0	1
Bacteria;Bacteria_none;Proteobacteria;Gammaproteobacteria;Pseudomonadales;Pseudomonadaceae;Pseudomonas;Pseudomonas tianjinensis	1	0	0	0	0	0	0	0	1
Bacteria;Bacteria_none;Firmicutes;Bacilli;Bacillales;Thermoactinomycetaceae;Thermoflavimicrobium;Thermoflavimicrobium daqui	0	0	0	0	1	0	0	0	1
Bacteria;Bacteria_none;Proteobacteria;Gammaproteobacteria;Nevskiales;Sinobacteraceae;Nevskia;Nevskia lacus	1	0	0	0	0	0	0	0	1
Bacteria;Bacteria_none;Proteobacteria;Gammaproteobacteria;Pseudomonadales;Pseudomonadaceae;Pseudomonas;Pseudomonas oryzae	0	0	0	1	0	0	0	0	1
Bacteria;Bacteria_none;Proteobacteria;Gammaproteobacteria;Pseudomonadales;Pseudomonadaceae;Pseudomonas;Pseudomonas persica	1	0	0	0	0	0	0	0	1
Bacteria;Bacteria_none;Proteobacteria;Gammaproteobacteria;Pseudomonadales;Pseudomonadaceae;Pseudomonas;Pseudomonas phenolilytica	1	0	0	0	0	0	0	0	1
Bacteria;Bacteria_none;Firmicutes;Clostridia;Eubacteriales;Clostridiaceae;Sarcina;Sarcina maxima	0	1	0	0	0	0	0	0	1
Bacteria;Bacteria_none;Actinobacteria;Actinomycetia;Micrococcales;Demequinaceae;Demequina;Demequina soli	0	0	0	1	0	0	0	0	1
Bacteria;Bacteria_none;Proteobacteria;Gammaproteobacteria;Pseudomonadales;Pseudomonadaceae;Pseudomonas;Pseudomonas profundi	0	0	1	0	0	0	0	0	1
Bacteria;Bacteria_none;Proteobacteria;Gammaproteobacteria;Moraxellales;Moraxellaceae;Psychrobacter;Psychrobacter frigidicola	0	1	0	0	0	0	0	0	1
Bacteria;Bacteria_none;Firmicutes;Bacilli;Bacillales;Thermoactinomycetaceae;Thermoactinomyces;Thermoactinomyces mirandus	0	0	1	0	0	0	0	0	1
Bacteria;Bacteria_none;Proteobacteria;Gammaproteobacteria;Pseudomonadales;Pseudomonadaceae;Pseudomonas;Pseudomonas songnenensis	0	0	0	1	0	0	0	0	1
Bacteria;Bacteria_none;Proteobacteria;Gammaproteobacteria;Moraxellales;Moraxellaceae;Psychrobacter;Psychrobacter muriicola	0	0	0	1	0	0	0	0	1
Bacteria;Bacteria_none;Actinobacteria;Actinomycetia;Micromonosporales;Micromonosporaceae;Actinoplanes;Actinoplanes globisporus	0	1	0	0	0	0	0	0	1
Bacteria;Bacteria_none;Proteobacteria;Gammaproteobacteria;Moraxellales;Moraxellaceae;Psychrobacter;Psychrobacter fulvigenes	1	0	0	0	0	0	0	0	1
Bacteria;Bacteria_none;Firmicutes;Bacilli;Lactobacillales;Enterococcaceae;Enterococcus;Enterococcus massiliensis	1	0	0	0	0	0	0	0	1
Bacteria;Bacteria_none;Proteobacteria;Gammaproteobacteria;Thiotrichales;Francisellaceae;Francisella;Francisella tularensis	0	0	1	0	0	0	0	0	1
Bacteria;Bacteria_none;Actinobacteria;Actinomycetia;Micromonosporales;Micromonosporaceae;Actinocatenispora;Actinocatenispora rupis	0	1	0	0	0	0	0	0	1
Bacteria;Bacteria_none;Firmicutes;Bacilli;Lactobacillales;Enterococcaceae;Vagococcus;Vagococcus bubulae	1	0	0	0	0	0	0	0	1
Bacteria;Bacteria_none;Proteobacteria;Gammaproteobacteria;Vibrionales;Vibrionaceae;Vibrio;Vibrio metoecus	1	0	0	0	0	0	0	0	1
Bacteria;Bacteria_none;Firmicutes;Bacilli;Lactobacillales;Enterococcaceae;Vagococcus;Vagococcus silagei	1	0	0	0	0	0	0	0	1
Bacteria;Bacteria_none;Actinobacteria;Actinomycetia;Micrococcales;Ruaniaceae;Occultella;Occultella glacieicola	0	1	0	0	0	0	0	0	1
Bacteria;Bacteria_none;Actinobacteria;Actinomycetia;Propionibacteriales;Nocardioidaceae;Aeromicrobium;Aeromicrobium camelliae	0	0	1	0	0	0	0	0	1
Bacteria;Bacteria_none;Proteobacteria;Gammaproteobacteria;Vibrionales;Vibrionaceae;Vibrio;Vibrio chemaguriensis	1	0	0	0	0	0	0	0	1
Bacteria;Bacteria_none;Proteobacteria;Gammaproteobacteria;Vibrionales;Vibrionaceae;Vibrio;Vibrio hannami	0	0	1	0	0	0	0	0	1
Bacteria;Bacteria_none;Firmicutes;Bacilli;Lactobacillales;Enterococcaceae;Vagococcus;Vagococcus teuberi	1	0	0	0	0	0	0	0	1
Bacteria;Bacteria_none;Actinobacteria;Actinomycetia;Micrococcales;Ruaniaceae;Occultella;Occultella aeris	0	0	0	1	0	0	0	0	1
Bacteria;Bacteria_none;Actinobacteria;Actinomycetia;Propionibacteriales;Kribbellaceae;Kribbella;Kribbella sindirgiensis	0	1	0	0	0	0	0	0	1
Bacteria;Bacteria_none;Proteobacteria;Gammaproteobacteria;Vibrionales;Vibrionaceae;Vibrio;Vibrio ruber	0	0	1	0	0	0	0	0	1
Bacteria;Bacteria_none;Firmicutes;Bacilli;Lactobacillales;Lactobacillaceae;Agrilactobacillus;Agrilactobacillus yilanensis	1	0	0	0	0	0	0	0	1
Bacteria;Bacteria_none;Actinobacteria;Actinomycetia;Micrococcales;Rarobacteraceae;Rarobacter;Rarobacter incanus	0	0	0	1	0	0	0	0	1
Bacteria;Bacteria_none;Proteobacteria;Gammaproteobacteria;Moraxellales;Moraxellaceae;Acinetobacter;Acinetobacter lactucae	1	0	0	0	0	0	0	0	1
Bacteria;Bacteria_none;Actinobacteria;Actinomycetia;Propionibacteriales;Nocardioidaceae;Aeromicrobium;Aeromicrobium chenweiae	0	1	0	0	0	0	0	0	1
Bacteria;Bacteria_none;Actinobacteria;Actinomycetia;Micrococcales;Promicromonosporaceae;Puerhibacterium;Puerhibacterium puerhi	1	0	0	0	0	0	0	0	1
Bacteria;Bacteria_none;Proteobacteria;Gammaproteobacteria;Vibrionales;Vibrionaceae;Vibrio;Vibrio agarilyticus	0	0	1	0	0	0	0	0	1
Bacteria;Bacteria_none;Firmicutes;Clostridia;Eubacteriales;Desulfallaceae;Desulfotruncus;Desulfotruncus alcoholivorax	0	1	0	0	0	0	0	0	1
Bacteria;Bacteria_none;Proteobacteria;Gammaproteobacteria;Moraxellales;Moraxellaceae;Acinetobacter;Acinetobacter stercoris	0	0	0	1	0	0	0	0	1
Bacteria;Bacteria_none;Firmicutes;Bacilli;Bacillales;Staphylococcaceae;Staphylococcus;Staphylococcus schleiferi	0	0	0	0	1	0	0	0	1
Bacteria;Bacteria_none;Proteobacteria;Gammaproteobacteria;Thiotrichales;Piscirickettsiaceae;Methylophaga;Methylophaga natronica	0	0	1	0	0	0	0	0	1
Bacteria;Bacteria_none;Proteobacteria;Gammaproteobacteria;Thiotrichales;Piscirickettsiaceae;Thiomicrospira;Thiomicrospira aerophila	0	0	0	0	0	0	0	1	1
Bacteria;Bacteria_none;Firmicutes;Bacilli;Bacillales;Thermoactinomycetaceae;Kroppenstedtia;Kroppenstedtia pulmonis	0	0	0	1	0	0	0	0	1
Bacteria;Bacteria_none;Actinobacteria;Actinomycetia;Nakamurellales;Nakamurellaceae;Nakamurella;Nakamurella deserti	0	1	0	0	0	0	0	0	1
Bacteria;Bacteria_none;Proteobacteria;Gammaproteobacteria;Thiotrichales;Thiotrichaceae;Thiothrix;Thiothrix defluvii	0	1	0	0	0	0	0	0	1
Bacteria;Bacteria_none;Actinobacteria;Actinomycetia;Nakamurellales;Nakamurellaceae;Nakamurella;Nakamurella lactea	0	0	0	1	0	0	0	0	1
Bacteria;Bacteria_none;Proteobacteria;Gammaproteobacteria;Thiotrichales;Thiotrichaceae;Thiothrix;Thiothrix fructosivorans	0	1	0	0	0	0	0	0	1
Bacteria;Bacteria_none;Actinobacteria;Actinomycetia;Micrococcales;Demequinaceae;Demequina;Demequina pelophila	0	0	0	1	0	0	0	0	1
Bacteria;Bacteria_none;Actinobacteria;Actinomycetia;Micrococcales;Tropherymataceae;Tropheryma;Tropheryma whipplei	0	0	0	0	0	0	0	1	1
Bacteria;Bacteria_none;Actinobacteria;Actinomycetia;Micrococcales;Ruaniaceae;Ruania;Ruania rhizosphaerae	0	1	0	0	0	0	0	0	1
Bacteria;Bacteria_none;Proteobacteria;Gammaproteobacteria;Vibrionales;Vibrionaceae;Aliivibrio;Aliivibrio fischeri	1	0	0	0	0	0	0	0	1
Bacteria;Bacteria_none;Firmicutes;Bacilli;Bacillales;Staphylococcaceae;Staphylococcus;Staphylococcus saccharolyticus	1	0	0	0	0	0	0	0	1
Bacteria;Bacteria_none;Firmicutes;Bacilli;Lactobacillales;Enterococcaceae;Vagococcus;Vagococcus humatus	1	0	0	0	0	0	0	0	1
Bacteria;Bacteria_none;Firmicutes;Bacilli;Lactobacillales;Enterococcaceae;Vagococcus;Vagococcus salmoninarum	0	0	0	0	0	0	1	0	1
Bacteria;Bacteria_none;Proteobacteria;Gammaproteobacteria;Nevskiales;Sinobacteraceae;Nevskia;Nevskia ramosa	0	1	0	0	0	0	0	0	1
Bacteria;Bacteria_none;Proteobacteria;Gammaproteobacteria;Pseudomonadales;Pseudomonadaceae;Pseudomonas;Pseudomonas nitritireducens	0	0	1	0	0	0	0	0	1
Bacteria;Bacteria_none;Actinobacteria;Actinomycetia;Micrococcales;Promicromonosporaceae;Promicromonospora;Promicromonospora endophytica	0	1	0	0	0	0	0	0	1
Bacteria;Bacteria_none;Actinobacteria;Actinomycetia;Micromonosporales;Micromonosporaceae;Micromonospora;Micromonospora rifamycinica	0	0	0	0	0	1	0	0	1
Bacteria;Bacteria_none;Actinobacteria;Actinomycetia;Micromonosporales;Micromonosporaceae;Micromonospora;Micromonospora coriariae	1	0	0	0	0	0	0	0	1
Bacteria;Bacteria_none;Proteobacteria;Gammaproteobacteria;Oceanospirillales;Halomonadaceae;Halomonas;Halomonas jeotgali	0	0	0	1	0	0	0	0	1
Bacteria;Bacteria_none;Proteobacteria;Gammaproteobacteria;Oceanospirillales;Saccharospirillaceae;Salinibius;Salinibius halmophilus	1	0	0	0	0	0	0	0	1
Bacteria;Bacteria_none;Proteobacteria;Gammaproteobacteria;Orbales;Orbaceae;Orbus;Orbus hercynius	0	0	1	0	0	0	0	0	1
Bacteria;Bacteria_none;Firmicutes;Clostridia;Eubacteriales;Clostridiaceae;Desnuesiella;Desnuesiella massiliensis	0	0	0	1	0	0	0	0	1
Bacteria;Bacteria_none;Proteobacteria;Gammaproteobacteria;Oceanospirillales;Halomonadaceae;Halomonas;Halomonas heilongjiangensis	1	0	0	0	0	0	0	0	1
Bacteria;Bacteria_none;Proteobacteria;Gammaproteobacteria;Pasteurellales;Pasteurellaceae;Bisgaardia;Bisgaardia miroungae	0	1	0	0	0	0	0	0	1
Bacteria;Bacteria_none;Proteobacteria;Gammaproteobacteria;Oceanospirillales;Halomonadaceae;Halomonas;Halomonas halocynthiae	1	0	0	0	0	0	0	0	1
Bacteria;Bacteria_none;Actinobacteria;Actinomycetia;Micromonosporales;Micromonosporaceae;Micromonospora;Micromonospora chalcea	0	0	1	0	0	0	0	0	1
Bacteria;Bacteria_none;Proteobacteria;Gammaproteobacteria;Oceanospirillales;Halomonadaceae;Halomonas;Halomonas cerina	0	0	0	0	0	0	0	1	1
Bacteria;Bacteria_none;Firmicutes;Clostridia;Eubacteriales;Clostridiaceae;Clostridium;Clostridium weizhouense	0	0	0	1	0	0	0	0	1
Bacteria;Bacteria_none;Proteobacteria;Gammaproteobacteria;Oceanospirillales;Halomonadaceae;Chromohalobacter;Chromohalobacter nigrandesensis	0	0	1	0	0	0	0	0	1
Bacteria;Bacteria_none;Firmicutes;Bacilli;Lactobacillales;Aerococcaceae;Ruoffia;Ruoffia halotolerans	0	0	1	0	0	0	0	0	1
Bacteria;Bacteria_none;Firmicutes;Clostridia;Eubacteriales;Clostridiaceae;Hungatella;Hungatella hathewayi	0	0	0	0	1	0	0	0	1
Bacteria;Bacteria_none;Proteobacteria;Gammaproteobacteria;Pasteurellales;Pasteurellaceae;Pasteurella;Pasteurella testudinis	1	0	0	0	0	0	0	0	1
Bacteria;Bacteria_none;Proteobacteria;Gammaproteobacteria;Oceanospirillales;Oceanospirillales_Incertae_sedis;Terasakiispira;Terasakiispira papahanaumokuakeensis	0	0	0	1	0	0	0	0	1
Bacteria;Bacteria_none;Actinobacteria;Actinomycetia;Micromonosporales;Micromonosporaceae;Micromonospora;Micromonospora endophytica (Xie et al. 2001) Li et al. 2019	0	1	0	0	0	0	0	0	1
Bacteria;Bacteria_none;Proteobacteria;Gammaproteobacteria;Oceanospirillales;Halomonadaceae;Halomonas;Halomonas nitrilica	1	0	0	0	0	0	0	0	1
Bacteria;Bacteria_none;Proteobacteria;Gammaproteobacteria;Oceanospirillales;Oceanospirillaceae;Marinospirillum;Marinospirillum perlucidum	1	0	0	0	0	0	0	0	1
Bacteria;Bacteria_none;Proteobacteria;Gammaproteobacteria;Oceanospirillales;Oceanospirillaceae;Litoribacillus;Litoribacillus peritrichatus	0	0	0	1	0	0	0	0	1
Bacteria;Bacteria_none;Proteobacteria;Gammaproteobacteria;Oceanospirillales;Oceanospirillaceae;Marinomonas;Marinomonas algicida	1	0	0	0	0	0	0	0	1
Bacteria;Bacteria_none;Proteobacteria;Gammaproteobacteria;Oceanospirillales;Oceanospirillaceae;Marinomonas;Marinomonas polaris	1	0	0	0	0	0	0	0	1
Bacteria;Bacteria_none;Proteobacteria;Gammaproteobacteria;Oceanospirillales;Halomonadaceae;Kushneria;Kushneria aurantia	0	0	0	0	0	1	0	0	1
Bacteria;Bacteria_none;Proteobacteria;Gammaproteobacteria;Oceanospirillales;Halomonadaceae;Halovibrio;Halovibrio salipaludis	1	0	0	0	0	0	0	0	1
Bacteria;Bacteria_none;Proteobacteria;Gammaproteobacteria;Oceanospirillales;Oceanospirillaceae;Marinomonas;Marinomonas vaga	1	0	0	0	0	0	0	0	1
Bacteria;Bacteria_none;Proteobacteria;Gammaproteobacteria;Oceanospirillales;Halomonadaceae;Halomonas;Halomonas songnenensis	0	0	1	0	0	0	0	0	1
Bacteria;Bacteria_none;Proteobacteria;Gammaproteobacteria;Oceanospirillales;Halomonadaceae;Halomonas;Halomonas profundi	0	1	0	0	0	0	0	0	1
Bacteria;Bacteria_none;Acidobacteria;Holophagae;Acanthopleuribacterales;Acanthopleuribacteraceae;Acanthopleuribacter;Acanthopleuribacter pedis	0	1	0	0	0	0	0	0	1
Bacteria;Bacteria_none;Proteobacteria;Gammaproteobacteria;Oceanospirillales;Oceanospirillaceae;Neptunomonas;Neptunomonas acidivorans	0	0	0	0	0	0	0	1	1
Bacteria;Bacteria_none;Proteobacteria;Gammaproteobacteria;Oceanospirillales;Halomonadaceae;Halomonas;Halomonas salipaludis	0	0	1	0	0	0	0	0	1
Bacteria;Bacteria_none;Proteobacteria;Gammaproteobacteria;Oceanospirillales;Oceanospirillaceae;Nitrincola;Nitrincola schmidtii	0	1	0	0	0	0	0	0	1
Bacteria;Bacteria_none;Proteobacteria;Gammaproteobacteria;Oceanospirillales;Oceanospirillaceae;Nitrincola;Nitrincola tapanii	0	1	0	0	0	0	0	0	1
Bacteria;Bacteria_none;Proteobacteria;Gammaproteobacteria;Oceanospirillales;Halomonadaceae;Halomonas;Halomonas ramblicola	1	0	0	0	0	0	0	0	1
Bacteria;Bacteria_none;Actinobacteria;Actinomycetia;Micromonosporales;Micromonosporaceae;Longispora;Longispora fulva	0	0	0	1	0	0	0	0	1
Bacteria;Bacteria_none;Proteobacteria;Gammaproteobacteria;Pasteurellales;Pasteurellaceae;Rodentibacter;Rodentibacter trehalosifermentans	1	0	0	0	0	0	0	0	1
Bacteria;Bacteria_none;Firmicutes;Bacilli;Lactobacillales;Carnobacteriaceae;Carnobacterium;Carnobacterium divergens	0	0	0	1	0	0	0	0	1
Bacteria;Bacteria_none;Actinobacteria;Actinomycetia;Micromonosporales;Micromonosporaceae;Asanoa;Asanoa hainanensis	0	1	0	0	0	0	0	0	1
Bacteria;Bacteria_none;Proteobacteria;Gammaproteobacteria;Pseudomonadales;Pseudomonadaceae;Pseudomonas;Pseudomonas batumici	1	0	0	0	0	0	0	0	1
Bacteria;Bacteria_none;Proteobacteria;Gammaproteobacteria;Pseudomonadales;Pseudomonadaceae;Pseudomonas;Pseudomonas brassicacearum	0	1	0	0	0	0	0	0	1
Bacteria;Bacteria_none;Proteobacteria;Gammaproteobacteria;Nevskiales;Sinobacteraceae;Stenotrophobium;Stenotrophobium rhamnosiphilum	0	1	0	0	0	0	0	0	1
Bacteria;Bacteria_none;Proteobacteria;Gammaproteobacteria;Pseudomonadales;Pseudomonadaceae;Pseudomonas;Pseudomonas deceptionensis	0	0	0	1	0	0	0	0	1
Bacteria;Bacteria_none;Proteobacteria;Gammaproteobacteria;Nevskiales;Sinobacteraceae;Stagnimonas;Stagnimonas aquatica	0	0	0	1	0	0	0	0	1
Bacteria;Bacteria_none;Actinobacteria;Actinomycetia;Micrococcales;Dermabacteraceae;Dermabacter;Dermabacter jinjuensis	0	1	0	0	0	0	0	0	1
Bacteria;Bacteria_none;Firmicutes;Bacilli;Lactobacillales;Enterococcaceae;Enterococcus;Enterococcus columbae	0	1	0	0	0	0	0	0	1
Bacteria;Bacteria_none;Actinobacteria;Actinomycetia;Micrococcales;Intrasporangiaceae;Terrabacter;Terrabacter ginsenosidimutans	0	0	0	0	0	1	0	0	1
Bacteria;Bacteria_none;Proteobacteria;Gammaproteobacteria;Pseudomonadales;Pseudomonadaceae;Pseudomonas;Pseudomonas fluvialis	0	0	1	0	0	0	0	0	1
Bacteria;Bacteria_none;Firmicutes;Bacilli;Lactobacillales;Aerococcaceae;Aerococcus;Aerococcus urinaehominis	0	1	0	0	0	0	0	0	1
Bacteria;Bacteria_none;Proteobacteria;Gammaproteobacteria;Nevskiales;Sinobacteraceae;Solimonas;Solimonas fluminis	0	0	0	1	0	0	0	0	1
Bacteria;Bacteria_none;Actinobacteria;Actinomycetia;Micromonosporales;Micromonosporaceae;Micromonospora;Micromonospora ovatispora	0	1	0	0	0	0	0	0	1
Bacteria;Bacteria_none;Proteobacteria;Gammaproteobacteria;Pseudomonadales;Pseudomonadaceae;Pseudomonas;Pseudomonas marginalis	0	0	1	0	0	0	0	0	1
Bacteria;Bacteria_none;Proteobacteria;Gammaproteobacteria;Pseudomonadales;Pseudomonadaceae;Pseudomonas;Pseudomonas massiliensis	0	0	1	0	0	0	0	0	1
Bacteria;Bacteria_none;Proteobacteria;Gammaproteobacteria;Pseudomonadales;Pseudomonadaceae;Pseudomonas;Pseudomonas anguilliseptica	0	0	1	0	0	0	0	0	1
Bacteria;Bacteria_none;Proteobacteria;Gammaproteobacteria;Pseudomonadales;Pseudomonadaceae;Pseudomonas;Pseudomonas alloputida	1	0	0	0	0	0	0	0	1
Bacteria;Bacteria_none;Proteobacteria;Gammaproteobacteria;Oceanospirillales;Balneatrichaceae;Pokkaliibacter;Pokkaliibacter plantistimulans	0	1	0	0	0	0	0	0	1
Bacteria;Bacteria_none;Firmicutes;Bacilli;Lactobacillales;Carnobacteriaceae;Desemzia;Desemzia incerta	0	0	1	0	0	0	0	0	1
Bacteria;Bacteria_none;Actinobacteria;Actinomycetia;Micromonosporales;Micromonosporaceae;Dactylosporangium;Dactylosporangium thailandense	0	0	0	1	0	0	0	0	1
Bacteria;Bacteria_none;Proteobacteria;Gammaproteobacteria;Pasteurellales;Pasteurellaceae;Volucribacter;Volucribacter amazonae	0	0	0	1	0	0	0	0	1
Bacteria;Bacteria_none;Proteobacteria;Gammaproteobacteria;Oceanospirillales;Alcanivoracaceae;Alcanivorax;Alcanivorax marinus	0	0	1	0	0	0	0	0	1
Bacteria;Bacteria_none;Proteobacteria;Gammaproteobacteria;Oceanospirillales;Alcanivoracaceae;Alcanivorax;Alcanivorax indicus	0	1	0	0	0	0	0	0	1
Bacteria;Bacteria_none;Proteobacteria;Gammaproteobacteria;Pseudomonadales;Marinobacteraceae;Marinobacter;Marinobacter gelidimuriae	1	0	0	0	0	0	0	0	1
Bacteria;Bacteria_none;Firmicutes;Bacilli;Lactobacillales;Carnobacteriaceae;Carnobacterium;Carnobacterium viridans	1	0	0	0	0	0	0	0	1
Bacteria;Bacteria_none;Proteobacteria;Gammaproteobacteria;Pseudomonadales;Marinobacteraceae;Marinobacter;Marinobacter vulgaris	0	0	0	1	0	0	0	0	1
Bacteria;Bacteria_none;Proteobacteria;Gammaproteobacteria;Nevskiales;Steroidobacteraceae;Steroidobacter;Steroidobacter agariperforans	0	0	0	0	1	0	0	0	1
Bacteria;Bacteria_none;Proteobacteria;Gammaproteobacteria;Pseudomonadales;Pseudomonadaceae;Azotobacter;Azotobacter bryophylli	1	0	0	0	0	0	0	0	1
Bacteria;Bacteria_none;Proteobacteria;Gammaproteobacteria;Oceanospirillales;Alcanivoracaceae;Alcanivorax;Alcanivorax borkumensis	0	0	0	1	0	0	0	0	1
Bacteria;Bacteria_none;Actinobacteria;Actinomycetia;Micromonosporales;Micromonosporaceae;Micromonospora;Micromonospora kangleipakensis	0	0	0	1	0	0	0	0	1
Bacteria;Bacteria_none;Proteobacteria;Gammaproteobacteria;Pseudomonadales;Pseudomonadaceae;Pseudomonas;Pseudomonas agarici	0	1	0	0	0	0	0	0	1
Bacteria;Bacteria_none;Firmicutes;Clostridia;Eubacteriales;Clostridiaceae;Mordavella;Mordavella massiliensis	0	1	0	0	0	0	0	0	1
Bacteria;Bacteria_none;Actinobacteria;Actinomycetia;Micrococcales;Intrasporangiaceae;Terrabacter;Terrabacter koreensis	0	1	0	0	0	0	0	0	1
Bacteria;Bacteria_none;Actinobacteria;Actinomycetia;Micrococcales;Promicromonosporaceae;Promicromonospora;Promicromonospora umidemergens	1	0	0	0	0	0	0	0	1
Bacteria;Bacteria_none;Actinobacteria;Actinomycetia;Propionibacteriales;Nocardioidaceae;Aeromicrobium;Aeromicrobium lacus	1	0	0	0	0	0	0	0	1
Bacteria;Bacteria_none;Actinobacteria;Actinomycetia;Micrococcales;Brevibacteriaceae;Brevibacterium;Brevibacterium renqingii	0	0	0	0	0	1	0	0	1
Bacteria;Bacteria_none;Actinobacteria;Actinomycetia;Micrococcales;Micrococcaceae;Nesterenkonia;Nesterenkonia ebinurensis	1	0	0	0	0	0	0	0	1
Bacteria;Bacteria_none;Actinobacteria;Actinomycetia;Micrococcales;Micrococcaceae;Kocuria;Kocuria flava	1	0	0	0	0	0	0	0	1
Bacteria;Bacteria_none;Actinobacteria;Actinomycetia;Micrococcales;Micrococcaceae;Kocuria;Kocuria dechangensis	0	1	0	0	0	0	0	0	1
Bacteria;Bacteria_none;Firmicutes;Clostridia;Eubacteriales;Eubacteriaceae;Eubacterium;Eubacterium uniforme	1	0	0	0	0	0	0	0	1
Bacteria;Bacteria_none;Proteobacteria;Gammaproteobacteria;Legionellales;Legionellaceae;Legionella;Legionella hackeliae	0	0	0	0	1	0	0	0	1
Bacteria;Bacteria_none;Firmicutes;Bacilli;Lactobacillales;Lactobacillaceae;Lactobacillus;Lactobacillus helveticus	1	0	0	0	0	0	0	0	1
Bacteria;Bacteria_none;Actinobacteria;Actinomycetia;Propionibacteriales;Nocardioidaceae;Nocardioides;Nocardioides gilvus	0	0	1	0	0	0	0	0	1
Bacteria;Bacteria_none;Actinobacteria;Actinomycetia;Micrococcales;Micrococcaceae;Kocuria;Kocuria carniphila	1	0	0	0	0	0	0	0	1
Bacteria;Bacteria_none;Firmicutes;Bacilli;Lactobacillales;Lactobacillaceae;Lactobacillus;Lactobacillus hominis	1	0	0	0	0	0	0	0	1
Bacteria;Bacteria_none;Actinobacteria;Actinomycetia;Micrococcales;Micrococcaceae;Kocuria;Kocuria assamensis	1	0	0	0	0	0	0	0	1
Bacteria;Bacteria_none;Actinobacteria;Actinomycetia;Propionibacteriales;Nocardioidaceae;Nocardioides;Nocardioides ginsengisoli	1	0	0	0	0	0	0	0	1
Bacteria;Bacteria_none;Actinobacteria;Actinomycetia;Propionibacteriales;Nocardioidaceae;Nocardioides;Nocardioides halotolerans	0	0	0	0	0	0	0	1	1
Bacteria;Bacteria_none;Actinobacteria;Actinomycetia;Micrococcales;Micrococcaceae;Glutamicibacter;Glutamicibacter soli	0	0	0	0	0	1	0	0	1
Bacteria;Bacteria_none;Actinobacteria;Actinomycetia;Propionibacteriales;Nocardioidaceae;Nocardioides;Nocardioides humi	0	0	1	0	0	0	0	0	1
Bacteria;Bacteria_none;Proteobacteria;Gammaproteobacteria;Xanthomonadales;Xanthomonadaceae;Pseudoxanthomonas;Pseudoxanthomonas wuyuanensis	1	0	0	0	0	0	0	0	1
Bacteria;Bacteria_none;Proteobacteria;Gammaproteobacteria;Legionellales;Legionellaceae;Legionella;Legionella dresdenensis	0	0	0	1	0	0	0	0	1
Bacteria;Bacteria_none;Firmicutes;Bacilli;Lactobacillales;Lactobacillaceae;Lactobacillus;Lactobacillus equicursoris	1	0	0	0	0	0	0	0	1
Bacteria;Bacteria_none;Actinobacteria;Actinomycetia;Propionibacteriales;Nocardioidaceae;Nocardioides;Nocardioides ferulae	0	0	1	0	0	0	0	0	1
Bacteria;Bacteria_none;Actinobacteria;Actinomycetia;Micrococcales;Intrasporangiaceae;Phycicoccus;Phycicoccus ochangensis	0	0	1	0	0	0	0	0	1
Bacteria;Bacteria_none;Firmicutes;Bacilli;Bacillales;Sporolactobacillaceae;Pullulanibacillus;Pullulanibacillus camelliae	1	0	0	0	0	0	0	0	1
Bacteria;Bacteria_none;Firmicutes;Bacilli;Lactobacillales;Lactobacillaceae;Lactobacillus;Lactobacillus acetotolerans	0	0	0	0	1	0	0	0	1
Bacteria;Bacteria_none;Actinobacteria;Actinomycetia;Micrococcales;Brevibacteriaceae;Spelaeicoccus;Spelaeicoccus albus	0	0	0	1	0	0	0	0	1
Bacteria;Bacteria_none;Proteobacteria;Gammaproteobacteria;Xanthomonadales;Xanthomonadaceae;Lysobacter;Lysobacter terrae	1	0	0	0	0	0	0	0	1
Bacteria;Bacteria_none;Proteobacteria;Gammaproteobacteria;Xanthomonadales;Xanthomonadaceae;Lysobacter;Lysobacter tyrosinelyticus	1	0	0	0	0	0	0	0	1
Bacteria;Bacteria_none;Actinobacteria;Actinomycetia;Micrococcales;Micrococcaceae;Micrococcus;Micrococcus endophyticus	0	1	0	0	0	0	0	0	1
Bacteria;Bacteria_none;Proteobacteria;Gammaproteobacteria;Legionellales;Legionellaceae;Legionella;Legionella pneumophila	0	0	1	0	0	0	0	0	1
Bacteria;Bacteria_none;Actinobacteria;Actinomycetia;Micrococcales;Brevibacteriaceae;Brevibacterium;Brevibacterium rongguiense	1	0	0	0	0	0	0	0	1
Bacteria;Bacteria_none;Actinobacteria;Actinomycetia;Micrococcales;Micrococcaceae;Kocuria;Kocuria marina	0	0	0	0	0	0	0	1	1
Bacteria;Bacteria_none;Actinobacteria;Actinomycetia;Propionibacteriales;Nocardioidaceae;Nocardioides;Nocardioides cynanchi	0	1	0	0	0	0	0	0	1
Bacteria;Bacteria_none;Proteobacteria;Gammaproteobacteria;Xanthomonadales;Xanthomonadaceae;Pseudoxanthomonas;Pseudoxanthomonas beigongshangi	0	0	0	0	0	0	0	1	1
Bacteria;Bacteria_none;Firmicutes;Bacilli;Bacillales;Planococcaceae;Viridibacillus;Viridibacillus neidei	1	0	0	0	0	0	0	0	1
Bacteria;Bacteria_none;Actinobacteria;Actinomycetia;Propionibacteriales;Nocardioidaceae;Nocardioides;Nocardioides dilutus	1	0	0	0	0	0	0	0	1
Bacteria;Bacteria_none;Actinobacteria;Actinomycetia;Micrococcales;Micrococcaceae;Kocuria;Kocuria oceani	1	0	0	0	0	0	0	0	1
Bacteria;Bacteria_none;Actinobacteria;Actinomycetia;Propionibacteriales;Nocardioidaceae;Nocardioides;Nocardioides eburneiflavus	0	1	0	0	0	0	0	0	1
Bacteria;Bacteria_none;Actinobacteria;Actinomycetia;Propionibacteriales;Nocardioidaceae;Nocardioides;Nocardioides hungaricus	0	0	0	1	0	0	0	0	1
Bacteria;Bacteria_none;Firmicutes;Bacilli;Lactobacillales;Lactobacillaceae;Lactobacillus;Lactobacillus iners	0	0	1	0	0	0	0	0	1
Bacteria;Bacteria_none;Actinobacteria;Actinomycetia;Micrococcales;Micrococcaceae;Glutamicibacter;Glutamicibacter arilaitensis	0	0	0	0	0	0	1	0	1
Bacteria;Bacteria_none;Proteobacteria;Gammaproteobacteria;Immundisolibacterales;Immundisolibacteraceae;Immundisolibacter;Immundisolibacter cernigliae	0	0	0	1	0	0	0	0	1
Bacteria;Bacteria_none;Actinobacteria;Actinomycetia;Propionibacteriales;Nocardioidaceae;Nocardioides;Nocardioides panacis	1	0	0	0	0	0	0	0	1
Bacteria;Bacteria_none;Actinobacteria;Actinomycetia;Micrococcales;Micrococcaceae;Arthrobacter;Arthrobacter deserti	0	0	0	1	0	0	0	0	1
Bacteria;Bacteria_none;Actinobacteria;Actinomycetia;Micrococcales;Micrococcaceae;Arthrobacter;Arthrobacter alkaliphilus	0	0	0	0	0	0	1	0	1
Bacteria;Bacteria_none;Firmicutes;Bacilli;Lactobacillales;Lactobacillaceae;Latilactobacillus;Latilactobacillus graminis	0	0	1	0	0	0	0	0	1
Bacteria;Bacteria_none;Proteobacteria;Gammaproteobacteria;Kangiellales;Kangiellaceae;Kangiella;Kangiella shandongensis	0	0	0	1	0	0	0	0	1
Bacteria;Bacteria_none;Proteobacteria;Gammaproteobacteria;Kangiellales;Kangiellaceae;Kangiella;Kangiella chungangensis	1	0	0	0	0	0	0	0	1
Bacteria;Bacteria_none;Proteobacteria;Gammaproteobacteria;Xanthomonadales;Xanthomonadaceae;Xanthomonas;Xanthomonas populi	0	0	0	1	0	0	0	0	1
Bacteria;Bacteria_none;Firmicutes;Clostridia;Eubacteriales;Eubacteriales Family XII. Incertae Sedis;Fusibacter;Fusibacter paucivorans	0	1	0	0	0	0	0	0	1
Bacteria;Bacteria_none;Proteobacteria;Gammaproteobacteria;Xanthomonadales;Xanthomonadaceae;Xanthomonas;Xanthomonas theicola	0	0	0	1	0	0	0	0	1
Bacteria;Bacteria_none;Actinobacteria;Actinomycetia;Micrococcales;Microbacteriaceae;Rhodoluna;Rhodoluna limnophila	0	1	0	0	0	0	0	0	1
Bacteria;Bacteria_none;Actinobacteria;Actinomycetia;Micrococcales;Microbacteriaceae;Rhodoglobus;Rhodoglobus vestalii	1	0	0	0	0	0	0	0	1
Bacteria;Bacteria_none;Proteobacteria;Gammaproteobacteria;Gammaproteobacteria_Incertae_sedis;Gammaproteobacteria_Incertae_sedis;Ignatzschineria;Ignatzschineria larvae	0	0	0	0	0	0	1	0	1
Bacteria;Bacteria_none;Proteobacteria;Hydrogenophilalia;Hydrogenophilales;Hydrogenophilaceae;Tepidiphilus;Tepidiphilus succinatimandens	0	0	0	1	0	0	0	0	1
Bacteria;Bacteria_none;Firmicutes;Clostridia;Eubacteriales;Clostridiaceae;Anaerophilus;Anaerophilus nitritogenes	0	0	0	0	1	0	0	0	1
Bacteria;Bacteria_none;Actinobacteria;Actinomycetia;Propionibacteriales;Nocardioidaceae;Nocardioides;Nocardioides pakistanensis	0	0	1	0	0	0	0	0	1
Bacteria;Bacteria_none;Firmicutes;Bacilli;Lactobacillales;Lactobacillaceae;Latilactobacillus;Latilactobacillus curvatus	0	0	1	0	0	0	0	0	1
Bacteria;Bacteria_none;Proteobacteria;Gammaproteobacteria;Xanthomonadales;Xanthomonadaceae;Stenotrophomonas;Stenotrophomonas chelatiphaga	1	0	0	0	0	0	0	0	1
Bacteria;Bacteria_none;Actinobacteria;Actinomycetia;Micrococcales;Micrococcaceae;Auritidibacter;Auritidibacter ignavus	1	0	0	0	0	0	0	0	1
Bacteria;Bacteria_none;Firmicutes;Bacilli;Lactobacillales;Lactobacillaceae;Lactobacillus;Lactobacillus jensenii	1	0	0	0	0	0	0	0	1
Bacteria;Bacteria_none;Actinobacteria;Actinomycetia;Micrococcales;Micrococcaceae;Galactobacter;Galactobacter valiniphilus	1	0	0	0	0	0	0	0	1
Bacteria;Bacteria_none;Actinobacteria;Actinomycetia;Micrococcales;Micrococcaceae;Citricoccus;Citricoccus muralis	0	0	1	0	0	0	0	0	1
Bacteria;Bacteria_none;Firmicutes;Bacilli;Lactobacillales;Lactobacillaceae;Lactobacillus;Lactobacillus kefiranofaciens	1	0	0	0	0	0	0	0	1
Bacteria;Bacteria_none;Firmicutes;Bacilli;Lactobacillales;Lactobacillaceae;Lactobacillus;Lactobacillus kimbladii	1	0	0	0	0	0	0	0	1
Bacteria;Bacteria_none;Actinobacteria;Actinomycetia;Propionibacteriales;Nocardioidaceae;Nocardioides;Nocardioides koreensis	0	1	0	0	0	0	0	0	1
Bacteria;Bacteria_none;Actinobacteria;Actinomycetia;Propionibacteriales;Nocardioidaceae;Nocardioides;Nocardioides lacusdianchii	1	0	0	0	0	0	0	0	1
Bacteria;Bacteria_none;Actinobacteria;Actinomycetia;Micrococcales;Microbacteriaceae;Microbacterium;Microbacterium deserti	0	0	0	1	0	0	0	0	1
Bacteria;Bacteria_none;Actinobacteria;Actinomycetia;Propionibacteriales;Nocardioidaceae;Nocardioides;Nocardioides luti	0	1	0	0	0	0	0	0	1
Bacteria;Bacteria_none;Proteobacteria;Gammaproteobacteria;Legionellales;Legionellaceae;Fluoribacter;Fluoribacter gormanii	1	0	0	0	0	0	0	0	1
Bacteria;Bacteria_none;Actinobacteria;Actinomycetia;Micrococcales;Micrococcaceae;Arthrobacter;Arthrobacter zhaoguopingii	1	0	0	0	0	0	0	0	1
Bacteria;Bacteria_none;Actinobacteria;Actinomycetia;Micrococcales;Micrococcaceae;Arthrobacter;Arthrobacter saudimassiliensis	0	0	1	0	0	0	0	0	1
Bacteria;Bacteria_none;Acidobacteria;Blastocatellia;Blastocatellales;Blastocatellaceae;Aridibacter;Aridibacter nitratireducens	1	0	0	0	0	0	0	0	1
Bacteria;Bacteria_none;Firmicutes;Clostridia;Eubacteriales;Clostridiaceae;Caloramator;Caloramator coolhaasii	0	1	0	0	0	0	0	0	1
Bacteria;Bacteria_none;Proteobacteria;Gammaproteobacteria;Xanthomonadales;Xanthomonadaceae;Lysobacter;Lysobacter rhizophilus	1	0	0	0	0	0	0	0	1
Bacteria;Bacteria_none;Firmicutes;Bacilli;Lactobacillales;Lactobacillaceae;Lactiplantibacillus;Lactiplantibacillus mudanjiangensis	1	0	0	0	0	0	0	0	1
Bacteria;Bacteria_none;Actinobacteria;Actinomycetia;Micrococcales;Promicromonosporaceae;Myceligenerans;Myceligenerans xiligouense	0	1	0	0	0	0	0	0	1
Bacteria;Bacteria_none;Actinobacteria;Actinomycetia;Micrococcales;Micrococcaceae;Paeniglutamicibacter;Paeniglutamicibacter kerguelensis	1	0	0	0	0	0	0	0	1
Bacteria;Bacteria_none;Firmicutes;Bacilli;Bacillales;Staphylococcaceae;Salinicoccus;Salinicoccus roseus	0	0	1	0	0	0	0	0	1
Bacteria;Bacteria_none;Actinobacteria;Actinomycetia;Micrococcales;Ornithinimicrobiaceae;Ornithinimicrobium;Ornithinimicrobium murale	0	0	0	1	0	0	0	0	1
Bacteria;Bacteria_none;Firmicutes;Bacilli;Bacillales;Staphylococcaceae;Salinicoccus;Salinicoccus cyprini	0	0	1	0	0	0	0	0	1
Bacteria;Bacteria_none;Actinobacteria;Actinomycetia;Micrococcales;Ornithinimicrobiaceae;Ornithinimicrobium;Ornithinimicrobium algicola	0	1	0	0	0	0	0	0	1
Bacteria;Bacteria_none;Firmicutes;Clostridia;Eubacteriales;Desulfotomaculaceae;Desulfotomaculum;Desulfotomaculum varum	0	0	1	0	0	0	0	0	1
Bacteria;Bacteria_none;Actinobacteria;Actinomycetia;Propionibacteriales;Nocardioidaceae;Flindersiella;Flindersiella endophytica	0	1	0	0	0	0	0	0	1
Bacteria;Bacteria_none;Proteobacteria;Gammaproteobacteria;Xanthomonadales;Xanthomonadaceae;Arenimonas;Arenimonas fontis	0	0	0	1	0	0	0	0	1
Bacteria;Bacteria_none;Actinobacteria;Actinomycetia;Micrococcales;Micrococcaceae;Specibacter;Specibacter cremeus	0	0	0	1	0	0	0	0	1
Bacteria;Bacteria_none;Proteobacteria;Gammaproteobacteria;Moraxellales;Moraxellaceae;Acinetobacter;Acinetobacter bereziniae	1	0	0	0	0	0	0	0	1
Bacteria;Bacteria_none;Actinobacteria;Actinomycetia;Micrococcales;Dermacoccaceae;Leekyejoonella;Leekyejoonella antrihumi	0	1	0	0	0	0	0	0	1
Bacteria;Bacteria_none;Actinobacteria;Actinomycetia;Propionibacteriales;Nocardioidaceae;Marmoricola;Marmoricola bigeumensis	1	0	0	0	0	0	0	0	1
Bacteria;Bacteria_none;Proteobacteria;Gammaproteobacteria;Moraxellales;Moraxellaceae;Acinetobacter;Acinetobacter baretiae	1	0	0	0	0	0	0	0	1
Bacteria;Bacteria_none;Firmicutes;Bacilli;Lactobacillales;Lactobacillaceae;Companilactobacillus;Companilactobacillus nantensis	0	0	0	0	0	0	1	0	1
Bacteria;Bacteria_none;Actinobacteria;Actinomycetia;Micrococcales;Micrococcaceae;Sinomonas;Sinomonas echigonensis	0	0	1	0	0	0	0	0	1
Bacteria;Bacteria_none;Actinobacteria;Actinomycetia;Micrococcales;Micrococcaceae;Sinomonas;Sinomonas albida	0	0	0	1	0	0	0	0	1
Bacteria;Bacteria_none;Proteobacteria;Gammaproteobacteria;Moraxellales;Moraxellaceae;Acinetobacter;Acinetobacter defluvii	0	0	0	1	0	0	0	0	1
Bacteria;Bacteria_none;Proteobacteria;Gammaproteobacteria;Xanthomonadales;Rhodanobacteraceae;Rhodanobacter;Rhodanobacter hydrolyticus	1	0	0	0	0	0	0	0	1
Bacteria;Bacteria_none;Firmicutes;Bacilli;Bacillales;Staphylococcaceae;Salinicoccus;Salinicoccus salitudinis	0	0	1	0	0	0	0	0	1
Bacteria;Bacteria_none;Actinobacteria;Actinomycetia;Propionibacteriales;Nocardioidaceae;Aeromicrobium;Aeromicrobium piscarium	0	0	1	0	0	0	0	0	1
Bacteria;Bacteria_none;Actinobacteria;Actinomycetia;Micrococcales;Promicromonosporaceae;Myceligenerans;Myceligenerans indicum	0	0	1	0	0	0	0	0	1
Bacteria;Bacteria_none;Actinobacteria;Actinomycetia;Micrococcales;Promicromonosporaceae;Myceligenerans;Myceligenerans cantabricum	0	1	0	0	0	0	0	0	1
Bacteria;Bacteria_none;Proteobacteria;Gammaproteobacteria;Xanthomonadales;Rhodanobacteraceae;Dyella;Dyella acidisoli	1	0	0	0	0	0	0	0	1
Bacteria;Bacteria_none;Firmicutes;Bacilli;Bacillales;Staphylococcaceae;Staphylococcus;Staphylococcus argensis	0	0	1	0	0	0	0	0	1
Bacteria;Bacteria_none;Actinobacteria;Actinomycetia;Propionibacteriales;Nocardioidaceae;Aeromicrobium;Aeromicrobium panacisoli	1	0	0	0	0	0	0	0	1
Bacteria;Bacteria_none;Proteobacteria;Gammaproteobacteria;Xanthomonadales;Rhodanobacteraceae;Dyella;Dyella japonica	1	0	0	0	0	0	0	0	1
Bacteria;Bacteria_none;Proteobacteria;Gammaproteobacteria;Xanthomonadales;Rhodanobacteraceae;Dyella;Dyella thiooxydans	1	0	0	0	0	0	0	0	1
Bacteria;Bacteria_none;Proteobacteria;Gammaproteobacteria;Xanthomonadales;Rhodanobacteraceae;Rhodanobacter;Rhodanobacter ginsengisoli	1	0	0	0	0	0	0	0	1
Bacteria;Bacteria_none;Actinobacteria;Actinomycetia;Micrococcales;Ornithinimicrobiaceae;Serinicoccus;Serinicoccus profundi	1	0	0	0	0	0	0	0	1
Bacteria;Bacteria_none;Actinobacteria;Actinomycetia;Propionibacteriales;Nocardioidaceae;Aeromicrobium;Aeromicrobium ponti	0	0	0	0	1	0	0	0	1
Bacteria;Bacteria_none;Proteobacteria;Gammaproteobacteria;Xanthomonadales;Rhodanobacteraceae;Fulvimonas;Fulvimonas yonginensis	0	1	0	0	0	0	0	0	1
Bacteria;Bacteria_none;Firmicutes;Bacilli;Lactobacillales;Lactobacillaceae;Bombilactobacillus;Bombilactobacillus mellifer	0	0	0	1	0	0	0	0	1
Bacteria;Bacteria_none;Proteobacteria;Gammaproteobacteria;Xanthomonadales;Rhodanobacteraceae;Luteibacter;Luteibacter rhizovicinus	1	0	0	0	0	0	0	0	1
Bacteria;Bacteria_none;Firmicutes;Clostridia;Eubacteriales;Desulfitobacteriaceae;Desulfosporosinus;Desulfosporosinus lacus	0	0	0	0	0	0	1	0	1
Bacteria;Bacteria_none;Actinobacteria;Actinomycetia;Propionibacteriales;Nocardioidaceae;Marmoricola;Marmoricola ginsengisoli	0	0	0	1	0	0	0	0	1
Bacteria;Bacteria_none;Actinobacteria;Actinomycetia;Micrococcales;Micrococcaceae;Rothia;Rothia nasisuis	0	0	0	0	1	0	0	0	1
Bacteria;Bacteria_none;Actinobacteria;Actinomycetia;Micrococcales;Micrococcaceae;Rothia;Rothia mucilaginosa	0	1	0	0	0	0	0	0	1
Bacteria;Bacteria_none;Proteobacteria;Gammaproteobacteria;Xanthomonadales;Xanthomonadaceae;Lysobacter;Lysobacter gummosus	1	0	0	0	0	0	0	0	1
Bacteria;Bacteria_none;Proteobacteria;Gammaproteobacteria;Xanthomonadales;Xanthomonadaceae;Lysobacter;Lysobacter bugurensis	1	0	0	0	0	0	0	0	1
Bacteria;Bacteria_none;Actinobacteria;Actinomycetia;Micrococcales;Micrococcaceae;Pseudarthrobacter;Pseudarthrobacter niigatensis	0	0	0	0	1	0	0	0	1
Bacteria;Bacteria_none;Proteobacteria;Gammaproteobacteria;Xanthomonadales;Xanthomonadaceae;Lysobacter;Lysobacter cookii	1	0	0	0	0	0	0	0	1
Bacteria;Bacteria_none;Firmicutes;Bacilli;Lactobacillales;Lactobacillaceae;Lacticaseibacillus;Lacticaseibacillus manihotivorans	0	0	0	0	0	0	1	0	1
Bacteria;Bacteria_none;Actinobacteria;Actinomycetia;Propionibacteriales;Nocardioidaceae;Nocardioides;Nocardioides albertanoniae	0	0	0	1	0	0	0	0	1
Bacteria;Bacteria_none;Firmicutes;Bacilli;Lactobacillales;Lactobacillaceae;Lacticaseibacillus;Lacticaseibacillus pantheris	1	0	0	0	0	0	0	0	1
Bacteria;Bacteria_none;Proteobacteria;Gammaproteobacteria;Xanthomonadales;Xanthomonadaceae;Lysobacter;Lysobacter koreensis	0	1	0	0	0	0	0	0	1
Bacteria;Bacteria_none;Actinobacteria;Actinomycetia;Micrococcales;Cellulomonadaceae;Cellulomonas;Cellulomonas macrotermitis	0	0	0	1	0	0	0	0	1
Bacteria;Bacteria_none;Actinobacteria;Actinomycetia;Propionibacteriales;Nocardioidaceae;Nocardioides;Nocardioides anomalus	0	1	0	0	0	0	0	0	1
Bacteria;Bacteria_none;Actinobacteria;Actinomycetia;Propionibacteriales;Nocardioidaceae;Nocardioides;Nocardioides antarcticus	0	0	0	0	0	0	1	0	1
Bacteria;Bacteria_none;Firmicutes;Bacilli;Lactobacillales;Lactobacillaceae;Lactiplantibacillus;Lactiplantibacillus argentoratensis	0	0	1	0	0	0	0	0	1
Bacteria;Bacteria_none;Proteobacteria;Gammaproteobacteria;Xanthomonadales;Xanthomonadaceae;Lysobacter;Lysobacter niastensis	0	0	1	0	0	0	0	0	1
Bacteria;Bacteria_none;Actinobacteria;Actinomycetia;Propionibacteriales;Nocardioidaceae;Nocardioides;Nocardioides aquaticus	1	0	0	0	0	0	0	0	1
Bacteria;Bacteria_none;Proteobacteria;Gammaproteobacteria;Oceanospirillales;Oceanospirillaceae;Amphritea;Amphritea opalescens	1	0	0	0	0	0	0	0	1
Bacteria;Bacteria_none;Actinobacteria;Actinomycetia;Micrococcales;Dermatophilaceae;Gephyromycinifex;Gephyromycinifex aptenodytis	0	1	0	0	0	0	0	0	1
Bacteria;Bacteria_none;Proteobacteria;Gammaproteobacteria;Xanthomonadales;Xanthomonadaceae;Lysobacter;Lysobacter alkalisoli	0	0	0	1	0	0	0	0	1
Bacteria;Bacteria_none;Proteobacteria;Gammaproteobacteria;Xanthomonadales;Xanthomonadaceae;Luteimonas;Luteimonas aestuarii	1	0	0	0	0	0	0	0	1
Bacteria;Bacteria_none;Proteobacteria;Gammaproteobacteria;Xanthomonadales;Xanthomonadaceae;Luteimonas;Luteimonas lutimaris	1	0	0	0	0	0	0	0	1
Bacteria;Bacteria_none;Proteobacteria;Gammaproteobacteria;Methylococcales;Methylococcaceae;Methylotuvimicrobium;Methylotuvimicrobium buryatense	0	0	0	1	0	0	0	0	1
Bacteria;Bacteria_none;Proteobacteria;Gammaproteobacteria;Methylococcales;Methylococcaceae;Methylosphaera;Methylosphaera hansonii	0	1	0	0	0	0	0	0	1
Bacteria;Bacteria_none;Proteobacteria;Gammaproteobacteria;Xanthomonadales;Xanthomonadaceae;Luteimonas;Luteimonas deserti	0	0	0	0	0	1	0	0	1
Bacteria;Bacteria_none;Proteobacteria;Gammaproteobacteria;Xanthomonadales;Xanthomonadaceae;Luteimonas;Luteimonas gilva	1	0	0	0	0	0	0	0	1
Bacteria;Bacteria_none;Firmicutes;Bacilli;Lactobacillales;Lactobacillaceae;Fructilactobacillus;Fructilactobacillus fructivorans	0	1	0	0	0	0	0	0	1
Bacteria;Bacteria_none;Actinobacteria;Actinomycetia;Micrococcales;Cellulomonadaceae;Paraoerskovia;Paraoerskovia sediminicola	0	1	0	0	0	0	0	0	1
Bacteria;Bacteria_none;Proteobacteria;Gammaproteobacteria;Methylococcales;Methylococcaceae;Methylocucumis;Methylocucumis oryzae	0	1	0	0	0	0	0	0	1
Bacteria;Bacteria_none;Firmicutes;Bacilli;Bacillales;Staphylococcaceae;Jeotgalicoccus;Jeotgalicoccus marinus	0	1	0	0	0	0	0	0	1
Bacteria;Bacteria_none;Firmicutes;Clostridia;Eubacteriales;Clostridiaceae;Clostridium;Clostridium combesii	0	0	1	0	0	0	0	0	1
Bacteria;Bacteria_none;Proteobacteria;Gammaproteobacteria;Xanthomonadales;Xanthomonadaceae;Luteimonas;Luteimonas saliphila	1	0	0	0	0	0	0	0	1
Bacteria;Bacteria_none;Actinobacteria;Actinomycetia;Propionibacteriales;Nocardioidaceae;Marmoricola;Marmoricola silvestris	0	0	1	0	0	0	0	0	1
Bacteria;Bacteria_none;Firmicutes;Bacilli;Lactobacillales;Lactobacillaceae;Furfurilactobacillus;Furfurilactobacillus rossiae	0	0	1	0	0	0	0	0	1
Bacteria;Bacteria_none;Proteobacteria;Gammaproteobacteria;Xanthomonadales;Xanthomonadaceae;Luteimonas;Luteimonas yindakuii	1	0	0	0	0	0	0	0	1
Bacteria;Bacteria_none;Actinobacteria;Actinomycetia;Micrococcales;Dermatophilaceae;Dermatophilus;Dermatophilus congolensis	0	0	0	1	0	0	0	0	1
Bacteria;Bacteria_none;Actinobacteria;Actinomycetia;Corynebacteriales;Corynebacteriaceae;Corynebacterium;Corynebacterium flavescens	0	0	0	0	0	0	0	1	1
Bacteria;Bacteria_none;Actinobacteria;Actinomycetia;Streptosporangiales;Streptosporangiaceae;Nonomuraea;Nonomuraea maritima	0	1	0	0	0	0	0	0	1
Bacteria;Bacteria_none;Actinobacteria;Actinomycetia;Micrococcales;Microbacteriaceae;Microbacterium;Microbacterium chocolatum	0	1	0	0	0	0	0	0	1
Bacteria;Bacteria_none;Cyanobacteria;Cyanobacteria_Incertae_sedis;Nostocales;Nostocaceae;Nostoc;Nostoc oromo	0	0	0	1	0	0	0	0	1
Bacteria;Bacteria_none;Proteobacteria;Alphaproteobacteria;Sphingomonadales;Erythrobacteraceae;Croceibacterium;Croceibacterium xixiisoli	0	0	1	0	0	0	0	0	1
Bacteria;Bacteria_none;Proteobacteria;Alphaproteobacteria;Sphingomonadales;Erythrobacteraceae;Alteriqipengyuania;Alteriqipengyuania abyssalis	0	0	0	0	0	1	0	0	1
Bacteria;Bacteria_none;Proteobacteria;Alphaproteobacteria;Sphingomonadales;Erythrobacteraceae;Altererythrobacter;Altererythrobacter segetis	0	1	0	0	0	0	0	0	1
Bacteria;Bacteria_none;Proteobacteria;Alphaproteobacteria;Hyphomicrobiales;Cohaesibacteraceae;Cohaesibacter;Cohaesibacter marisflavi	0	0	0	0	0	1	0	0	1
Bacteria;Bacteria_none;Proteobacteria;Alphaproteobacteria;Sneathiellales;Sneathiellaceae;Sneathiella;Sneathiella limimaris	0	0	0	1	0	0	0	0	1
Bacteria;Bacteria_none;Proteobacteria;Alphaproteobacteria;Hyphomicrobiales;Devosiaceae;Arsenicitalea;Arsenicitalea aurantiaca	0	0	0	0	0	1	0	0	1
Bacteria;Bacteria_none;Proteobacteria;Alphaproteobacteria;Hyphomicrobiales;Devosiaceae;Devosia;Devosia chinhatensis	0	0	0	0	0	0	1	0	1
Bacteria;Bacteria_none;Proteobacteria;Alphaproteobacteria;Rickettsiales;Rickettsiaceae;Rickettsia;Rickettsia gravesii	0	1	0	0	0	0	0	0	1
Bacteria;Bacteria_none;Proteobacteria;Alphaproteobacteria;Hyphomicrobiales;Devosiaceae;Devosia;Devosia elaeis	1	0	0	0	0	0	0	0	1
Bacteria;Bacteria_none;Proteobacteria;Alphaproteobacteria;Rickettsiales;Rickettsiaceae;Rickettsia;Rickettsia canadensis	1	0	0	0	0	0	0	0	1
Bacteria;Bacteria_none;Proteobacteria;Alphaproteobacteria;Hyphomicrobiales;Devosiaceae;Devosia;Devosia enhydra	1	0	0	0	0	0	0	0	1
Bacteria;Bacteria_none;Proteobacteria;Alphaproteobacteria;Rickettsiales;Anaplasmataceae;Ehrlichia;Ehrlichia ruminantium	1	0	0	0	0	0	0	0	1
Bacteria;Bacteria_none;Proteobacteria;Alphaproteobacteria;Hyphomicrobiales;Devosiaceae;Devosia;Devosia geojensis	0	0	1	0	0	0	0	0	1
Bacteria;Bacteria_none;Proteobacteria;Alphaproteobacteria;Rickettsiales;Anaplasmataceae;Anaplasma;Anaplasma phagocytophilum	0	0	0	0	0	0	1	0	1
Bacteria;Bacteria_none;Proteobacteria;Alphaproteobacteria;Rhodothalassiales;Rhodothalassiaceae;Rhodothalassium;Rhodothalassium salexigens	0	0	1	0	0	0	0	0	1
Bacteria;Bacteria_none;Proteobacteria;Alphaproteobacteria;Rhodospirillales;Thalassospiraceae;Thalassospira;Thalassospira mesophila	0	0	0	1	0	0	0	0	1
Bacteria;Bacteria_none;Bacteroidota;Chitinophagia;Chitinophagales;Chitinophagaceae;Pinibacter;Pinibacter aurantiacus	1	0	0	0	0	0	0	0	1
Bacteria;Bacteria_none;Bacteroidota;Chitinophagia;Chitinophagales;Chitinophagaceae;Puia;Puia dinghuensis	0	0	0	0	0	0	1	0	1
Bacteria;Bacteria_none;Bacteroidota;Chitinophagia;Chitinophagales;Chitinophagaceae;Sediminibacterium;Sediminibacterium aquarii	1	0	0	0	0	0	0	0	1
Bacteria;Bacteria_none;Proteobacteria;Alphaproteobacteria;Hyphomicrobiales;Devosiaceae;Devosia;Devosia honganensis	0	0	0	0	1	0	0	0	1
Bacteria;Bacteria_none;Cyanobacteria;Cyanobacteria_Incertae_sedis;Nostocales;Nostocaceae;Desmonostoc;Desmonostoc geniculatum	0	1	0	0	0	0	0	0	1
Bacteria;Bacteria_none;Cyanobacteria;Cyanobacteria_Incertae_sedis;Nostocales;Nostocaceae;Desmonostoc;Desmonostoc caucasicum	1	0	0	0	0	0	0	0	1
Bacteria;Bacteria_none;Proteobacteria;Alphaproteobacteria;Hyphomicrobiales;Devosiaceae;Devosia;Devosia marina	0	0	0	1	0	0	0	0	1
Bacteria;Bacteria_none;Cyanobacteria;Cyanobacteria_Incertae_sedis;Nostocales;Nostocaceae;Nostoc;Nostoc mirabile	0	0	1	0	0	0	0	0	1
Bacteria;Bacteria_none;Cyanobacteria;Cyanobacteria_Incertae_sedis;Nostocales;Rivulariaceae;Nunduva;Nunduva biania	0	0	0	0	0	1	0	0	1
Bacteria;Bacteria_none;Proteobacteria;Betaproteobacteria;Burkholderiales;Burkholderiaceae;Paraburkholderia;Paraburkholderia graminis	1	0	0	0	0	0	0	0	1
Bacteria;Bacteria_none;Proteobacteria;Alphaproteobacteria;Sphingomonadales;Erythrobacteraceae;Erythrobacter;Erythrobacter neustonensis	0	0	1	0	0	0	0	0	1
Bacteria;Bacteria_none;Cyanobacteria;Cyanobacteria_Incertae_sedis;Oscillatoriales;Coleofasciculaceae;Ramsaria;Ramsaria avicennae	0	0	0	1	0	0	0	0	1
Bacteria;Bacteria_none;Proteobacteria;Alphaproteobacteria;Sphingomonadales;Sphingomonadaceae;Novosphingobium;Novosphingobium ovatum	0	0	1	0	0	0	0	0	1
Bacteria;Bacteria_none;Proteobacteria;Alphaproteobacteria;Sphingomonadales;Sphingomonadaceae;Novosphingobium;Novosphingobium oryzae	1	0	0	0	0	0	0	0	1
Bacteria;Bacteria_none;Proteobacteria;Alphaproteobacteria;Sphingomonadales;Sphingomonadaceae;Novosphingobium;Novosphingobium lotistagni	0	0	1	0	0	0	0	0	1
Bacteria;Bacteria_none;Proteobacteria;Alphaproteobacteria;Sphingomonadales;Sphingomonadaceae;Novosphingobium;Novosphingobium huizhouense	0	1	0	0	0	0	0	0	1
Bacteria;Bacteria_none;Cyanobacteria;Cyanobacteria_Incertae_sedis;Oscillatoriales;Coleofasciculaceae;Pycnacronema;Pycnacronema marmoreum	0	0	0	0	0	1	0	0	1
Bacteria;Bacteria_none;Cyanobacteria;Cyanobacteria_Incertae_sedis;Oscillatoriales;Coleofasciculaceae;Kastovskya;Kastovskya adunca	0	0	1	0	0	0	0	0	1
Bacteria;Bacteria_none;Cyanobacteria;Cyanobacteria_Incertae_sedis;Oscillatoriales;Coleofasciculaceae;Coleofasciculus;Coleofasciculus chthonoplastes	0	0	0	1	0	0	0	0	1
Bacteria;Bacteria_none;Cyanobacteria;Cyanobacteria_Incertae_sedis;Oscillatoriales;Coleofasciculaceae;Anagnostidinema;Anagnostidinema pseudacutissimum	0	1	0	0	0	0	0	0	1
Bacteria;Bacteria_none;Actinobacteria;Actinomycetia;Corynebacteriales;Corynebacteriaceae;Corynebacterium;Corynebacterium trachiae	0	0	1	0	0	0	0	0	1
Bacteria;Bacteria_none;Cyanobacteria;Cyanobacteria_Incertae_sedis;Oscillatoriales;Coleofasciculaceae;Allocoleopsis;Allocoleopsis franciscana	1	0	0	0	0	0	0	0	1
Bacteria;Bacteria_none;Proteobacteria;Alphaproteobacteria;Sphingomonadales;Sphingomonadaceae;Novosphingobium;'Novosphingobium aquaticum' Singh et al. 2015	0	0	1	0	0	0	0	0	1
Bacteria;Bacteria_none;Proteobacteria;Alphaproteobacteria;Sphingomonadales;Sphingomonadaceae;Allosphingosinicella;Allosphingosinicella vermicomposti	0	1	0	0	0	0	0	0	1
Bacteria;Bacteria_none;Proteobacteria;Alphaproteobacteria;Sphingomonadales;Erythrobacteraceae;Tsuneonella;Tsuneonella mangrovi	0	0	0	0	1	0	0	0	1
Bacteria;Bacteria_none;Proteobacteria;Alphaproteobacteria;Sphingomonadales;Erythrobacteraceae;Tsuneonella;Tsuneonella flava	0	1	0	0	0	0	0	0	1
Bacteria;Bacteria_none;Proteobacteria;Alphaproteobacteria;Sphingomonadales;Erythrobacteraceae;Qipengyuania;Qipengyuania sediminis	0	0	0	0	0	1	0	0	1
Bacteria;Bacteria_none;Proteobacteria;Alphaproteobacteria;Sphingomonadales;Erythrobacteraceae;Qipengyuania;Qipengyuania algicida	0	1	0	0	0	0	0	0	1
Bacteria;Bacteria_none;Proteobacteria;Alphaproteobacteria;Sphingomonadales;Erythrobacteraceae;Pontixanthobacter;Pontixanthobacter luteolus	0	1	0	0	0	0	0	0	1
Bacteria;Bacteria_none;Bacteroidota;Chitinophagia;Chitinophagales;Chitinophagaceae;Niveitalea;Niveitalea solisilvae	0	1	0	0	0	0	0	0	1
Bacteria;Bacteria_none;Proteobacteria;Alphaproteobacteria;Sphingomonadales;Erythrobacteraceae;Pelagerythrobacter;Pelagerythrobacter aerophilus	0	0	0	1	0	0	0	0	1
Bacteria;Bacteria_none;Proteobacteria;Alphaproteobacteria;Sphingomonadales;Erythrobacteraceae;Parerythrobacter;Parerythrobacter lutipelagi	0	0	0	1	0	0	0	0	1
Bacteria;Bacteria_none;Proteobacteria;Alphaproteobacteria;Sphingomonadales;Erythrobacteraceae;Parerythrobacter;Parerythrobacter jejuensis	0	0	0	0	1	0	0	0	1
Bacteria;Bacteria_none;Proteobacteria;Alphaproteobacteria;Sphingomonadales;Erythrobacteraceae;Erythrobacter;Erythrobacter westpacificensis	1	0	0	0	0	0	0	0	1
Bacteria;Bacteria_none;Cyanobacteria;Cyanobacteria_Incertae_sedis;Nostocales;Nostocaceae;Desikacharya;Desikacharya constricta	1	0	0	0	0	0	0	0	1
Bacteria;Bacteria_none;Proteobacteria;Alphaproteobacteria;Rhodospirillales;Rhodospirillaceae;Tagaea;Tagaea marina	0	1	0	0	0	0	0	0	1
Bacteria;Bacteria_none;Proteobacteria;Alphaproteobacteria;Rhodospirillales;Rhodospirillaceae;Roseospira;Roseospira thiosulfatophila	0	0	0	1	0	0	0	0	1
Bacteria;Bacteria_none;Proteobacteria;Alphaproteobacteria;Rhodospirillales;Rhodospirillaceae;Rhodospira;Rhodospira trueperi	0	0	0	0	1	0	0	0	1
Bacteria;Bacteria_none;Proteobacteria;Alphaproteobacteria;Rhodospirillales;Azospirillaceae;Azospirillum;Azospirillum picis	0	0	0	1	0	0	0	0	1
Bacteria;Bacteria_none;Proteobacteria;Alphaproteobacteria;Rhodospirillales;Azospirillaceae;Azospirillum;Azospirillum oleiclasticum	1	0	0	0	0	0	0	0	1
Bacteria;Bacteria_none;Proteobacteria;Alphaproteobacteria;Rhodospirillales;Azospirillaceae;Azospirillum;Azospirillum humicireducens	0	1	0	0	0	0	0	0	1
Bacteria;Bacteria_none;Proteobacteria;Alphaproteobacteria;Rhodospirillales;Azospirillaceae;Azospirillum;Azospirillum halopraeferens	1	0	0	0	0	0	0	0	1
Bacteria;Bacteria_none;Bacteroidota;Cytophagia;Cytophagales;Cytophagaceae;Cytophaga;Cytophaga hutchinsonii	1	0	0	0	0	0	0	0	1
Bacteria;Bacteria_none;Proteobacteria;Alphaproteobacteria;Rhodospirillales;Acetobacteraceae;Roseomonas;Roseomonas vastitatis	0	1	0	0	0	0	0	0	1
Bacteria;Bacteria_none;Cyanobacteria;Cyanobacteria_Incertae_sedis;Chroococcales;Geminocystaceae;Geminobacterium;Geminobacterium atlanticum	1	0	0	0	0	0	0	0	1
Bacteria;Bacteria_none;Cyanobacteria;Cyanobacteria_Incertae_sedis;Chroococcales;Geminocystaceae;Annamia;Annamia dubia	0	0	0	1	0	0	0	0	1
Bacteria;Bacteria_none;Cyanobacteria;Cyanobacteria_Incertae_sedis;Chroococcales;Chroococcaceae;Neochroococcus;Neochroococcus gongqingensis	0	1	0	0	0	0	0	0	1
Bacteria;Bacteria_none;Cyanobacteria;Cyanobacteria_Incertae_sedis;Chroococcales;Chroococcaceae;Limnococcus;Limnococcus limneticus	1	0	0	0	0	0	0	0	1
Bacteria;Bacteria_none;Proteobacteria;Alphaproteobacteria;Rhodospirillales;Acetobacteraceae;Roseomonas;Roseomonas oleicola	0	0	0	1	0	0	0	0	1
Bacteria;Bacteria_none;Cyanobacteria;Cyanobacteria_Incertae_sedis;Chroococcales;Aphanothecaceae;Rubidibacter;Rubidibacter lacunae	0	0	0	1	0	0	0	0	1
Bacteria;Bacteria_none;Bacteroidota;Cytophagia;Cytophagales;Cytophagaceae;Spirosoma;Spirosoma metallilatum	0	0	0	1	0	0	0	0	1
Bacteria;Bacteria_none;Actinobacteria;Actinomycetia;Corynebacteriales;Corynebacteriaceae;Corynebacterium;Corynebacterium matruchotii	0	1	0	0	0	0	0	0	1
Bacteria;Bacteria_none;Proteobacteria;Alphaproteobacteria;Rhodospirillales;Acetobacteraceae;Roseomonas;Roseomonas harenae	0	1	0	0	0	0	0	0	1
Bacteria;Bacteria_none;Proteobacteria;Alphaproteobacteria;Hyphomicrobiales;Hyphomicrobiales_Incertae_sedis;Terrihabitans;Terrihabitans soli	0	0	1	0	0	0	0	0	1
Bacteria;Bacteria_none;Cyanobacteria;Cyanobacteria_Incertae_sedis;Chroococcales;Aphanothecaceae;Gloeothece;Gloeothece reniformis	0	1	0	0	0	0	0	0	1
Bacteria;Bacteria_none;Bacteroidota;Cytophagia;Cytophagales;Cytophagaceae;Spirosoma;Spirosoma soli	1	0	0	0	0	0	0	0	1
Bacteria;Bacteria_none;Bacteroidota;Cytophagia;Cytophagales;Cytophagaceae;Spirosoma;Spirosoma telluris	0	1	0	0	0	0	0	0	1
Bacteria;Bacteria_none;Chrysiogenetes;Chrysiogenetes;Chrysiogenales;Chrysiogenaceae;Chrysiogenes;Chrysiogenes arsenatis	0	0	1	0	0	0	0	0	1
Bacteria;Bacteria_none;Bacteroidota;Cytophagia;Cytophagales;Cytophagaceae;Tellurirhabdus;Tellurirhabdus rosea	0	1	0	0	0	0	0	0	1
Bacteria;Bacteria_none;Proteobacteria;Alphaproteobacteria;Rhodospirillales;Acetobacteraceae;Roseomonas;Roseomonas aestuarii	0	0	1	0	0	0	0	0	1
Bacteria;Bacteria_none;Chloroflexi;Thermomicrobia;Thermomicrobiales;Thermomicrobiaceae;Thermomicrobium;Thermomicrobium roseum	0	0	0	1	0	0	0	0	1
Bacteria;Bacteria_none;Proteobacteria;Alphaproteobacteria;Rhodospirillales;Azospirillaceae;Azospirillum;Azospirillum zeae	0	1	0	0	0	0	0	0	1
Bacteria;Bacteria_none;Proteobacteria;Alphaproteobacteria;Rhodospirillales;Azospirillaceae;Deserticella;Deserticella xinjiangensis	1	0	0	0	0	0	0	0	1
Bacteria;Bacteria_none;Proteobacteria;Alphaproteobacteria;Rhodospirillales;Azospirillaceae;Nitrospirillum;Nitrospirillum amazonense	1	0	0	0	0	0	0	0	1
Bacteria;Bacteria_none;Bacteroidota;Cytophagia;Cytophagales;Cyclobacteriaceae;Algoriphagus;Algoriphagus resistens	0	0	0	0	0	1	0	0	1
Bacteria;Bacteria_none;Proteobacteria;Alphaproteobacteria;Rhodospirillales;Rhodospirillaceae;Phaeospirillum;Phaeospirillum tilakii	0	1	0	0	0	0	0	0	1
Bacteria;Bacteria_none;Proteobacteria;Alphaproteobacteria;Rhodospirillales;Rhodospirillaceae;Phaeospirillum;Phaeospirillum chandramohanii	0	0	0	0	1	0	0	0	1
Bacteria;Bacteria_none;Cyanobacteria;Cyanobacteria_Incertae_sedis;Nostocales;Nostocaceae;Aliinostoc;Aliinostoc morphoplasticum	0	0	0	1	0	0	0	0	1
Bacteria;Bacteria_none;Proteobacteria;Alphaproteobacteria;Rhodospirillales;Rhodospirillaceae;Oleiliquidispirillum;Oleiliquidispirillum nitrogeniifigens	0	0	0	0	0	1	0	0	1
Bacteria;Bacteria_none;Cyanobacteria;Cyanobacteria_Incertae_sedis;Nostocales;Hapalosiphonaceae;Westiellopsis;Westiellopsis ramosa	1	0	0	0	0	0	0	0	1
Bacteria;Bacteria_none;Proteobacteria;Alphaproteobacteria;Hyphomicrobiales;Devosiaceae;Pelagibacterium;Pelagibacterium halotolerans	0	0	1	0	0	0	0	0	1
Bacteria;Bacteria_none;Proteobacteria;Alphaproteobacteria;Hyphomicrobiales;Devosiaceae;Pelagibacterium;Pelagibacterium montanilacus	0	0	1	0	0	0	0	0	1
Bacteria;Bacteria_none;Proteobacteria;Alphaproteobacteria;Hyphomicrobiales;Hyphomicrobiaceae;Aquabacter;Aquabacter cavernae	1	0	0	0	0	0	0	0	1
Bacteria;Bacteria_none;Actinobacteria;Actinomycetia;Bifidobacteriales;Bifidobacteriaceae;Bifidobacterium;Bifidobacterium dolichotidis	0	0	1	0	0	0	0	0	1
Bacteria;Bacteria_none;Proteobacteria;Alphaproteobacteria;Hyphomicrobiales;Hyphomicrobiaceae;Aquabacter;Aquabacter spiritensis	0	0	0	0	0	1	0	0	1
Bacteria;Bacteria_none;Proteobacteria;Alphaproteobacteria;Hyphomicrobiales;Hyphomicrobiaceae;Caenibius;Caenibius tardaugens	1	0	0	0	0	0	0	0	1
Bacteria;Bacteria_none;Actinobacteria;Actinomycetia;Corynebacteriales;Corynebacteriaceae;Corynebacterium;Corynebacterium resistens	0	0	1	0	0	0	0	0	1
Bacteria;Bacteria_none;Proteobacteria;Alphaproteobacteria;Rhodospirillales;Rhodospirillaceae;Aerophototrophica;Aerophototrophica crusticola	0	1	0	0	0	0	0	0	1
Bacteria;Bacteria_none;Proteobacteria;Alphaproteobacteria;Rhodospirillales;Kiloniellaceae;Aestuariispira;Aestuariispira insulae	0	0	0	0	0	0	1	0	1
Bacteria;Bacteria_none;Proteobacteria;Alphaproteobacteria;Rhodospirillales;Kiloniellaceae;Aestuariispira;Aestuariispira ectoiniformans	0	0	0	1	0	0	0	0	1
Bacteria;Bacteria_none;Bacteroidota;Cytophagia;Cytophagales;Cyclobacteriaceae;Echinicola;Echinicola rosea	0	1	0	0	0	0	0	0	1
Bacteria;Bacteria_none;Bacteroidota;Cytophagia;Cytophagales;Cyclobacteriaceae;Echinicola;Echinicola vietnamensis	0	0	0	0	1	0	0	0	1
Bacteria;Bacteria_none;Cyanobacteria;Cyanobacteria_Incertae_sedis;Nostocales;Geitleriaceae;Geitleria;Geitleria appalachiana	0	1	0	0	0	0	0	0	1
Bacteria;Bacteria_none;Proteobacteria;Alphaproteobacteria;Rhodospirillales;Azospirillaceae;Skermanella;Skermanella rosea	0	0	0	0	0	0	1	0	1
Bacteria;Bacteria_none;Actinobacteria;Actinomycetia;Corynebacteriales;Corynebacteriaceae;Corynebacterium;Corynebacterium tapiri	0	1	0	0	0	0	0	0	1
Bacteria;Bacteria_none;Proteobacteria;Alphaproteobacteria;Rhodospirillales;Azospirillaceae;Skermanella;Skermanella mucosa	0	0	1	0	0	0	0	0	1
Bacteria;Bacteria_none;Proteobacteria;Alphaproteobacteria;Rhodospirillales;Azospirillaceae;Rhodocista;Rhodocista pekingensis	0	0	1	0	0	0	0	0	1
Bacteria;Bacteria_none;Proteobacteria;Alphaproteobacteria;Sphingomonadales;Sphingomonadaceae;Novosphingobium;Novosphingobium pokkalii	1	0	0	0	0	0	0	0	1
Bacteria;Bacteria_none;Proteobacteria;Alphaproteobacteria;Sphingomonadales;Sphingomonadaceae;Novosphingobium;Novosphingobium profundi	0	0	0	1	0	0	0	0	1
Bacteria;Bacteria_none;Bacteroidota;Chitinophagia;Chitinophagales;Chitinophagaceae;Niastella;Niastella hibisci	1	0	0	0	0	0	0	0	1
Bacteria;Bacteria_none;Proteobacteria;Alphaproteobacteria;Sphingomonadales;Sphingomonadaceae;Sphingosinithalassobacter;Sphingosinithalassobacter portus	1	0	0	0	0	0	0	0	1
Bacteria;Bacteria_none;Proteobacteria;Betaproteobacteria;Burkholderiales;Burkholderiaceae;Burkholderia;Burkholderia australis	0	1	0	0	0	0	0	0	1
Bacteria;Bacteria_none;Bacteroidota;Chitinophagia;Chitinophagales;Chitinophagaceae;Chitinophaga;Chitinophaga silvisoli	0	0	1	0	0	0	0	0	1
Bacteria;Bacteria_none;Bacteroidota;Chitinophagia;Chitinophagales;Chitinophagaceae;Chitinophaga;Chitinophaga varians	1	0	0	0	0	0	0	0	1
Bacteria;Bacteria_none;Cyanobacteria;Cyanobacteria_Incertae_sedis;Pseudanabaenales;Oculatellaceae;Komarkovaea;Komarkovaea angustata	0	0	0	1	0	0	0	0	1
Bacteria;Bacteria_none;Bacteroidota;Chitinophagia;Chitinophagales;Chitinophagaceae;Deminuibacter;Deminuibacter soli	0	0	1	0	0	0	0	0	1
Bacteria;Bacteria_none;Cyanobacteria;Cyanobacteria_Incertae_sedis;Pseudanabaenales;Oculatellaceae;Cartusia;Cartusia fontana	1	0	0	0	0	0	0	0	1
Bacteria;Bacteria_none;Bacteroidota;Chitinophagia;Chitinophagales;Chitinophagaceae;Edaphobaculum;Edaphobaculum flavum	1	0	0	0	0	0	0	0	1
Bacteria;Bacteria_none;Proteobacteria;Betaproteobacteria;Burkholderiales;Alcaligenaceae;Pigmentiphaga;Pigmentiphaga aceris	1	0	0	0	0	0	0	0	1
Bacteria;Bacteria_none;Proteobacteria;Alphaproteobacteria;Caulobacterales;Caulobacteraceae;Brevundimonas;Brevundimonas fluminis	0	1	0	0	0	0	0	0	1
Bacteria;Bacteria_none;Proteobacteria;Betaproteobacteria;Burkholderiales;Alcaligenaceae;Paralcaligenes;Paralcaligenes ureilyticus	1	0	0	0	0	0	0	0	1
Bacteria;Bacteria_none;Proteobacteria;Betaproteobacteria;Burkholderiales;Alcaligenaceae;Paracandidimonas;Paracandidimonas soli	0	0	0	0	0	0	1	0	1
Bacteria;Bacteria_none;Proteobacteria;Betaproteobacteria;Burkholderiales;Alcaligenaceae;Paracandidimonas;Paracandidimonas caeni	0	0	0	0	0	0	1	0	1
Bacteria;Bacteria_none;Proteobacteria;Betaproteobacteria;Burkholderiales;Alcaligenaceae;Paenalcaligenes;Paenalcaligenes suwonensis	0	0	0	0	0	1	0	0	1
Bacteria;Bacteria_none;Cyanobacteria;Cyanobacteria_Incertae_sedis;Pseudanabaenales;Leptolyngbyaceae;Kovacikia;Kovacikia muscicola	0	1	0	0	0	0	0	0	1
Bacteria;Bacteria_none;Proteobacteria;Betaproteobacteria;Burkholderiales;Alcaligenaceae;Candidimonas;Candidimonas humi	1	0	0	0	0	0	0	0	1
Bacteria;Bacteria_none;Bacteroidota;Chitinophagia;Chitinophagales;Chitinophagaceae;Flavisolibacter;Flavisolibacter ginsengisoli	0	1	0	0	0	0	0	0	1
Bacteria;Bacteria_none;Bacteroidota;Chitinophagia;Chitinophagales;Chitinophagaceae;Flavisolibacter;Flavisolibacter metallilatus	1	0	0	0	0	0	0	0	1
Bacteria;Bacteria_none;Proteobacteria;Betaproteobacteria;Burkholderiales;Alcaligenaceae;Achromobacter;Achromobacter xylosoxidans	0	0	1	0	0	0	0	0	1
Bacteria;Bacteria_none;Bacteroidota;Chitinophagia;Chitinophagales;Chitinophagaceae;Flavisolibacter;Flavisolibacter tropicus	1	0	0	0	0	0	0	0	1
Bacteria;Bacteria_none;Proteobacteria;Betaproteobacteria;Burkholderiales;Alcaligenaceae;Achromobacter;Achromobacter animicus	0	1	0	0	0	0	0	0	1
Bacteria;Bacteria_none;Proteobacteria;Alphaproteobacteria;Sphingomonadales;Sphingosinicellaceae;Sphingosinicella;Sphingosinicella cucumeris	0	1	0	0	0	0	0	0	1
Bacteria;Bacteria_none;Proteobacteria;Alphaproteobacteria;Sphingomonadales;Sphingosinicellaceae;Sandarakinorhabdus;Sandarakinorhabdus cyanobacteriorum	0	0	1	0	0	0	0	0	1
Bacteria;Bacteria_none;Proteobacteria;Alphaproteobacteria;Sphingomonadales;Sphingosinicellaceae;Polymorphobacter;Polymorphobacter glacialis	0	0	1	0	0	0	0	0	1
Bacteria;Bacteria_none;Proteobacteria;Betaproteobacteria;Burkholderiales;Burkholderiaceae;Burkholderia;Burkholderia ubonensis	0	0	0	0	0	0	0	1	1
Bacteria;Bacteria_none;Bacteroidota;Chitinophagia;Chitinophagales;Chitinophagaceae;Chitinophaga;Chitinophaga oryzae	1	0	0	0	0	0	0	0	1
Bacteria;Bacteria_none;Bacteroidota;Chitinophagia;Chitinophagales;Chitinophagaceae;Chitinophaga;Chitinophaga ginsengihumi	1	0	0	0	0	0	0	0	1
Bacteria;Bacteria_none;Bacteroidota;Bacteroidia;Marinilabiliales;Prolixibacteraceae;Sunxiuqinia;Sunxiuqinia faeciviva	0	0	0	0	0	0	0	1	1
Bacteria;Bacteria_none;Bacteroidota;Bacteroidia;Marinilabiliales;Marinilabiliaceae;Thermophagus;Thermophagus xiamenensis	0	0	0	1	0	0	0	0	1
Bacteria;Bacteria_none;Proteobacteria;Betaproteobacteria;Burkholderiales;Burkholderiaceae;Paraburkholderia;Paraburkholderia caribensis	1	0	0	0	0	0	0	0	1
Bacteria;Bacteria_none;Proteobacteria;Betaproteobacteria;Burkholderiales;Burkholderiaceae;Paraburkholderia;Paraburkholderia aspalathi	1	0	0	0	0	0	0	0	1
Bacteria;Bacteria_none;Proteobacteria;Betaproteobacteria;Burkholderiales;Burkholderiaceae;Paraburkholderia;Paraburkholderia antibiotica	0	0	1	0	0	0	0	0	1
Bacteria;Bacteria_none;Proteobacteria;Betaproteobacteria;Burkholderiales;Burkholderiaceae;Paraburkholderia;Paraburkholderia agricolaris	0	0	0	0	0	0	0	1	1
Bacteria;Bacteria_none;Actinobacteria;Actinomycetia;Corynebacteriales;Corynebacteriales_Incertae_sedis;Tomitella;Tomitella biformata	0	0	0	1	0	0	0	0	1
Bacteria;Bacteria_none;Actinobacteria;Actinomycetia;Bifidobacteriales;Bifidobacteriaceae;Alloscardovia;Alloscardovia venturai	0	1	0	0	0	0	0	0	1
Bacteria;Bacteria_none;Proteobacteria;Betaproteobacteria;Burkholderiales;Burkholderiaceae;Pandoraea;Pandoraea iniqua	1	0	0	0	0	0	0	0	1
Bacteria;Bacteria_none;Bacteroidota;Bacteroidia;Marinilabiliales;Prolixibacteraceae;Maribellus;Maribellus sediminis	0	0	0	1	0	0	0	0	1
Bacteria;Bacteria_none;Cyanobacteria;Cyanobacteria_Incertae_sedis;Pseudanabaenales;Pseudanabaenaceae;Lusitaniella;Lusitaniella coriacea	0	1	0	0	0	0	0	0	1
Bacteria;Bacteria_none;Proteobacteria;Betaproteobacteria;Burkholderiales;Burkholderiaceae;Cupriavidus;Cupriavidus plantarum	0	0	0	0	0	1	0	0	1
Bacteria;Bacteria_none;Bacteroidota;Chitinophagia;Chitinophagales;Chitinophagaceae;Chitinophaga;Chitinophaga dinghuensis	0	1	0	0	0	0	0	0	1
Bacteria;Bacteria_none;Cyanobacteria;Cyanobacteria_Incertae_sedis;Pseudanabaenales;Oculatellaceae;Timaviella;Timaviella radians	0	0	1	0	0	0	0	0	1
Bacteria;Bacteria_none;Bacteroidota;Chitinophagia;Chitinophagales;Chitinophagaceae;Agriterribacter;Agriterribacter humi	1	0	0	0	0	0	0	0	1
Bacteria;Bacteria_none;Cyanobacteria;Cyanobacteria_Incertae_sedis;Pseudanabaenales;Oculatellaceae;Oculatella;Oculatella subterranea	0	0	0	0	0	0	1	0	1
Bacteria;Bacteria_none;Proteobacteria;Betaproteobacteria;Burkholderiales;Burkholderiaceae;Cupriavidus;Cupriavidus laharis	0	0	1	0	0	0	0	0	1
Bacteria;Bacteria_none;Actinobacteria;Actinomycetia;Corynebacteriales;Corynebacteriaceae;Corynebacterium;Corynebacterium vitaeruminis	1	0	0	0	0	0	0	0	1
Bacteria;Bacteria_none;Bacteroidota;Chitinophagia;Chitinophagales;Chitinophagaceae;Chitinophaga;Chitinophaga aurantiaca	1	0	0	0	0	0	0	0	1
Bacteria;Bacteria_none;Proteobacteria;Acidithiobacillia;Acidithiobacillales;Acidithiobacillaceae;Acidithiobacillus;Acidithiobacillus ferrooxidans	0	1	0	0	0	0	0	0	1
Bacteria;Bacteria_none;Proteobacteria;Alphaproteobacteria;Alphaproteobacteria_Incertae_sedis;Alphaproteobacteria_Incertae_sedis;Alphaproteobacteria_Incertae_sedis;Aquaspirillum polymorphum	1	0	0	0	0	0	0	0	1
Bacteria;Bacteria_none;Bacteroidota;Chitinophagia;Chitinophagales;Chitinophagaceae;Chitinophaga;Chitinophaga barathri	0	0	0	0	0	0	1	0	1
Bacteria;Bacteria_none;Proteobacteria;Alphaproteobacteria;Caulobacterales;Caulobacteraceae;Asticcacaulis;Asticcacaulis excentricus	0	0	1	0	0	0	0	0	1
Bacteria;Bacteria_none;Actinobacteria;Actinomycetia;Corynebacteriales;Corynebacteriaceae;Corynebacterium;Corynebacterium variabile	0	1	0	0	0	0	0	0	1
Bacteria;Bacteria_none;Proteobacteria;Alphaproteobacteria;Sphingomonadales;Sphingomonadaceae;Sphingorhabdus;Sphingorhabdus soli	0	0	0	0	0	0	1	0	1
Bacteria;Bacteria_none;Proteobacteria;Alphaproteobacteria;Hyphomicrobiales;Blastochloridaceae;Blastochloris;Blastochloris gulmargensis	0	0	1	0	0	0	0	0	1
Bacteria;Bacteria_none;Proteobacteria;Alphaproteobacteria;Emcibacterales;Emcibacteraceae;Paremcibacter;Paremcibacter congregatus	1	0	0	0	0	0	0	0	1
Bacteria;Bacteria_none;Proteobacteria;Alphaproteobacteria;Sphingomonadales;Sphingomonadaceae;Sphingomonas;Sphingomonas desiccabilis	1	0	0	0	0	0	0	0	1
Bacteria;Bacteria_none;Proteobacteria;Alphaproteobacteria;Sphingomonadales;Sphingomonadaceae;Sphingomonas;Sphingomonas crusticola	1	0	0	0	0	0	0	0	1
Bacteria;Bacteria_none;Proteobacteria;Alphaproteobacteria;Hyphomicrobiales;Bartonellaceae;Bartonella;Bartonella alsatica	1	0	0	0	0	0	0	0	1
Bacteria;Bacteria_none;Proteobacteria;Alphaproteobacteria;Sphingomonadales;Sphingomonadaceae;Sphingomonas;Sphingomonas changnyeongensis	1	0	0	0	0	0	0	0	1
Bacteria;Bacteria_none;Proteobacteria;Alphaproteobacteria;Hyphomicrobiales;Bartonellaceae;Bartonella;Bartonella apis	0	1	0	0	0	0	0	0	1
Bacteria;Bacteria_none;Proteobacteria;Alphaproteobacteria;Hyphomicrobiales;Bartonellaceae;Bartonella;Bartonella chomelii	1	0	0	0	0	0	0	0	1
Bacteria;Bacteria_none;Proteobacteria;Alphaproteobacteria;Hyphomicrobiales;Bartonellaceae;Bartonella;Bartonella quintana	1	0	0	0	0	0	0	0	1
Bacteria;Bacteria_none;Proteobacteria;Alphaproteobacteria;Sphingomonadales;Sphingomonadaceae;Sphingomonas;Sphingomonas arantia	0	1	0	0	0	0	0	0	1
Bacteria;Bacteria_none;Proteobacteria;Alphaproteobacteria;Hyphomicrobiales;Beijerinckiaceae;Methylocapsa;Methylocapsa acidiphila	0	0	0	0	0	1	0	0	1
Bacteria;Bacteria_none;Bacteroidota;Chitinophagia;Chitinophagales;Chitinophagaceae;Niabella;Niabella beijingensis	1	0	0	0	0	0	0	0	1
Bacteria;Bacteria_none;Proteobacteria;Alphaproteobacteria;Sphingomonadales;Sphingomonadaceae;Sphingobium;Sphingobium vermicomposti	0	1	0	0	0	0	0	0	1
Bacteria;Bacteria_none;Proteobacteria;Alphaproteobacteria;Sphingomonadales;Sphingomonadaceae;Sphingobium;Sphingobium subterraneum	0	0	1	0	0	0	0	0	1
Bacteria;Bacteria_none;Proteobacteria;Alphaproteobacteria;Sphingomonadales;Sphingomonadaceae;Sphingobium;Sphingobium qiguonii	0	0	0	0	0	1	0	0	1
Bacteria;Bacteria_none;Proteobacteria;Alphaproteobacteria;Sphingomonadales;Sphingomonadaceae;Sphingobium;Sphingobium naphthae	0	0	0	1	0	0	0	0	1
Bacteria;Bacteria_none;Bacteroidota;Chitinophagia;Chitinophagales;Chitinophagaceae;Niabella;Niabella hibiscisoli	1	0	0	0	0	0	0	0	1
Bacteria;Bacteria_none;Bacteroidota;Chitinophagia;Chitinophagales;Chitinophagaceae;Niabella;Niabella soli	1	0	0	0	0	0	0	0	1
Bacteria;Bacteria_none;Proteobacteria;Alphaproteobacteria;Sphingomonadales;Sphingomonadaceae;Sphingobium;Sphingobium estronivorans	0	0	0	1	0	0	0	0	1
Bacteria;Bacteria_none;Proteobacteria;Alphaproteobacteria;Sphingomonadales;Sphingomonadaceae;Sphingobium;Sphingobium cloacae	0	0	1	0	0	0	0	0	1
Bacteria;Bacteria_none;Proteobacteria;Alphaproteobacteria;Sphingomonadales;Sphingomonadaceae;Sphingobium;Sphingobium aromaticiconvertens	1	0	0	0	0	0	0	0	1
Bacteria;Bacteria_none;Proteobacteria;Alphaproteobacteria;Sphingomonadales;Sphingomonadaceae;Rhizorhapis;Rhizorhapis suberifaciens	0	0	1	0	0	0	0	0	1
Bacteria;Bacteria_none;Proteobacteria;Alphaproteobacteria;Sphingomonadales;Sphingomonadaceae;Rhizorhabdus;Rhizorhabdus starnbergensis	1	0	0	0	0	0	0	0	1
Bacteria;Bacteria_none;Cyanobacteria;Cyanobacteria_Incertae_sedis;Oscillatoriales;Laspinemataceae;Laspinema;Laspinema lumbricale	0	0	1	0	0	0	0	0	1
Bacteria;Bacteria_none;Proteobacteria;Alphaproteobacteria;Sphingomonadales;Sphingomonadaceae;Novosphingopyxis;Novosphingopyxis iocasae	1	0	0	0	0	0	0	0	1
Bacteria;Bacteria_none;Proteobacteria;Alphaproteobacteria;Sphingomonadales;Sphingomonadaceae;Sphingomonas;Sphingomonas echinoides	0	0	0	0	0	1	0	0	1
Bacteria;Bacteria_none;Proteobacteria;Alphaproteobacteria;Hyphomicrobiales;Aurantimonadaceae;Fulvimarina;Fulvimarina endophytica	0	0	0	1	0	0	0	0	1
Bacteria;Bacteria_none;Proteobacteria;Alphaproteobacteria;Sphingomonadales;Sphingomonadaceae;Sphingomonas;Sphingomonas fonticola	0	0	1	0	0	0	0	0	1
Bacteria;Bacteria_none;Proteobacteria;Alphaproteobacteria;Sphingomonadales;Sphingomonadaceae;Sphingomonas;Sphingomonas pokkalii	1	0	0	0	0	0	0	0	1
Bacteria;Bacteria_none;Proteobacteria;Alphaproteobacteria;Emcibacterales;Emcibacteraceae;Pseudemcibacter;Pseudemcibacter aquimaris	0	1	0	0	0	0	0	0	1
Bacteria;Bacteria_none;Cyanobacteria;Cyanobacteria_Incertae_sedis;Pleurocapsales;Hyellaceae;Waterburya;Waterburya agarophytonicola	1	0	0	0	0	0	0	0	1
Bacteria;Bacteria_none;Proteobacteria;Alphaproteobacteria;Hyphomicrobiales;Ahrensiaceae;Pseudahrensia;Pseudahrensia aquimaris	0	0	1	0	0	0	0	0	1
Bacteria;Bacteria_none;Cyanobacteria;Cyanobacteria_Incertae_sedis;Oscillatoriales;Sirenicapillariaceae;Capilliphycus;Capilliphycus tropicalis	0	0	0	1	0	0	0	0	1
Bacteria;Bacteria_none;Proteobacteria;Alphaproteobacteria;Hyphomicrobiales;Amorphaceae;Amorphus;Amorphus orientalis	0	1	0	0	0	0	0	0	1
Bacteria;Bacteria_none;Proteobacteria;Alphaproteobacteria;Sphingomonadales;Sphingomonadaceae;Sphingomonas;Sphingomonas vulcanisoli	1	0	0	0	0	0	0	0	1
Bacteria;Bacteria_none;Proteobacteria;Alphaproteobacteria;Sphingomonadales;Sphingomonadaceae;Sphingomonas;Sphingomonas solaris	0	0	0	1	0	0	0	0	1
Bacteria;Bacteria_none;Proteobacteria;Alphaproteobacteria;Sphingomonadales;Sphingomonadaceae;Sphingomonas;Sphingomonas pseudosanguinis	0	0	1	0	0	0	0	0	1
Bacteria;Bacteria_none;Proteobacteria;Alphaproteobacteria;Hyphomicrobiales;Aurantimonadaceae;Aurantimonas;Aurantimonas marina	0	1	0	0	0	0	0	0	1
Bacteria;Bacteria_none;Proteobacteria;Alphaproteobacteria;Sphingomonadales;Sphingomonadaceae;Sphingomonas;Sphingomonas polyaromaticivorans	0	0	0	1	0	0	0	0	1
Bacteria;Bacteria_none;Proteobacteria;Alphaproteobacteria;Sphingomonadales;Sphingomonadaceae;Sphingomonas;Sphingomonas piscinae	1	0	0	0	0	0	0	0	1
Bacteria;Bacteria_none;Proteobacteria;Alphaproteobacteria;Sphingomonadales;Sphingomonadaceae;Sphingomonas;Sphingomonas gei	0	0	1	0	0	0	0	0	1
Bacteria;Bacteria_none;Proteobacteria;Alphaproteobacteria;Hyphomicrobiales;Aurantimonadaceae;Aureimonas;Aureimonas flava	0	0	0	1	0	0	0	0	1
Bacteria;Bacteria_none;Proteobacteria;Alphaproteobacteria;Sphingomonadales;Sphingomonadaceae;Sphingomonas;Sphingomonas parva	0	1	0	0	0	0	0	0	1
Bacteria;Bacteria_none;Proteobacteria;Alphaproteobacteria;Sphingomonadales;Sphingomonadaceae;Sphingomonas;Sphingomonas palmae	0	0	0	0	0	0	0	1	1
Bacteria;Bacteria_none;Proteobacteria;Alphaproteobacteria;Sphingomonadales;Sphingomonadaceae;Sphingomonas;Sphingomonas paeninsulae	0	0	0	1	0	0	0	0	1
Bacteria;Bacteria_none;Proteobacteria;Alphaproteobacteria;Sphingomonadales;Sphingomonadaceae;Sphingomonas;Sphingomonas montana	1	0	0	0	0	0	0	0	1
Bacteria;Bacteria_none;Bacteroidota;Chitinophagia;Chitinophagales;Chitinophagaceae;Nemorincola;Nemorincola caseinilytica	0	0	0	0	0	1	0	0	1
Bacteria;Bacteria_none;Proteobacteria;Alphaproteobacteria;Hyphomicrobiales;Aurantimonadaceae;Aureimonas;Aureimonas glaciistagni	0	0	1	0	0	0	0	0	1
Bacteria;Bacteria_none;Proteobacteria;Alphaproteobacteria;Sphingomonadales;Sphingomonadaceae;Sphingomonas;Sphingomonas insulae	1	0	0	0	0	0	0	0	1
Bacteria;Bacteria_none;Proteobacteria;Alphaproteobacteria;Hyphomicrobiales;Aurantimonadaceae;Aureimonas;Aureimonas rubiginis	1	0	0	0	0	0	0	0	1
Bacteria;Bacteria_none;Proteobacteria;Alphaproteobacteria;Hyphomicrobiales;Aurantimonadaceae;Consotaella;Consotaella salsifontis	0	0	0	1	0	0	0	0	1
Bacteria;Bacteria_none;Proteobacteria;Alphaproteobacteria;Rhodospirillales;Acetobacteraceae;Roseomonas;Roseomonas aceris	0	0	0	0	0	0	0	1	1
Bacteria;Bacteria_none;Proteobacteria;Alphaproteobacteria;Rhodospirillales;Acetobacteraceae;Rhodovarius;Rhodovarius lipocyclicus	0	0	1	0	0	0	0	0	1
Bacteria;Bacteria_none;Proteobacteria;Alphaproteobacteria;Rhodospirillales;Acetobacteraceae;Oleomonas;Oleomonas sagaranensis	0	1	0	0	0	0	0	0	1
Bacteria;Bacteria_none;Proteobacteria;Alphaproteobacteria;Hyphomicrobiales;Phyllobacteriaceae;Phyllobacterium;Phyllobacterium pellucidum	1	0	0	0	0	0	0	0	1
Bacteria;Bacteria_none;Proteobacteria;Alphaproteobacteria;Hyphomicrobiales;Phyllobacteriaceae;Nitratireductor;Nitratireductor basaltis	0	0	1	0	0	0	0	0	1
Bacteria;Bacteria_none;Bacteroidota;Flavobacteriia;Flavobacteriales;Flavobacteriaceae;Flavobacterium;Flavobacterium xanthum	0	0	0	1	0	0	0	0	1
Bacteria;Bacteria_none;Bacteroidota;Flavobacteriia;Flavobacteriales;Flavobacteriaceae;Flavobacterium;Flavobacterium yonginense	1	0	0	0	0	0	0	0	1
Bacteria;Bacteria_none;Proteobacteria;Alphaproteobacteria;Rhodobacterales;Rhodobacteraceae;Cereibacter;Cereibacter ovatus	1	0	0	0	0	0	0	0	1
Bacteria;Bacteria_none;Bacteroidota;Flavobacteriia;Flavobacteriales;Flavobacteriaceae;Frondibacter;Frondibacter aureus	0	1	0	0	0	0	0	0	1
Bacteria;Bacteria_none;Proteobacteria;Alphaproteobacteria;Rhodobacterales;Rhodobacteraceae;Ascidiaceihabitans;Ascidiaceihabitans donghaensis	0	0	0	1	0	0	0	0	1
Bacteria;Bacteria_none;Actinobacteria;Actinomycetia;Corynebacteriales;Corynebacteriaceae;Corynebacterium;Corynebacterium capitovis	0	1	0	0	0	0	0	0	1
Bacteria;Bacteria_none;Actinobacteria;Actinomycetia;Corynebacteriales;Corynebacteriaceae;Corynebacterium;Corynebacterium casei	0	1	0	0	0	0	0	0	1
Bacteria;Bacteria_none;Bacteroidota;Flavobacteriia;Flavobacteriales;Flavobacteriaceae;Gelidibacter;Gelidibacter mesophilus	0	1	0	0	0	0	0	0	1
Bacteria;Bacteria_none;Proteobacteria;Alphaproteobacteria;Hyphomicrobiales;Phyllobacteriaceae;Nitratireductor;Nitratireductor indicus	0	0	0	1	0	0	0	0	1
Bacteria;Bacteria_none;Proteobacteria;Alphaproteobacteria;Rhodobacterales;Rhodobacteraceae;Allgaiera;Allgaiera indica	0	0	0	1	0	0	0	0	1
Bacteria;Bacteria_none;Proteobacteria;Alphaproteobacteria;Rhodobacterales;Rhodobacteraceae;Alkalilacustris;Alkalilacustris brevis	0	1	0	0	0	0	0	0	1
Bacteria;Bacteria_none;Proteobacteria;Alphaproteobacteria;Hyphomicrobiales;Phyllobacteriaceae;Nitratireductor;Nitratireductor shengliensis	1	0	0	0	0	0	0	0	1
Bacteria;Bacteria_none;Bacteroidota;Flavobacteriia;Flavobacteriales;Flavobacteriaceae;Haloflavibacter;Haloflavibacter putidus	0	1	0	0	0	0	0	0	1
Bacteria;Bacteria_none;Bacteroidota;Flavobacteriia;Flavobacteriales;Flavobacteriaceae;Hoppeia;Hoppeia youngheungensis	0	1	0	0	0	0	0	0	1
Bacteria;Bacteria_none;Proteobacteria;Alphaproteobacteria;Hyphomicrobiales;Phyllobacteriaceae;Oceaniradius;Oceaniradius stylonematis	0	0	0	1	0	0	0	0	1
Bacteria;Bacteria_none;Proteobacteria;Alphaproteobacteria;Rhodobacterales;Rhodobacteraceae;Acidimangrovimonas;Acidimangrovimonas sediminis	0	0	1	0	0	0	0	0	1
Bacteria;Bacteria_none;Proteobacteria;Alphaproteobacteria;Hyphomicrobiales;Phyllobacteriaceae;Paramesorhizobium;Paramesorhizobium deserti	0	1	0	0	0	0	0	0	1
Bacteria;Bacteria_none;Bacteroidota;Flavobacteriia;Flavobacteriales;Weeksellaceae;Faecalibacter;Faecalibacter bovis	1	0	0	0	0	0	0	0	1
Bacteria;Bacteria_none;Proteobacteria;Alphaproteobacteria;Parvularculales;Parvularculaceae;Parvularcula;Parvularcula dongshanensis	0	0	0	0	0	1	0	0	1
Bacteria;Bacteria_none;Bacteroidota;Flavobacteriia;Flavobacteriales;Flavobacteriaceae;Imtechella;Imtechella halotolerans	0	1	0	0	0	0	0	0	1
Bacteria;Bacteria_none;Proteobacteria;Alphaproteobacteria;Maricaulales;Robiginitomaculaceae;Robiginitomaculum;Robiginitomaculum antarcticum	0	0	1	0	0	0	0	0	1
Bacteria;Bacteria_none;Bacteroidota;Flavobacteriia;Flavobacteriales;Flavobacteriaceae;Lacinutrix;Lacinutrix himadriensis	1	0	0	0	0	0	0	0	1
Bacteria;Bacteria_none;Bacteroidota;Flavobacteriia;Flavobacteriales;Weeksellaceae;Kaistella;Kaistella anthropi	1	0	0	0	0	0	0	0	1
Bacteria;Bacteria_none;Bacteroidota;Flavobacteriia;Flavobacteriales;Flavobacteriaceae;Flavobacterium;Flavobacterium supellecticarium	1	0	0	0	0	0	0	0	1
Bacteria;Bacteria_none;Bacteroidota;Flavobacteriia;Flavobacteriales;Flavobacteriaceae;Flavobacterium;Flavobacterium suncheonense	1	0	0	0	0	0	0	0	1
Bacteria;Bacteria_none;Proteobacteria;Alphaproteobacteria;Rhodobacterales;Rhodobacteraceae;Histidinibacterium;Histidinibacterium aquaticum	1	0	0	0	0	0	0	0	1
Bacteria;Bacteria_none;Bacteroidota;Flavobacteriia;Flavobacteriales;Flavobacteriaceae;Flavobacterium;Flavobacterium chryseum	1	0	0	0	0	0	0	0	1
Bacteria;Bacteria_none;Proteobacteria;Alphaproteobacteria;Hyphomicrobiales;Phyllobacteriaceae;Hoeflea;Hoeflea prorocentri	0	1	0	0	0	0	0	0	1
Bacteria;Bacteria_none;Proteobacteria;Alphaproteobacteria;Hyphomicrobiales;Phyllobacteriaceae;Lentilitoribacter;Lentilitoribacter donghaensis	0	0	1	0	0	0	0	0	1
Bacteria;Bacteria_none;Proteobacteria;Alphaproteobacteria;Rhodobacterales;Rhodobacteraceae;Paracoccus;Paracoccus alkanivorans	0	0	0	1	0	0	0	0	1
Bacteria;Bacteria_none;Proteobacteria;Alphaproteobacteria;Rhodobacterales;Rhodobacteraceae;Paracoccus;Paracoccus alcaliphilus	1	0	0	0	0	0	0	0	1
Bacteria;Bacteria_none;Proteobacteria;Alphaproteobacteria;Rhodobacterales;Rhodobacteraceae;Oceaniglobus;Oceaniglobus ichthyenteri	0	0	0	1	0	0	0	0	1
Bacteria;Bacteria_none;Proteobacteria;Alphaproteobacteria;Rhodobacterales;Rhodobacteraceae;Marivivens;Marivivens aquimaris	0	1	0	0	0	0	0	0	1
Bacteria;Bacteria_none;Bacteroidota;Saprospiria;Saprospirales;Saprospiraceae;Saprospira;Saprospira grandis	1	0	0	0	0	0	0	0	1
Bacteria;Bacteria_none;Proteobacteria;Alphaproteobacteria;Rhodobacterales;Rhodobacteraceae;Litorivita;Litorivita pollutaquae	0	0	0	1	0	0	0	0	1
Bacteria;Bacteria_none;Proteobacteria;Alphaproteobacteria;Rhodobacterales;Rhodobacteraceae;Jhaorihella;Jhaorihella thermophila	0	0	0	1	0	0	0	0	1
Bacteria;Bacteria_none;Proteobacteria;Alphaproteobacteria;Rhodobacterales;Rhodobacteraceae;Harenicola;Harenicola maris	1	0	0	0	0	0	0	0	1
Bacteria;Bacteria_none;Bacteroidota;Flavobacteriia;Flavobacteriales;Flavobacteriaceae;Flavobacterium;Flavobacterium silvisoli	0	1	0	0	0	0	0	0	1
Bacteria;Bacteria_none;Actinobacteria;Actinomycetia;Micrococcales;Microbacteriaceae;Agromyces;Agromyces intestinalis	0	0	0	1	0	0	0	0	1
Bacteria;Bacteria_none;Proteobacteria;Alphaproteobacteria;Rhodobacterales;Rhodobacteraceae;Halocynthiibacter;Halocynthiibacter namhaensis	1	0	0	0	0	0	0	0	1
Bacteria;Bacteria_none;Proteobacteria;Alphaproteobacteria;Rhodobacterales;Rhodobacteraceae;Haematobacter;Haematobacter massiliensis	0	0	0	0	1	0	0	0	1
Bacteria;Bacteria_none;Bacteroidota;Saprospiria;Saprospirales;Saprospiraceae;Aureispira;Aureispira marina	1	0	0	0	0	0	0	0	1
Bacteria;Bacteria_none;Bacteroidota;Flavobacteriia;Flavobacteriales;Flavobacteriaceae;Flavobacterium;Flavobacterium maotaiense	1	0	0	0	0	0	0	0	1
Bacteria;Bacteria_none;Bacteroidota;Saprospiria;Saprospirales;Lewinellaceae;Neolewinella;Neolewinella lacunae	0	1	0	0	0	0	0	0	1
Bacteria;Bacteria_none;Bacteroidota;Saprospiria;Saprospirales;Lewinellaceae;Neolewinella;Neolewinella aquimaris	0	1	0	0	0	0	0	0	1
Bacteria;Bacteria_none;Bacteroidota;Flavobacteriia;Flavobacteriales;Flavobacteriaceae;Flavobacterium;Flavobacterium petrolei	0	0	0	1	0	0	0	0	1
Bacteria;Bacteria_none;Bacteroidota;Flavobacteriia;Flavobacteriales;Weeksellaceae;Moheibacter;Moheibacter sediminis	1	0	0	0	0	0	0	0	1
Bacteria;Bacteria_none;Bacteroidota;Flavobacteriia;Flavobacteriales;Flavobacteriaceae;Flavobacterium;Flavobacterium sasangense	0	1	0	0	0	0	0	0	1
Bacteria;Bacteria_none;Proteobacteria;Alphaproteobacteria;Magnetococcales;Magnetococcaceae;Magnetofaba;Magnetofaba australis	0	0	0	0	0	0	1	0	1
Bacteria;Bacteria_none;Proteobacteria;Alphaproteobacteria;Hyphomicrobiales;Phyllobacteriaceae;Phyllobacterium;Phyllobacterium salinisoli	0	0	0	1	0	0	0	0	1
Bacteria;Bacteria_none;Bacteroidota;Sphingobacteriia;Sphingobacteriales;Sphingobacteriaceae;Mucilaginibacter;Mucilaginibacter auburnensis	0	0	0	1	0	0	0	0	1
Bacteria;Bacteria_none;Proteobacteria;Alphaproteobacteria;Hyphomicrobiales;Phyllobacteriaceae;Pseudaminobacter;Pseudaminobacter arsenicus	0	0	0	0	0	0	1	0	1
Bacteria;Bacteria_none;Proteobacteria;Alphaproteobacteria;Hyphomicrobiales;Rhizobiaceae;Allorhizobium;Allorhizobium undicola	0	1	0	0	0	0	0	0	1
Bacteria;Bacteria_none;Bacteroidota;Flavobacteriia;Flavobacteriales;Flavobacteriaceae;Polaribacter;Polaribacter filamentus	1	0	0	0	0	0	0	0	1
Bacteria;Bacteria_none;Bacteroidota;Flavobacteriia;Flavobacteriales;Flavobacteriaceae;Pricia;Pricia antarctica	0	0	1	0	0	0	0	0	1
Bacteria;Bacteria_none;Bacteroidota;Flavobacteriia;Flavobacteriales;Flavobacteriaceae;Psychroflexus;Psychroflexus salarius	0	0	0	1	0	0	0	0	1
Bacteria;Bacteria_none;Bacteroidota;Flavobacteriia;Flavobacteriales;Flavobacteriaceae;Psychroflexus;Psychroflexus torquis	0	0	1	0	0	0	0	0	1
Bacteria;Bacteria_none;Proteobacteria;Alphaproteobacteria;Hyphomicrobiales;Rhizobiaceae;Sinorhizobium;Sinorhizobium meliloti	0	0	0	0	0	1	0	0	1
Bacteria;Bacteria_none;Proteobacteria;Alphaproteobacteria;Hyphomicrobiales;Rhizobiaceae;Ciceribacter;Ciceribacter lividus	0	1	0	0	0	0	0	0	1
Bacteria;Bacteria_none;Proteobacteria;Alphaproteobacteria;Hyphomicrobiales;Rhizobiaceae;Gellertiella;Gellertiella hungarica	0	1	0	0	0	0	0	0	1
Bacteria;Bacteria_none;Actinobacteria;Actinomycetia;Corynebacteriales;Corynebacteriaceae;Corynebacterium;Corynebacterium efficiens	0	1	0	0	0	0	0	0	1
Bacteria;Bacteria_none;Bacteroidota;Flavobacteriia;Flavobacteriales;Flavobacteriaceae;Salegentibacter;Salegentibacter sediminis	0	0	0	1	0	0	0	0	1
Bacteria;Bacteria_none;Bacteroidota;Flavobacteriia;Flavobacteriales;Weeksellaceae;Chryseobacterium;Chryseobacterium gleum	0	0	1	0	0	0	0	0	1
Bacteria;Bacteria_none;Proteobacteria;Alphaproteobacteria;Hyphomicrobiales;Rhizobiaceae;Rhizobium;Rhizobium rhizoryzae	0	0	0	1	0	0	0	0	1
Bacteria;Bacteria_none;Bacteroidota;Flavobacteriia;Flavobacteriales;Flavobacteriaceae;Winogradskyella;Winogradskyella jejuensis	1	0	0	0	0	0	0	0	1
Bacteria;Bacteria_none;Proteobacteria;Alphaproteobacteria;Hyphomicrobiales;Rhizobiaceae;Pararhizobium;Pararhizobium capsulatum	0	1	0	0	0	0	0	0	1
Bacteria;Bacteria_none;Bacteroidota;Flavobacteriia;Flavobacteriales;Ichthyobacteriaceae;Ichthyobacterium;Ichthyobacterium seriolicida	1	0	0	0	0	0	0	0	1
Bacteria;Bacteria_none;Proteobacteria;Alphaproteobacteria;Hyphomicrobiales;Rhizobiaceae;Pararhizobium;Pararhizobium mangrovi	1	0	0	0	0	0	0	0	1
Bacteria;Bacteria_none;Bacteroidota;Flavobacteriia;Flavobacteriales;Schleiferiaceae;Thermaurantimonas;Thermaurantimonas aggregans	0	1	0	0	0	0	0	0	1
Bacteria;Bacteria_none;Proteobacteria;Alphaproteobacteria;Hyphomicrobiales;Rhizobiaceae;Rhizobium;Rhizobium hainanense	1	0	0	0	0	0	0	0	1
Bacteria;Bacteria_none;Bacteroidota;Flavobacteriia;Flavobacteriales;Weeksellaceae;Apibacter;Apibacter adventoris	1	0	0	0	0	0	0	0	1
Bacteria;Bacteria_none;Bacteroidota;Flavobacteriia;Flavobacteriales;Weeksellaceae;Chryseobacterium;Chryseobacterium caseinilyticum	1	0	0	0	0	0	0	0	1
Bacteria;Bacteria_none;Proteobacteria;Alphaproteobacteria;Hyphomicrobiales;Rhizobiaceae;Pararhizobium;Pararhizobium polonicum	0	0	1	0	0	0	0	0	1
Bacteria;Bacteria_none;Bacteroidota;Flavobacteriia;Flavobacteriales;Weeksellaceae;Chryseobacterium;Chryseobacterium echinoideorum	1	0	0	0	0	0	0	0	1
Bacteria;Bacteria_none;Proteobacteria;Alphaproteobacteria;Hyphomicrobiales;Rhizobiaceae;Rhizobium;Rhizobium azibense	0	1	0	0	0	0	0	0	1
Bacteria;Bacteria_none;Bacteroidota;Flavobacteriia;Flavobacteriales;Weeksellaceae;Chryseobacterium;Chryseobacterium koreense	1	0	0	0	0	0	0	0	1
Bacteria;Bacteria_none;Bacteroidota;Flavobacteriia;Flavobacteriales;Weeksellaceae;Chryseobacterium;Chryseobacterium oleae	1	0	0	0	0	0	0	0	1
Bacteria;Bacteria_none;Bacteroidota;Flavobacteriia;Flavobacteriales;Flavobacteriaceae;Nonlabens;Nonlabens xylanidelens	0	0	0	1	0	0	0	0	1
Bacteria;Bacteria_none;Proteobacteria;Alphaproteobacteria;Hyphomicrobiales;Pleomorphomonadaceae;Hartmannibacter;Hartmannibacter diazotrophicus	0	0	1	0	0	0	0	0	1
Bacteria;Bacteria_none;Proteobacteria;Alphaproteobacteria;Hyphomonadales;Hyphomonadaceae;Henriciella;Henriciella mobilis	0	0	0	0	0	1	0	0	1
Bacteria;Bacteria_none;Proteobacteria;Alphaproteobacteria;Hyphomicrobiales;Phyllobacteriaceae;Pseudaminobacter;Pseudaminobacter soli	0	0	0	1	0	0	0	0	1
Bacteria;Bacteria_none;Bacteroidota;Flavobacteriia;Flavobacteriales;Weeksellaceae;Epilithonimonas;Epilithonimonas ginsengisoli	0	1	0	0	0	0	0	0	1
Bacteria;Bacteria_none;Bacteroidota;Flavobacteriia;Flavobacteriales;Weeksellaceae;Epilithonimonas;Epilithonimonas caeni	0	1	0	0	0	0	0	0	1
Bacteria;Bacteria_none;Bacteroidota;Flavobacteriia;Flavobacteriales;Flavobacteriaceae;Lutibacter;Lutibacter flavus	0	0	1	0	0	0	0	0	1
Bacteria;Bacteria_none;Proteobacteria;Alphaproteobacteria;Hyphomicrobiales;Xanthobacteraceae;Starkeya;Starkeya koreensis	0	0	1	0	0	0	0	0	1
Bacteria;Bacteria_none;Bacteroidota;Flavobacteriia;Flavobacteriales;Flavobacteriaceae;Maritimimonas;Maritimimonas rapanae	1	0	0	0	0	0	0	0	1
Bacteria;Bacteria_none;Actinobacteria;Actinomycetia;Corynebacteriales;Corynebacteriaceae;Corynebacterium;Corynebacterium ciconiae	0	1	0	0	0	0	0	0	1
Bacteria;Bacteria_none;Bacteroidota;Flavobacteriia;Flavobacteriales;Flavobacteriaceae;Mesonia;Mesonia algae	0	0	0	0	0	0	1	0	1
Bacteria;Bacteria_none;Bacteroidota;Flavobacteriia;Flavobacteriales;Flavobacteriaceae;Mesonia;Mesonia sediminis	0	0	0	1	0	0	0	0	1
Bacteria;Bacteria_none;Bacteroidota;Flavobacteriia;Flavobacteriales;Flavobacteriaceae;Myroides;Myroides guanonis	0	1	0	0	0	0	0	0	1
Bacteria;Bacteria_none;Proteobacteria;Alphaproteobacteria;Hyphomicrobiales;Salinarimonadaceae;Salinarimonas;Salinarimonas ramus	1	0	0	0	0	0	0	0	1
Bacteria;Bacteria_none;Bacteroidota;Flavobacteriia;Flavobacteriales;Weeksellaceae;Elizabethkingia;Elizabethkingia miricola	1	0	0	0	0	0	0	0	1
Bacteria;Bacteria_none;Actinobacteria;Actinomycetia;Corynebacteriales;Corynebacteriaceae;Corynebacterium;Corynebacterium godavarianum	0	1	0	0	0	0	0	0	1
Bacteria;Bacteria_none;Actinobacteria;Actinomycetia;Corynebacteriales;Corynebacteriaceae;Corynebacterium;Corynebacterium glucuronolyticum	0	0	0	0	0	1	0	0	1
Bacteria;Bacteria_none;Bacteroidota;Flavobacteriia;Flavobacteriales;Weeksellaceae;Chryseobacterium;Chryseobacterium rigui	1	0	0	0	0	0	0	0	1
Bacteria;Bacteria_none;Proteobacteria;Alphaproteobacteria;Hyphomicrobiales;Stappiaceae;Roseibium;Roseibium salinum	1	0	0	0	0	0	0	0	1
Bacteria;Bacteria_none;Proteobacteria;Alphaproteobacteria;Hyphomicrobiales;Stappiaceae;Roseibium;Roseibium denhamense	1	0	0	0	0	0	0	0	1
Bacteria;Bacteria_none;Proteobacteria;Alphaproteobacteria;Hyphomicrobiales;Stappiaceae;Roseibium;Roseibium aquae	0	1	0	0	0	0	0	0	1
Bacteria;Bacteria_none;Bacteroidota;Flavobacteriia;Flavobacteriales;Flavobacteriaceae;Nonlabens;Nonlabens dokdonensis	0	0	0	0	0	0	1	0	1
Bacteria;Bacteria_none;Proteobacteria;Alphaproteobacteria;Hyphomicrobiales;Stappiaceae;Pannonibacter;Pannonibacter carbonis	0	0	1	0	0	0	0	0	1
Bacteria;Bacteria_none;Proteobacteria;Alphaproteobacteria;Hyphomicrobiales;Segnochrobactraceae;Segnochrobactrum;Segnochrobactrum spirostomi	1	0	0	0	0	0	0	0	1
Bacteria;Bacteria_none;Bacteroidota;Flavobacteriia;Flavobacteriales;Flavobacteriaceae;Flavobacterium;Flavobacterium cheniae	1	0	0	0	0	0	0	0	1
Bacteria;Bacteria_none;Bacteroidota;Flavobacteriia;Flavobacteriales;Flavobacteriaceae;Flavobacterium;Flavobacterium antarcticum	0	0	0	1	0	0	0	0	1
Bacteria;Bacteria_none;Proteobacteria;Alphaproteobacteria;Hyphomicrobiales;Lichenibacteriaceae;Lichenibacterium;Lichenibacterium minor	0	0	1	0	0	0	0	0	1
Bacteria;Bacteria_none;Proteobacteria;Alphaproteobacteria;Rhodobacterales;Rhodobacteraceae;Rhodovulum;Rhodovulum strictum	0	0	0	1	0	0	0	0	1
Bacteria;Bacteria_none;Proteobacteria;Alphaproteobacteria;Rhodobacterales;Roseobacteraceae;Roseovarius;Roseovarius lutimaris	1	0	0	0	0	0	0	0	1
Bacteria;Bacteria_none;Proteobacteria;Alphaproteobacteria;Rhodobacterales;Roseobacteraceae;Roseovarius;Roseovarius arcticus	0	0	0	1	0	0	0	0	1
Bacteria;Bacteria_none;Proteobacteria;Alphaproteobacteria;Rhodobacterales;Roseobacteraceae;Roseobacter;Roseobacter denitrificans	0	0	0	1	0	0	0	0	1
Bacteria;Bacteria_none;Proteobacteria;Alphaproteobacteria;Hyphomicrobiales;Methylobacteriaceae;Microvirga;Microvirga arsenatis	0	1	0	0	0	0	0	0	1
Bacteria;Bacteria_none;Proteobacteria;Alphaproteobacteria;Rhodobacterales;Roseobacteraceae;Roseivivax;Roseivivax halodurans	0	1	0	0	0	0	0	0	1
Bacteria;Bacteria_none;Proteobacteria;Alphaproteobacteria;Rhodobacterales;Roseobacteraceae;Pontibaca;Pontibaca methylaminivorans	0	0	0	0	1	0	0	0	1
Bacteria;Bacteria_none;Proteobacteria;Alphaproteobacteria;Rhodobacterales;Roseobacteraceae;Pacificibacter;Pacificibacter maritimus	0	1	0	0	0	0	0	0	1
Bacteria;Bacteria_none;Chloroflexi;Chloroflexia;Chloroflexales;Roseiflexaceae;Heliothrix;Heliothrix oregonensis	1	0	0	0	0	0	0	0	1
Bacteria;Bacteria_none;Proteobacteria;Alphaproteobacteria;Rhodobacterales;Roseobacteraceae;Octadecabacter;Octadecabacter antarcticus	0	1	0	0	0	0	0	0	1
Bacteria;Bacteria_none;Proteobacteria;Alphaproteobacteria;Rhodobacterales;Roseobacteraceae;Maritimibacter;Maritimibacter alexandrii	1	0	0	0	0	0	0	0	1
Bacteria;Bacteria_none;Proteobacteria;Alphaproteobacteria;Rhodobacterales;Roseobacteraceae;Maribius;Maribius salinus	0	0	1	0	0	0	0	0	1
Bacteria;Bacteria_none;Proteobacteria;Alphaproteobacteria;Rhodobacterales;Roseobacteraceae;Maribius;Maribius pelagius	1	0	0	0	0	0	0	0	1
Bacteria;Bacteria_none;Proteobacteria;Alphaproteobacteria;Rhodobacterales;Roseobacteraceae;Loktanella;Loktanella fryxellensis	0	0	1	0	0	0	0	0	1
Bacteria;Bacteria_none;Proteobacteria;Alphaproteobacteria;Hyphomicrobiales;Methylobacteriaceae;Microvirga;Microvirga subterranea	0	0	0	0	0	1	0	0	1
Bacteria;Bacteria_none;Proteobacteria;Alphaproteobacteria;Rhodobacterales;Roseobacteraceae;Dinoroseobacter;Dinoroseobacter shibae	0	0	0	1	0	0	0	0	1
Bacteria;Bacteria_none;Actinobacteria;Actinomycetia;Bifidobacteriales;Bifidobacteriaceae;Bombiscardovia;Bombiscardovia coagulans	0	0	1	0	0	0	0	0	1
Bacteria;Bacteria_none;Chloroflexi;Chloroflexia;Chloroflexales;Chloroflexaceae;Chloroflexus;Chloroflexus aurantiacus	0	1	0	0	0	0	0	0	1
Bacteria;Bacteria_none;Proteobacteria;Alphaproteobacteria;Hyphomicrobiales;Methylocystaceae;Chenggangzhangella;Chenggangzhangella methanolivorans	0	0	1	0	0	0	0	0	1
Bacteria;Bacteria_none;Actinobacteria;Actinomycetia;Bifidobacteriales;Bifidobacteriaceae;Gardnerella;Gardnerella vaginalis	0	0	0	0	0	0	0	1	1
Bacteria;Bacteria_none;Bacteroidota;Cytophagia;Cytophagales;Hymenobacteraceae;Pontibacter;Pontibacter roseus	0	1	0	0	0	0	0	0	1
Bacteria;Bacteria_none;Chlorobi;Chlorobia;Chlorobiales;Chlorobiaceae;Prosthecochloris;Prosthecochloris marina	0	1	0	0	0	0	0	0	1
Bacteria;Bacteria_none;Proteobacteria;Alphaproteobacteria;Rhodobacterales;Rhodobacteraceae;Sinirhodobacter;Sinirhodobacter populi	0	1	0	0	0	0	0	0	1
Bacteria;Bacteria_none;Bacteroidota;Cytophagia;Cytophagales;Hymenobacteraceae;Pontibacter;Pontibacter xinjiangensis	1	0	0	0	0	0	0	0	1
Bacteria;Bacteria_none;Proteobacteria;Alphaproteobacteria;Hyphomicrobiales;Methylobacteriaceae;Methylorubrum;Methylorubrum thiocyanatum	0	0	0	0	0	0	0	1	1
Bacteria;Bacteria_none;Bacteroidota;Cytophagia;Cytophagales;Hymenobacteraceae;Hymenobacter;Hymenobacter psychrotolerans	0	0	0	0	0	0	0	1	1
Bacteria;Bacteria_none;Proteobacteria;Alphaproteobacteria;Rhodobacterales;Roseobacteraceae;Seohaeicola;Seohaeicola westpacificensis	0	0	1	0	0	0	0	0	1
Bacteria;Bacteria_none;Proteobacteria;Alphaproteobacteria;Rhodospirillales;Acetobacteraceae;Asaia;Asaia prunellae	1	0	0	0	0	0	0	0	1
Bacteria;Bacteria_none;Bacteroidota;Cytophagia;Cytophagales;Flammeovirgaceae;Sediminitomix;Sediminitomix flava	1	0	0	0	0	0	0	0	1
Bacteria;Bacteria_none;Proteobacteria;Alphaproteobacteria;Rhodospirillales;Acetobacteraceae;Gluconobacter;Gluconobacter wancherniae	1	0	0	0	0	0	0	0	1
Bacteria;Bacteria_none;Proteobacteria;Alphaproteobacteria;Rhodospirillales;Acetobacteraceae;Falsiroseomonas;Falsiroseomonas wooponensis	0	0	1	0	0	0	0	0	1
Bacteria;Bacteria_none;Proteobacteria;Alphaproteobacteria;Hyphomicrobiales;Methylobacteriaceae;Methylobacterium;Methylobacterium crusticola	1	0	0	0	0	0	0	0	1
Bacteria;Bacteria_none;Proteobacteria;Alphaproteobacteria;Rhodospirillales;Acetobacteraceae;Falsiroseomonas;Falsiroseomonas arcticisoli	0	1	0	0	0	0	0	0	1
Bacteria;Bacteria_none;Proteobacteria;Alphaproteobacteria;Hyphomicrobiales;Methylobacteriaceae;Methylobacterium;Methylobacterium durans	0	0	1	0	0	0	0	0	1
Bacteria;Bacteria_none;Proteobacteria;Alphaproteobacteria;Rhodospirillales;Acetobacteraceae;Craurococcus;Craurococcus roseus	0	1	0	0	0	0	0	0	1
Bacteria;Bacteria_none;Proteobacteria;Alphaproteobacteria;Hyphomicrobiales;Methylobacteriaceae;Methylobacterium;Methylobacterium goesingense	0	0	0	1	0	0	0	0	1
Bacteria;Bacteria_none;Proteobacteria;Alphaproteobacteria;Hyphomicrobiales;Methylobacteriaceae;Methylobacterium;Methylobacterium jeotgali	0	0	0	1	0	0	0	0	1
Bacteria;Bacteria_none;Proteobacteria;Alphaproteobacteria;Rhodospirillales;Acetobacteraceae;Belnapia;Belnapia rosea	0	0	1	0	0	0	0	0	1
Bacteria;Bacteria_none;Proteobacteria;Alphaproteobacteria;Hyphomicrobiales;Methylobacteriaceae;Methylobacterium;Methylobacterium organophilum	0	1	0	0	0	0	0	0	1
Bacteria;Bacteria_none;Proteobacteria;Alphaproteobacteria;Rhodobacterales;Roseobacteraceae;Sulfitobacter;Sulfitobacter faviae	0	0	0	0	1	0	0	0	1
Bacteria;Bacteria_none;Bacteroidota;Cytophagia;Cytophagales;Hymenobacteraceae;Adhaeribacter;Adhaeribacter radiodurans	0	1	0	0	0	0	0	0	1
Bacteria;Bacteria_none;Bacteroidota;Cytophagia;Cytophagales;Hymenobacteraceae;Botryobacter;Botryobacter ruber	0	0	0	1	0	0	0	0	1
Bacteria;Bacteria_none;Proteobacteria;Alphaproteobacteria;Rhodospirillales;Acetobacteraceae;Acetobacter;Acetobacter thailandicus	0	0	0	0	0	0	1	0	1
Bacteria;Bacteria_none;Proteobacteria;Alphaproteobacteria;Rhodospirillales;Acetobacteraceae;Acetobacter;Acetobacter suratthaniensis	0	0	1	0	0	0	0	0	1
Bacteria;Bacteria_none;Proteobacteria;Alphaproteobacteria;Hyphomicrobiales;Methylobacteriaceae;Methylobacterium;Methylobacterium radiodurans	0	1	0	0	0	0	0	0	1
Bacteria;Bacteria_none;Bacteroidota;Cytophagia;Cytophagales;Hymenobacteraceae;Hymenobacter;Hymenobacter coalescens	0	1	0	0	0	0	0	0	1
Bacteria;Bacteria_none;Proteobacteria;Alphaproteobacteria;Hyphomicrobiales;Methylobacteriaceae;Methylorubrum;Methylorubrum podarium	0	0	0	0	0	0	1	0	1
Bacteria;Bacteria_none;Proteobacteria;Alphaproteobacteria;Rhodospirillales;Acetobacteraceae;Acetobacter;Acetobacter estunensis	0	1	0	0	0	0	0	0	1
Bacteria;Bacteria_none;Proteobacteria;Alphaproteobacteria;Rhodobacterales;Roseobacteraceae;Tranquillimonas;Tranquillimonas rosea	0	0	0	1	0	0	0	0	1
Bacteria;Bacteria_none;Proteobacteria;Alphaproteobacteria;Rhodobacterales;Roseobacteraceae;Thalassobius;Thalassobius mangrovi	1	0	0	0	0	0	0	0	1
Bacteria;Bacteria_none;Proteobacteria;Alphaproteobacteria;Rhodobacterales;Rhodobacteraceae;Rubribacterium;Rubribacterium polymorphum	0	0	0	0	0	0	1	0	1
Bacteria;Bacteria_none;Chlamydiae;Chlamydiia;Parachlamydiales;Parachlamydiaceae;Neochlamydia;Neochlamydia hartmannellae	0	1	0	0	0	0	0	0	1
Bacteria;Bacteria_none;Proteobacteria;Alphaproteobacteria;Rhodobacterales;Rhodobacteraceae;Paracoccus;Paracoccus beibuensis	0	0	1	0	0	0	0	0	1
Bacteria;Bacteria_none;Chlamydiae;Chlamydiia;Parachlamydiales;Parachlamydiaceae;Candidatus Protochlamydia;Candidatus Protochlamydia naegleriophila	0	0	0	0	0	0	0	1	1
Bacteria;Bacteria_none;Bacteroidota;Sphingobacteriia;Sphingobacteriales;Sphingobacteriaceae;Pedobacter;Pedobacter zeae	0	0	1	0	0	0	0	0	1
Bacteria;Bacteria_none;Proteobacteria;Alphaproteobacteria;Rhodobacterales;Rhodobacteraceae;Pararhodobacter;Pararhodobacter marinus	0	1	0	0	0	0	0	0	1
Bacteria;Bacteria_none;Bacteroidota;Cytophagia;Cytophagales;Spirosomaceae;Persicitalea;Persicitalea jodogahamensis	0	1	0	0	0	0	0	0	1
Bacteria;Bacteria_none;Bacteroidota;Cytophagia;Cytophagales;Spirosomaceae;Runella;Runella aurantiaca	1	0	0	0	0	0	0	0	1
Bacteria;Bacteria_none;Bacteroidota;Cytophagia;Cytophagales;Spirosomaceae;Runella;Runella zeae	1	0	0	0	0	0	0	0	1
Bacteria;Bacteria_none;Bacteroidota;Cytophagia;Cytophagales;Spirosomaceae;Taeseokella;Taeseokella kangwonensis	1	0	0	0	0	0	0	0	1
Bacteria;Bacteria_none;Proteobacteria;Alphaproteobacteria;Hyphomicrobiales;Parvibaculaceae;Rhodoligotrophos;Rhodoligotrophos appendicifer	0	0	1	0	0	0	0	0	1
Bacteria;Bacteria_none;Bacteroidota;Flavobacteriia;Flavobacteriales;Crocinitomicaceae;Crocinitomix;Crocinitomix catalasitica	1	0	0	0	0	0	0	0	1
Bacteria;Bacteria_none;Proteobacteria;Alphaproteobacteria;Hyphomicrobiales;Parvibaculaceae;Tepidicaulis;Tepidicaulis marinus	1	0	0	0	0	0	0	0	1
Bacteria;Bacteria_none;Actinobacteria;Actinomycetia;Corynebacteriales;Corynebacteriaceae;Corynebacterium;Corynebacterium afermentans	0	0	0	0	1	0	0	0	1
Bacteria;Bacteria_none;Bacteroidota;Sphingobacteriia;Sphingobacteriales;Sphingobacteriaceae;Pedobacter;Pedobacter ginsengiterrae	0	0	0	1	0	0	0	0	1
Bacteria;Bacteria_none;Bacteroidota;Flavobacteriia;Flavobacteriales;Flavobacteriaceae;Amniculibacterium;Amniculibacterium aquaticum	0	1	0	0	0	0	0	0	1
Bacteria;Bacteria_none;Actinobacteria;Actinomycetia;Corynebacteriales;Corynebacteriaceae;Corynebacterium;Corynebacterium atrinae	0	0	1	0	0	0	0	0	1
Bacteria;Bacteria_none;Proteobacteria;Alphaproteobacteria;Rhodobacterales;Rhodobacteraceae;Paracoccus;Paracoccus laeviglucosivorans	0	0	0	1	0	0	0	0	1
Bacteria;Bacteria_none;Bacteroidota;Sphingobacteriia;Sphingobacteriales;Sphingobacteriaceae;Pedobacter;Pedobacter daejeonensis	0	1	0	0	0	0	0	0	1
Bacteria;Bacteria_none;Proteobacteria;Alphaproteobacteria;Hyphomicrobiales;Phyllobacteriaceae;Aminobacter;Aminobacter ciceronei	0	0	1	0	0	0	0	0	1
Bacteria;Bacteria_none;Proteobacteria;Alphaproteobacteria;Hyphomicrobiales;Phyllobacteriaceae;Aquamicrobium;Aquamicrobium segne	0	1	0	0	0	0	0	0	1
Bacteria;Bacteria_none;Bacteroidota;Sphingobacteriia;Sphingobacteriales;Sphingobacteriaceae;Pedobacter;Pedobacter aquae	0	1	0	0	0	0	0	0	1
Bacteria;Bacteria_none;Bacteroidota;Sphingobacteriia;Sphingobacteriales;Sphingobacteriaceae;Pararcticibacter;Pararcticibacter amylolyticus	1	0	0	0	0	0	0	0	1
Bacteria;Bacteria_none;Bacteroidota;Flavobacteriia;Flavobacteriales;Flavobacteriaceae;Cellulophaga;Cellulophaga tyrosinoxydans	0	0	0	0	0	0	0	1	1
Bacteria;Bacteria_none;Bacteroidota;Flavobacteriia;Flavobacteriales;Flavobacteriaceae;Citreitalea;Citreitalea marina	0	1	0	0	0	0	0	0	1
Bacteria;Bacteria_none;Bacteroidota;Sphingobacteriia;Sphingobacteriales;Sphingobacteriaceae;Mucilaginibacter;Mucilaginibacter calamicampi	0	0	0	1	0	0	0	0	1
Bacteria;Bacteria_none;Proteobacteria;Alphaproteobacteria;Hyphomicrobiales;Phyllobacteriaceae;Hoeflea;Hoeflea marina	0	1	0	0	0	0	0	0	1
Bacteria;Bacteria_none;Proteobacteria;Alphaproteobacteria;Hyphomicrobiales;Nitrobacteraceae;Bradyrhizobium;Bradyrhizobium oligotrophicum	0	0	0	0	0	1	0	0	1
Bacteria;Bacteria_none;Bacteroidota;Sphingobacteriia;Sphingobacteriales;Sphingobacteriaceae;Sphingobacterium;Sphingobacterium changzhouense	0	0	0	0	0	0	0	1	1
Bacteria;Bacteria_none;Bacteroidota;Cytophagia;Cytophagales;Spirosomaceae;Fluviimonas;Fluviimonas pallidilutea	0	0	0	1	0	0	0	0	1
Bacteria;Bacteria_none;Bacteroidota;Cytophagia;Cytophagales;Spirosomaceae;Dyadobacter;Dyadobacter frigoris	0	0	0	0	1	0	0	0	1
Bacteria;Bacteria_none;Proteobacteria;Alphaproteobacteria;Rhodobacterales;Rhodobacteraceae;Rhodovulum;Rhodovulum iodosum	0	1	0	0	0	0	0	0	1
Bacteria;Bacteria_none;Bacteroidota;Cytophagia;Cytophagales;Reichenbachiellaceae;Marinoscillum;Marinoscillum pacificum	1	0	0	0	0	0	0	0	1
Bacteria;Bacteria_none;Actinobacteria;Actinomycetia;Corynebacteriales;Corynebacteriaceae;Corynebacterium;Corynebacterium humireducens	0	0	0	1	0	0	0	0	1
Bacteria;Bacteria_none;Bacteroidota;Cytophagia;Cytophagales;Reichenbachiellaceae;Reichenbachiella;Reichenbachiella agariperforans	0	1	0	0	0	0	0	0	1
Bacteria;Bacteria_none;Bacteroidota;Cytophagia;Cytophagales;Reichenbachiellaceae;Reichenbachiella;Reichenbachiella faecimaris	0	0	1	0	0	0	0	0	1
Bacteria;Bacteria_none;Proteobacteria;Alphaproteobacteria;Rhodobacterales;Rhodobacteraceae;Rhodobacter;Rhodobacter xinxiangensis	1	0	0	0	0	0	0	0	1
Bacteria;Bacteria_none;Bacteroidota;Cytophagia;Cytophagales;Roseivirgaceae;Roseivirga;Roseivirga echinicomitans	0	0	0	0	0	0	1	0	1
Bacteria;Bacteria_none;Actinobacteria;Actinomycetia;Bifidobacteriales;Bifidobacteriaceae;Parascardovia;Parascardovia denticolens	0	0	0	1	0	0	0	0	1
Bacteria;Bacteria_none;Bacteroidota;Cytophagia;Cytophagales;Spirosomaceae;Arcticibacterium;Arcticibacterium luteifluviistationis	0	0	1	0	0	0	0	0	1
Bacteria;Bacteria_none;Actinobacteria;Actinomycetia;Corynebacteriales;Corynebacteriaceae;Corynebacterium;Corynebacterium hansenii	0	0	0	0	0	0	1	0	1
Bacteria;Bacteria_none;Proteobacteria;Alphaproteobacteria;Hyphomicrobiales;Nitrobacteraceae;Bradyrhizobium;Bradyrhizobium denitrificans	0	0	0	0	0	0	0	1	1
Bacteria;Bacteria_none;Proteobacteria;Alphaproteobacteria;Rhodobacterales;Rhodobacteraceae;Pontivivens;Pontivivens insulae	0	0	0	1	0	0	0	0	1
Bacteria;Bacteria_none;Proteobacteria;Alphaproteobacteria;Rhodobacterales;Rhodobacteraceae;Pseudoroseicyclus;Pseudoroseicyclus tamaricis	0	1	0	0	0	0	0	0	1
Bacteria;Bacteria_none;Proteobacteria;Alphaproteobacteria;Rhodobacterales;Rhodobacteraceae;Pseudorhodobacter;Pseudorhodobacter wandonensis	0	0	1	0	0	0	0	0	1
Bacteria;Bacteria_none;Proteobacteria;Alphaproteobacteria;Rhodobacterales;Rhodobacteraceae;Pseudorhodobacter;Pseudorhodobacter turbinis	1	0	0	0	0	0	0	0	1
Bacteria;Bacteria_none;Bacteroidota;Sphingobacteriia;Sphingobacteriales;Sphingobacteriaceae;Sphingobacterium;Sphingobacterium thalpophilum	0	0	1	0	0	0	0	0	1
Bacteria;Bacteria_none;Proteobacteria;Alphaproteobacteria;Rhodobacterales;Rhodobacteraceae;Pseudooceanicola;Pseudooceanicola nanhaiensis	1	0	0	0	0	0	0	0	1
Bacteria;Bacteria_none;Bacteroidota;Sphingobacteriia;Sphingobacteriales;Sphingobacteriaceae;Sphingobacterium;Sphingobacterium haloxyli	0	0	1	0	0	0	0	0	1
Bacteria;Bacteria_none;Proteobacteria;Alphaproteobacteria;Hyphomicrobiales;Nitrobacteraceae;Bradyrhizobium;Bradyrhizobium manausense	0	1	0	0	0	0	0	0	1
Bacteria;Bacteria_none;Proteobacteria;Alphaproteobacteria;Rhodobacterales;Rhodobacteraceae;Pseudomaribius;Pseudomaribius aestuariivivens	0	0	0	0	1	0	0	0	1
Bacteria;Bacteria_none;Bacteroidota;Cytophagia;Cytophagales;Spirosomaceae;Flectobacillus;Flectobacillus major	0	0	0	1	0	0	0	0	1
Bacteria;Bacteria_none;Proteobacteria;Alphaproteobacteria;Rhodobacterales;Rhodobacteraceae;Profundibacter;Profundibacter amoris	0	0	0	1	0	0	0	0	1
Bacteria;Bacteria_none;Planctomycetota;Planctomycetia;Pirellulales;Pirellulaceae;Roseiconus;Roseiconus nitratireducens	0	1	0	0	0	0	0	0	1
Bacteria;Bacteria_none;Bacteroidota;Bacteroidia;Marinilabiliales;Marinilabiliaceae;Mangroviflexus;Mangroviflexus xiamenensis	0	1	0	0	0	0	0	0	1
Bacteria;Bacteria_none;Actinobacteria;Actinomycetia;Propionibacteriales;Propionibacteriaceae;Vaginimicrobium;Vaginimicrobium propionicum	0	0	0	0	0	0	0	1	1
Bacteria;Bacteria_none;Proteobacteria;Epsilonproteobacteria;Campylobacterales;Campylobacteraceae;Campylobacter;Campylobacter canadensis	0	0	0	1	0	0	0	0	1
Bacteria;Bacteria_none;Proteobacteria;Epsilonproteobacteria;Campylobacterales;Arcobacteraceae;Arcobacter;Arcobacter vandammei	0	0	0	0	0	1	0	0	1
Bacteria;Bacteria_none;Proteobacteria;Epsilonproteobacteria;Campylobacterales;Arcobacteraceae;Arcobacter;Arcobacter nitrofigilis	0	0	0	1	0	0	0	0	1
Bacteria;Bacteria_none;Actinobacteria;Actinomycetia;Corynebacteriales;Nocardiaceae;Rhodococcus;Rhodococcus kroppenstedtii	0	1	0	0	0	0	0	0	1
Bacteria;Bacteria_none;Actinobacteria;Actinomycetia;Corynebacteriales;Nocardiaceae;Rhodococcus;Rhodococcus kronopolitis	0	0	1	0	0	0	0	0	1
Bacteria;Bacteria_none;Firmicutes;Bacilli;Bacillales;Bacillaceae;Pueribacillus;Pueribacillus theae	0	0	1	0	0	0	0	0	1
Bacteria;Bacteria_none;Actinobacteria;Actinomycetia;Corynebacteriales;Nocardiaceae;Rhodococcus;Rhodococcus jostii	0	1	0	0	0	0	0	0	1
Bacteria;Bacteria_none;Proteobacteria;Epsilonproteobacteria;Campylobacterales;Arcobacteraceae;Aliarcobacter;Aliarcobacter lanthieri	0	0	0	1	0	0	0	0	1
Bacteria;Bacteria_none;Actinobacteria;Actinomycetia;Streptomycetales;Streptomycetaceae;Streptomyces;Streptomyces liangshanensis	0	0	0	1	0	0	0	0	1
Bacteria;Bacteria_none;Firmicutes;Bacilli;Bacillales;Bacillaceae;Psychrobacillus;Psychrobacillus soli	0	0	0	1	0	0	0	0	1
Bacteria;Bacteria_none;Firmicutes;Bacilli;Bacillales;Bacillaceae;Pradoshia;Pradoshia eiseniae	0	0	0	1	0	0	0	0	1
Bacteria;Bacteria_none;Actinobacteria;Actinomycetia;Streptomycetales;Streptomycetaceae;Streptomyces;Streptomyces luteolifulvus	0	0	0	1	0	0	0	0	1
Bacteria;Bacteria_none;Firmicutes;Bacilli;Bacillales;Bacillaceae;Pontibacillus;Pontibacillus marinus	0	0	0	0	0	1	0	0	1
Bacteria;Bacteria_none;Actinobacteria;Actinomycetia;Streptomycetales;Streptomycetaceae;Streptomyces;Streptomyces malaysiense	0	0	0	1	0	0	0	0	1
Bacteria;Bacteria_none;Actinobacteria;Acidimicrobiia;Acidimicrobiales;Ilumatobacteraceae;Ilumatobacter;Ilumatobacter coccineus	0	1	0	0	0	0	0	0	1
Bacteria;Bacteria_none;Firmicutes;Bacilli;Bacillales;Bacillaceae;Peribacillus;Peribacillus psychrosaccharolyticus	0	1	0	0	0	0	0	0	1
Bacteria;Bacteria_none;Actinobacteria;Actinomycetia;Streptomycetales;Streptomycetaceae;Streptomyces;Streptomyces nogalater	0	0	0	0	0	0	1	0	1
Bacteria;Bacteria_none;Firmicutes;Bacilli;Bacillales;Bacillaceae;Peribacillus;Peribacillus gossypii	0	1	0	0	0	0	0	0	1
Bacteria;Bacteria_none;Actinobacteria;Actinomycetia;Streptomycetales;Streptomycetaceae;Streptomyces;Streptomyces odonnellii	0	1	0	0	0	0	0	0	1
Bacteria;Bacteria_none;Actinobacteria;Actinomycetia;Corynebacteriales;Nocardiaceae;Nocardia;Nocardia jiangsuensis	0	0	1	0	0	0	0	0	1
Bacteria;Bacteria_none;Firmicutes;Bacilli;Bacillales;Bacillaceae;Oceanobacillus;Oceanobacillus zhaokaii	0	0	0	1	0	0	0	0	1
Bacteria;Bacteria_none;Actinobacteria;Actinomycetia;Streptomycetales;Streptomycetaceae;Streptomyces;Streptomyces pactum	0	0	0	1	0	0	0	0	1
Bacteria;Bacteria_none;Proteobacteria;Deltaproteobacteria;Myxococcales;Myxococcales_Incertae_sedis;Minicystis;Minicystis rosea	1	0	0	0	0	0	0	0	1
Bacteria;Bacteria_none;Proteobacteria;Deltaproteobacteria;Myxococcales;Myxococcales_Incertae_sedis;Enhygromyxa;Enhygromyxa salina	0	0	1	0	0	0	0	0	1
Bacteria;Bacteria_none;Proteobacteria;Epsilonproteobacteria;Campylobacterales;Arcobacteraceae;Malaciobacter;Malaciobacter halophilus	0	0	1	0	0	0	0	0	1
Bacteria;Bacteria_none;Firmicutes;Bacilli;Bacillales;Bacillaceae;Saccharococcus;Saccharococcus thermophilus	0	1	0	0	0	0	0	0	1
Bacteria;Bacteria_none;Planctomycetota;Planctomycetia;Pirellulales;Pirellulaceae;Novipirellula;Novipirellula aureliae	0	0	0	1	0	0	0	0	1
Bacteria;Bacteria_none;Actinobacteria;Actinomycetia;Corynebacteriales;Nocardiaceae;Williamsia;Williamsia aurantiaca	0	0	1	0	0	0	0	0	1
Bacteria;Bacteria_none;Proteobacteria;Gammaproteobacteria;Alteromonadales;Alteromonadaceae;Glaciecola;Glaciecola pallidula	1	0	0	0	0	0	0	0	1
Bacteria;Bacteria_none;Firmicutes;Bacilli;Bacillales;Bacillaceae;Virgibacillus;Virgibacillus pantothenticus	0	0	1	0	0	0	0	0	1
Bacteria;Bacteria_none;Proteobacteria;Gammaproteobacteria;Alteromonadales;Alteromonadaceae;Alkalimarinus;Alkalimarinus sediminis	0	0	0	1	0	0	0	0	1
Bacteria;Bacteria_none;Proteobacteria;Gammaproteobacteria;Alteromonadales;Alteromonadaceae;Alishewanella;Alishewanella longhuensis	0	0	0	1	0	0	0	0	1
Bacteria;Bacteria_none;Proteobacteria;Gammaproteobacteria;Alteromonadales;Alteromonadaceae;Alishewanella;Alishewanella alkalitolerans	0	1	0	0	0	0	0	0	1
Bacteria;Bacteria_none;Proteobacteria;Gammaproteobacteria;Aeromonadales;Succinivibrionaceae;Succinatimonas;Succinatimonas hippei	0	1	0	0	0	0	0	0	1
Bacteria;Bacteria_none;Actinobacteria;Actinomycetia;Geodermatophilales;Geodermatophilaceae;Geodermatophilus;Geodermatophilus sabuli	1	0	0	0	0	0	0	0	1
Bacteria;Bacteria_none;Actinobacteria;Actinomycetia;Streptomycetales;Streptomycetaceae;Streptomyces;Streptomyces daqingensis	0	1	0	0	0	0	0	0	1
Bacteria;Bacteria_none;Actinobacteria;Actinomycetia;Streptomycetales;Streptomycetaceae;Streptomyces;Streptomyces davaonensis	1	0	0	0	0	0	0	0	1
Bacteria;Bacteria_none;Firmicutes;Bacilli;Bacillales;Bacillaceae;Tepidibacillus;Tepidibacillus fermentans	1	0	0	0	0	0	0	0	1
Bacteria;Bacteria_none;Actinobacteria;Actinomycetia;Cryptosporangiales;Cryptosporangiaceae;Cryptosporangium;Cryptosporangium mongoliense	0	0	1	0	0	0	0	0	1
Bacteria;Bacteria_none;Proteobacteria;Gammaproteobacteria;Aeromonadales;Aeromonadaceae;Aeromonas;Aeromonas intestinalis	0	0	0	1	0	0	0	0	1
Bacteria;Bacteria_none;Firmicutes;Bacilli;Bacillales;Bacillaceae;Saliterribacillus;Saliterribacillus persicus	1	0	0	0	0	0	0	0	1
Bacteria;Bacteria_none;Proteobacteria;Epsilonproteobacteria;Campylobacterales;Thiovulaceae;Sulfurimonas;Sulfurimonas denitrificans	0	0	0	1	0	0	0	0	1
Bacteria;Bacteria_none;Actinobacteria;Actinomycetia;Micrococcales;Jonesiaceae;Jonesia;Jonesia luteola	0	1	0	0	0	0	0	0	1
Bacteria;Bacteria_none;Firmicutes;Clostridia;Eubacteriales;Oscillospiraceae;Drancourtella;Drancourtella massiliensis	0	0	1	0	0	0	0	0	1
Bacteria;Bacteria_none;Actinobacteria;Actinomycetia;Streptomycetales;Streptomycetaceae;Streptomyces;Streptomyces glycovorans	0	0	0	0	0	0	1	0	1
Bacteria;Bacteria_none;Actinobacteria;Actinomycetia;Corynebacteriales;Tsukamurellaceae;Tsukamurella;Tsukamurella pseudospumae	0	1	0	0	0	0	0	0	1
Bacteria;Bacteria_none;Proteobacteria;Epsilonproteobacteria;Campylobacterales;Sulfurospirillaceae;Sulfurospirillum;Sulfurospirillum alkalitolerans	1	0	0	0	0	0	0	0	1
Bacteria;Bacteria_none;Actinobacteria;Actinomycetia;Streptomycetales;Streptomycetaceae;Streptomyces;Streptomyces hebeiensis	0	0	1	0	0	0	0	0	1
Bacteria;Bacteria_none;Firmicutes;Bacilli;Bacillales;Bacillaceae;Salibacterium;Salibacterium salarium	0	1	0	0	0	0	0	0	1
Bacteria;Bacteria_none;Firmicutes;Bacilli;Bacillales;Bacillaceae;Salibacterium;Salibacterium aidingense	0	0	0	0	0	0	0	1	1
Bacteria;Bacteria_none;Actinobacteria;Actinomycetia;Streptomycetales;Streptomycetaceae;Streptomyces;Streptomyces javensis	0	1	0	0	0	0	0	0	1
Bacteria;Bacteria_none;Proteobacteria;Deltaproteobacteria;Myxococcales;Myxococcaceae;Corallococcus;Corallococcus llansteffanensis	0	1	0	0	0	0	0	0	1
Bacteria;Bacteria_none;Actinobacteria;Actinomycetia;Streptomycetales;Streptomycetaceae;Streptomyces;Streptomyces pilosus	1	0	0	0	0	0	0	0	1
Bacteria;Bacteria_none;Actinobacteria;Actinomycetia;Corynebacteriales;Nocardiaceae;Nocardia;Nocardia crassostreae	0	1	0	0	0	0	0	0	1
Bacteria;Bacteria_none;Actinobacteria;Actinomycetia;Corynebacteriales;Nocardiaceae;Nocardia;Nocardia cerradoensis	0	0	1	0	0	0	0	0	1
Bacteria;Bacteria_none;Firmicutes;Bacilli;Bacillales;Bacillaceae;Metabacillus;Metabacillus galliciensis	0	0	1	0	0	0	0	0	1
Bacteria;Bacteria_none;Actinobacteria;Actinomycetia;Corynebacteriales;Mycobacteriaceae;Mycolicibacterium;Mycolicibacterium obuense	0	1	0	0	0	0	0	0	1
Bacteria;Bacteria_none;Actinobacteria;Actinomycetia;Streptomycetales;Streptomycetaceae;Streptomyces;Streptomyces venezuelae	0	0	0	0	0	1	0	0	1
Bacteria;Bacteria_none;Actinobacteria;Actinomycetia;Micrococcales;Kytococcaceae;Kytococcus;Kytococcus schroeteri	0	1	0	0	0	0	0	0	1
Bacteria;Bacteria_none;Actinobacteria;Actinomycetia;Streptomycetales;Streptomycetaceae;Streptomyces;Streptomyces vulcanius	0	0	0	0	0	1	0	0	1
Bacteria;Bacteria_none;Actinobacteria;Actinomycetia;Streptomycetales;Streptomycetaceae;Streptomyces;Streptomyces xiamenensis	0	1	0	0	0	0	0	0	1
Bacteria;Bacteria_none;Actinobacteria;Actinomycetia;Corynebacteriales;Mycobacteriaceae;Mycolicibacterium;Mycolicibacterium komanii	0	1	0	0	0	0	0	0	1
Bacteria;Bacteria_none;Actinobacteria;Actinomycetia;Streptosporangiales;Nocardiopsaceae;Lipingzhangella;Lipingzhangella halophila	0	0	1	0	0	0	0	0	1
Bacteria;Bacteria_none;Firmicutes;Bacilli;Bacillales;Bacillaceae;Massilibacterium;Massilibacterium senegalense	0	0	1	0	0	0	0	0	1
Bacteria;Bacteria_none;Actinobacteria;Actinomycetia;Corynebacteriales;Mycobacteriaceae;Mycolicibacterium;Mycolicibacterium fallax	0	1	0	0	0	0	0	0	1
Bacteria;Bacteria_none;Actinobacteria;Actinomycetia;Corynebacteriales;Mycobacteriaceae;Mycolicibacterium;Mycolicibacterium celeriflavum	0	0	1	0	0	0	0	0	1
Bacteria;Bacteria_none;Firmicutes;Bacilli;Bacillales;Bacillaceae;Margalitia;Margalitia camelliae	0	0	0	1	0	0	0	0	1
Bacteria;Bacteria_none;Actinobacteria;Actinomycetia;Streptosporangiales;Nocardiopsaceae;Spinactinospora;Spinactinospora alkalitolerans	1	0	0	0	0	0	0	0	1
Bacteria;Bacteria_none;Actinobacteria;Actinomycetia;Corynebacteriales;Mycobacteriaceae;Mycolicibacterium;Mycolicibacterium boenickei	0	1	0	0	0	0	0	0	1
Bacteria;Bacteria_none;Firmicutes;Bacilli;Bacillales;Bacillaceae;Lysinibacillus;Lysinibacillus timonensis	0	0	0	0	0	0	0	1	1
Bacteria;Bacteria_none;Firmicutes;Bacilli;Bacillales;Bacillaceae;Lysinibacillus;Lysinibacillus telephonicus	1	0	0	0	0	0	0	0	1
Bacteria;Bacteria_none;Proteobacteria;Deltaproteobacteria;Desulfovibrionales;Desulfonauticaceae;Desulfonauticus;Desulfonauticus autotrophicus	0	0	1	0	0	0	0	0	1
Bacteria;Bacteria_none;Proteobacteria;Deltaproteobacteria;Desulfovibrionales;Desulfonatronaceae;Desulfonatronum;Desulfonatronum thiodismutans	0	0	0	0	0	0	0	1	1
Bacteria;Bacteria_none;Firmicutes;Bacilli;Bacillales;Bacillaceae;Lysinibacillus;Lysinibacillus parviboronicapiens	1	0	0	0	0	0	0	0	1
Bacteria;Bacteria_none;Proteobacteria;Deltaproteobacteria;Desulfovibrionales;Desulfomicrobiaceae;Desulfomicrobium;Desulfomicrobium salsuginis	0	1	0	0	0	0	0	0	1
Bacteria;Bacteria_none;Proteobacteria;Deltaproteobacteria;Desulfovibrionales;Desulfomicrobiaceae;Desulfomicrobium;Desulfomicrobium escambiense	0	0	0	1	0	0	0	0	1
Bacteria;Bacteria_none;Proteobacteria;Deltaproteobacteria;Desulfovibrionales;Desulfomicrobiaceae;Desulfomicrobium;Desulfomicrobium aestuarii	0	0	0	0	1	0	0	0	1
Bacteria;Bacteria_none;Proteobacteria;Deltaproteobacteria;Desulfovibrionales;Desulfohalobiaceae;Desulfovermiculus;Desulfovermiculus halophilus	1	0	0	0	0	0	0	0	1
Bacteria;Bacteria_none;Actinobacteria;Actinomycetia;Streptomycetales;Streptomycetaceae;Streptomyces;Streptomyces triticisoli	0	0	0	1	0	0	0	0	1
Bacteria;Bacteria_none;Firmicutes;Bacilli;Bacillales;Bacillaceae;Microaerobacter;Microaerobacter geothermalis	0	0	0	1	0	0	0	0	1
Bacteria;Bacteria_none;Proteobacteria;Deltaproteobacteria;Desulfovibrionales;Desulfovibrionaceae;Salidesulfovibrio;Salidesulfovibrio onnuriiensis	0	0	1	0	0	0	0	0	1
Bacteria;Bacteria_none;Proteobacteria;Deltaproteobacteria;Desulfuromonadales;Geobacteraceae;Geoalkalibacter;Geoalkalibacter ferrihydriticus	1	0	0	0	0	0	0	0	1
Bacteria;Bacteria_none;Actinobacteria;Actinomycetia;Corynebacteriales;Nocardiaceae;Nocardia;Nocardia boironii	0	0	0	0	0	1	0	0	1
Bacteria;Bacteria_none;Actinobacteria;Actinomycetia;Corynebacteriales;Nocardiaceae;Nocardia;Nocardia albiluteola	0	0	1	0	0	0	0	0	1
Bacteria;Bacteria_none;Actinobacteria;Actinomycetia;Corynebacteriales;Mycobacteriaceae;Mycolicibacterium;Mycolicibacterium thermoresistibile	0	1	0	0	0	0	0	0	1
Bacteria;Bacteria_none;Firmicutes;Bacilli;Bacillales;Bacillaceae;Oceanobacillus;Oceanobacillus iheyensis	0	0	0	0	0	0	1	0	1
Bacteria;Bacteria_none;Firmicutes;Bacilli;Bacillales;Bacillaceae;Oceanobacillus;Oceanobacillus chironomi	0	1	0	0	0	0	0	0	1
Bacteria;Bacteria_none;Firmicutes;Bacilli;Bacillales;Bacillaceae;Oceanobacillus;Oceanobacillus aidingensis	0	0	0	1	0	0	0	0	1
Bacteria;Bacteria_none;Actinobacteria;Actinomycetia;Streptomycetales;Streptomycetaceae;Streptomyces;Streptomyces sediminis	0	0	0	1	0	0	0	0	1
Bacteria;Bacteria_none;Actinobacteria;Actinomycetia;Streptomycetales;Streptomycetaceae;Streptomyces;Streptomyces solisilvae	0	1	0	0	0	0	0	0	1
Bacteria;Bacteria_none;Actinobacteria;Actinomycetia;Streptomycetales;Streptomycetaceae;Streptomyces;Streptomyces songpinggouensis	0	1	0	0	0	0	0	0	1
Bacteria;Bacteria_none;Firmicutes;Clostridia;Eubacteriales;Peptococcaceae;Desulforamulus;Desulforamulus aeronauticus	0	0	1	0	0	0	0	0	1
Bacteria;Bacteria_none;Proteobacteria;Deltaproteobacteria;Desulfuromonadales;Geobacteraceae;Citrifermentans;Citrifermentans pelophilum	1	0	0	0	0	0	0	0	1
Bacteria;Bacteria_none;Firmicutes;Bacilli;Bacillales;Bacillaceae;Neobacillus;Neobacillus novalis	1	0	0	0	0	0	0	0	1
Bacteria;Bacteria_none;Firmicutes;Clostridia;Eubacteriales;Peptococcaceae;Desulforamulus;Desulforamulus aquiferis	0	0	0	0	0	1	0	0	1
Bacteria;Bacteria_none;Firmicutes;Bacilli;Bacillales;Bacillaceae;Niallia;Niallia oryzisoli	0	1	0	0	0	0	0	0	1
Bacteria;Bacteria_none;Proteobacteria;Deltaproteobacteria;Desulfuromonadales;Desulfuromonadaceae;Desulfuromusa;Desulfuromusa kysingii	1	0	0	0	0	0	0	0	1
Bacteria;Bacteria_none;Actinobacteria;Actinomycetia;Streptomycetales;Streptomycetaceae;Streptomyces;Streptomyces sparsogenes	0	0	0	1	0	0	0	0	1
Bacteria;Bacteria_none;Proteobacteria;Deltaproteobacteria;Desulfuromonadales;Desulfuromonadaceae;Desulfuromonas;Desulfuromonas thiophila	0	1	0	0	0	0	0	0	1
Bacteria;Bacteria_none;Firmicutes;Bacilli;Bacillales;Bacillaceae;Neobacillus;Neobacillus pocheonensis	0	0	0	0	0	0	1	0	1
Bacteria;Bacteria_none;Proteobacteria;Deltaproteobacteria;Desulfuromonadales;Desulfuromonadaceae;Desulfuromonas;Desulfuromonas acetoxidans	0	0	0	1	0	0	0	0	1
Bacteria;Bacteria_none;Firmicutes;Clostridia;Eubacteriales;Peptococcaceae;Desulforamulus;Desulforamulus reducens	0	1	0	0	0	0	0	0	1
Bacteria;Bacteria_none;Firmicutes;Clostridia;Eubacteriales;Peptococcaceae;Desulforamulus;Desulforamulus ruminis	0	0	0	0	1	0	0	0	1
Bacteria;Bacteria_none;Actinobacteria;Actinomycetia;Streptomycetales;Streptomycetaceae;Streptomyces;Streptomyces stelliscabiei	0	0	0	1	0	0	0	0	1
Bacteria;Bacteria_none;Proteobacteria;Gammaproteobacteria;Alteromonadales;Alteromonadaceae;Hydrocarboniclastica;Hydrocarboniclastica marina	0	1	0	0	0	0	0	0	1
Bacteria;Bacteria_none;Proteobacteria;Gammaproteobacteria;Alteromonadales;Alteromonadaceae;Paraglaciecola;Paraglaciecola hydrolytica	0	0	0	0	1	0	0	0	1
Bacteria;Bacteria_none;Proteobacteria;Gammaproteobacteria;Alteromonadales;Colwelliaceae;Colwellia;Colwellia polaris	0	0	0	1	0	0	0	0	1
Bacteria;Bacteria_none;Actinobacteria;Actinomycetia;Jatrophihabitantales;Jatrophihabitantaceae;Jatrophihabitans;Jatrophihabitans telluris	0	1	0	0	0	0	0	0	1
Bacteria;Bacteria_none;Actinobacteria;Actinomycetia;Pseudonocardiales;Pseudonocardiaceae;Saccharopolyspora;Saccharopolyspora maritima	0	1	0	0	0	0	0	0	1
Bacteria;Bacteria_none;Firmicutes;Bacilli;Bacillales;Paenibacillaceae;Paenibacillus;Paenibacillus flagellatus	0	1	0	0	0	0	0	0	1
Bacteria;Bacteria_none;Actinobacteria;Actinomycetia;Pseudonocardiales;Pseudonocardiaceae;Saccharopolyspora;Saccharopolyspora spinosa	0	1	0	0	0	0	0	0	1
Bacteria;Bacteria_none;Firmicutes;Bacilli;Bacillales;Paenibacillaceae;Paenibacillus;Paenibacillus eucommiae	0	0	0	0	0	1	0	0	1
Bacteria;Bacteria_none;Actinobacteria;Actinomycetia;Pseudonocardiales;Pseudonocardiaceae;Saccharothrix;Saccharothrix variisporea	0	1	0	0	0	0	0	0	1
Bacteria;Bacteria_none;Actinobacteria;Actinomycetia;Pseudonocardiales;Pseudonocardiaceae;Salinifilum;Salinifilum aidingensis	1	0	0	0	0	0	0	0	1
Bacteria;Bacteria_none;Proteobacteria;Gammaproteobacteria;Enterobacterales;Budviciaceae;Limnobaculum;Limnobaculum parvum	1	0	0	0	0	0	0	0	1
Bacteria;Bacteria_none;Proteobacteria;Gammaproteobacteria;Enterobacterales;Bruguierivoracaceae;Sodalis;Sodalis praecaptivus	1	0	0	0	0	0	0	0	1
Bacteria;Bacteria_none;Proteobacteria;Gammaproteobacteria;Chromatiales;Thioprofundaceae;Thioprofundum;Thioprofundum lithotrophicum	0	0	0	0	0	0	1	0	1
Bacteria;Bacteria_none;Actinobacteria;Actinomycetia;Pseudonocardiales;Pseudonocardiaceae;Thermocrispum;Thermocrispum municipale	0	1	0	0	0	0	0	0	1
Bacteria;Bacteria_none;Proteobacteria;Gammaproteobacteria;Chromatiales;Thioalkalispiraceae;Endothiovibrio;Endothiovibrio diazotrophicus	0	0	0	0	0	1	0	0	1
Bacteria;Bacteria_none;Actinobacteria;Actinomycetia;Sporichthyales;Sporichthyaceae;Sporichthya;Sporichthya brevicatena	0	1	0	0	0	0	0	0	1
Bacteria;Bacteria_none;Firmicutes;Bacilli;Bacillales;Paenibacillaceae;Paenibacillus;Paenibacillus durus	0	0	0	0	0	1	0	0	1
Bacteria;Bacteria_none;Firmicutes;Bacilli;Bacillales;Paenibacillaceae;Paenibacillus;Paenibacillus daejeonensis	0	0	0	1	0	0	0	0	1
Bacteria;Bacteria_none;Firmicutes;Clostridia;Eubacteriales;Lachnospiraceae;Lachnoclostridium;Lachnoclostridium edouardi	1	0	0	0	0	0	0	0	1
Bacteria;Bacteria_none;Actinobacteria;Actinomycetia;Streptomycetales;Streptomycetaceae;Actinacidiphila;Actinacidiphila glaucinigra	0	0	0	0	0	0	1	0	1
Bacteria;Bacteria_none;Proteobacteria;Gammaproteobacteria;Chromatiales;Granulosicoccaceae;Sulfuriflexus;Sulfuriflexus mobilis	1	0	0	0	0	0	0	0	1
Bacteria;Bacteria_none;Firmicutes;Bacilli;Bacillales;Paenibacillaceae;Paenibacillus;Paenibacillus crassostreae	1	0	0	0	0	0	0	0	1
Bacteria;Bacteria_none;Proteobacteria;Gammaproteobacteria;Chromatiales;Ectothiorhodospiraceae;Thiohalospira;Thiohalospira alkaliphila	0	0	0	1	0	0	0	0	1
Bacteria;Bacteria_none;Proteobacteria;Gammaproteobacteria;Chromatiales;Ectothiorhodospiraceae;Thiohalomonas;Thiohalomonas nitratireducens	0	1	0	0	0	0	0	0	1
Bacteria;Bacteria_none;Firmicutes;Bacilli;Bacillales;Paenibacillaceae;Paenibacillus;Paenibacillus chitinolyticus	0	0	0	0	0	0	0	1	1
Bacteria;Bacteria_none;Proteobacteria;Gammaproteobacteria;Chromatiales;Ectothiorhodospiraceae;Thioalkalivibrio;Thioalkalivibrio nitratis	0	1	0	0	0	0	0	0	1
Bacteria;Bacteria_none;Proteobacteria;Gammaproteobacteria;Chromatiales;Ectothiorhodospiraceae;Thioalkalivibrio;Thioalkalivibrio denitrificans	0	0	1	0	0	0	0	0	1
Bacteria;Bacteria_none;Actinobacteria;Actinomycetia;Pseudonocardiales;Pseudonocardiaceae;Pseudonocardia;Pseudonocardia yunnanensis	0	1	0	0	0	0	0	0	1
Bacteria;Bacteria_none;Actinobacteria;Actinomycetia;Pseudonocardiales;Pseudonocardiaceae;Pseudonocardia;Pseudonocardia thermophila	0	0	1	0	0	0	0	0	1
Bacteria;Bacteria_none;Actinobacteria;Actinomycetia;Pseudonocardiales;Pseudonocardiaceae;Pseudonocardia;Pseudonocardia soli	0	1	0	0	0	0	0	0	1
Bacteria;Bacteria_none;Firmicutes;Bacilli;Bacillales;Paenibacillaceae;Paenibacillus;Paenibacillus konkukensis	0	0	0	1	0	0	0	0	1
Bacteria;Bacteria_none;Actinobacteria;Actinomycetia;Pseudonocardiales;Pseudonocardiaceae;Actinokineospora;Actinokineospora globicatena	1	0	0	0	0	0	0	0	1
Bacteria;Bacteria_none;Firmicutes;Bacilli;Bacillales;Paenibacillaceae;Paenibacillus;Paenibacillus montaniterrae	0	0	0	0	0	1	0	0	1
Bacteria;Bacteria_none;Actinobacteria;Actinomycetia;Kineosporiales;Kineosporiaceae;Pseudokineococcus;Pseudokineococcus lusitanus	0	0	0	1	0	0	0	0	1
Bacteria;Bacteria_none;Actinobacteria;Actinomycetia;Kineosporiales;Kineosporiaceae;Pseudokineococcus;Pseudokineococcus galaxeicola	1	0	0	0	0	0	0	0	1
Bacteria;Bacteria_none;Firmicutes;Bacilli;Bacillales;Paenibacillaceae;Paenibacillus;Paenibacillus marinum	0	0	1	0	0	0	0	0	1
Bacteria;Bacteria_none;Firmicutes;Bacilli;Bacillales;Paenibacillaceae;Paenibacillus;Paenibacillus marchantiophytorum	0	0	0	1	0	0	0	0	1
Bacteria;Bacteria_none;Firmicutes;Bacilli;Bacillales;Paenibacillaceae;Paenibacillus;Paenibacillus lemnae	0	0	0	0	0	0	1	0	1
Bacteria;Bacteria_none;Actinobacteria;Actinomycetia;Pseudonocardiales;Pseudonocardiaceae;Amycolatopsis;Amycolatopsis benzoatilytica	0	0	1	0	0	0	0	0	1
Bacteria;Bacteria_none;Firmicutes;Bacilli;Bacillales;Paenibacillaceae;Paenibacillus;Paenibacillus larvae	0	0	1	0	0	0	0	0	1
Bacteria;Bacteria_none;Firmicutes;Bacilli;Bacillales;Paenibacillaceae;Paenibacillus;Paenibacillus kyungheensis	0	0	1	0	0	0	0	0	1
Bacteria;Bacteria_none;Firmicutes;Bacilli;Bacillales;Paenibacillaceae;Paenibacillus;Paenibacillus kobensis	0	0	0	1	0	0	0	0	1
Bacteria;Bacteria_none;Firmicutes;Clostridia;Eubacteriales;Lachnospiraceae;Extibacter;Extibacter muris	0	0	0	0	1	0	0	0	1
Bacteria;Bacteria_none;Actinobacteria;Actinomycetia;Pseudonocardiales;Pseudonocardiaceae;Lentzea;Lentzea californiensis	0	0	1	0	0	0	0	0	1
Bacteria;Bacteria_none;Actinobacteria;Actinomycetia;Pseudonocardiales;Pseudonocardiaceae;Lentzea;Lentzea rhizosphaerae	0	1	0	0	0	0	0	0	1
Bacteria;Bacteria_none;Actinobacteria;Actinomycetia;Pseudonocardiales;Pseudonocardiaceae;Longimycelium;Longimycelium tulufanense	0	0	1	0	0	0	0	0	1
Bacteria;Bacteria_none;Actinobacteria;Actinomycetia;Pseudonocardiales;Pseudonocardiaceae;Prauserella;Prauserella halophila	0	1	0	0	0	0	0	0	1
Bacteria;Bacteria_none;Firmicutes;Bacilli;Bacillales;Paenibacillaceae;Paenibacillus;Paenibacillus humicus	0	0	0	0	0	0	0	1	1
Bacteria;Bacteria_none;Actinobacteria;Actinomycetia;Pseudonocardiales;Pseudonocardiaceae;Pseudonocardia;Pseudonocardia alni	0	1	0	0	0	0	0	0	1
Bacteria;Bacteria_none;Actinobacteria;Actinomycetia;Pseudonocardiales;Pseudonocardiaceae;Pseudonocardia;Pseudonocardia aurantiaca	0	0	0	0	0	1	0	0	1
Bacteria;Bacteria_none;Firmicutes;Bacilli;Bacillales;Paenibacillaceae;Paenibacillus;Paenibacillus herberti	0	0	1	0	0	0	0	0	1
Bacteria;Bacteria_none;Actinobacteria;Actinomycetia;Kineosporiales;Kineosporiaceae;Kineosporia;Kineosporia corallincola	1	0	0	0	0	0	0	0	1
Bacteria;Bacteria_none;Proteobacteria;Gammaproteobacteria;Enterobacterales;Enterobacteriaceae;Enterobacter;Enterobacter hormaechei	1	0	0	0	0	0	0	0	1
Bacteria;Bacteria_none;Proteobacteria;Gammaproteobacteria;Chromatiales;Ectothiorhodospiraceae;Oceanococcus;Oceanococcus atlanticus	1	0	0	0	0	0	0	0	1
Bacteria;Bacteria_none;Actinobacteria;Actinomycetia;Jatrophihabitantales;Jatrophihabitantaceae;Jatrophihabitans;Jatrophihabitans endophyticus	0	0	0	1	0	0	0	0	1
Bacteria;Bacteria_none;Proteobacteria;Gammaproteobacteria;Alteromonadales;Colwelliaceae;Colwellia;Colwellia psychrerythraea	0	1	0	0	0	0	0	0	1
Bacteria;Bacteria_none;Proteobacteria;Gammaproteobacteria;Chromatiales;Ectothiorhodospiraceae;Ectothiorhodospira;Ectothiorhodospira marina	0	0	1	0	0	0	0	0	1
Bacteria;Bacteria_none;Firmicutes;Bacilli;Bacillales;Paenibacillaceae;Ammoniibacillus;Ammoniibacillus agariperforans	0	0	0	0	0	1	0	0	1
Bacteria;Bacteria_none;Proteobacteria;Gammaproteobacteria;Cellvibrionales;Cellvibrionaceae;Cellvibrio;Cellvibrio japonicus	0	0	1	0	0	0	0	0	1
Bacteria;Bacteria_none;Actinobacteria;Actinomycetia;Glycomycetales;Glycomycetaceae;Salininema;Salininema proteolyticum	0	0	1	0	0	0	0	0	1
Bacteria;Bacteria_none;Proteobacteria;Gammaproteobacteria;Cellvibrionales;Cellvibrionaceae;Cellvibrio;Cellvibrio diazotrophicus	1	0	0	0	0	0	0	0	1
Bacteria;Bacteria_none;Proteobacteria;Gammaproteobacteria;Cellvibrionales;Cellvibrionaceae;Aestuariicella;Aestuariicella hydrocarbonica	0	1	0	0	0	0	0	0	1
Bacteria;Bacteria_none;Proteobacteria;Gammaproteobacteria;Alteromonadales;Shewanellaceae;Shewanella;Shewanella litorisediminis	1	0	0	0	0	0	0	0	1
Bacteria;Bacteria_none;Proteobacteria;Gammaproteobacteria;Alteromonadales;Shewanellaceae;Shewanella;Shewanella khirikhana	0	1	0	0	0	0	0	0	1
Bacteria;Bacteria_none;Proteobacteria;Gammaproteobacteria;Alteromonadales;Shewanellaceae;Shewanella;Shewanella gelidimarina	1	0	0	0	0	0	0	0	1
Bacteria;Bacteria_none;Proteobacteria;Gammaproteobacteria;Alteromonadales;Shewanellaceae;Shewanella;Shewanella donghaensis	0	0	0	1	0	0	0	0	1
Bacteria;Bacteria_none;Firmicutes;Bacilli;Bacillales;Bacillales_Incertae_sedis;Gemella;Gemella sanguinis	1	0	0	0	0	0	0	0	1
Bacteria;Bacteria_none;Proteobacteria;Gammaproteobacteria;Alteromonadales;Pseudoalteromonadaceae;Psychrosphaera;Psychrosphaera aquimarina	0	0	0	1	0	0	0	0	1
Bacteria;Bacteria_none;Actinobacteria;Actinomycetia;Glycomycetales;Glycomycetaceae;Glycomyces;Glycomyces xiaoerkulensis	0	0	0	0	0	1	0	0	1
Bacteria;Bacteria_none;Actinobacteria;Actinomycetia;Streptomycetales;Streptomycetaceae;Streptomyces;Streptomyces blattellae	0	0	0	0	0	1	0	0	1
Bacteria;Bacteria_none;Firmicutes;Bacilli;Bacillales;Bacillales_Incertae_sedis;Exiguobacterium;Exiguobacterium enclense	0	0	1	0	0	0	0	0	1
Bacteria;Bacteria_none;Proteobacteria;Gammaproteobacteria;Alteromonadales;Pseudoalteromonadaceae;Pseudoalteromonas;Pseudoalteromonas espejiana	1	0	0	0	0	0	0	0	1
Bacteria;Bacteria_none;Firmicutes;Bacilli;Bacillales;Bacillales_Incertae_sedis;Bacillales_Incertae_sedis;[Bacillus] thermocloacae	0	0	1	0	0	0	0	0	1
Bacteria;Bacteria_none;Firmicutes;Bacilli;Bacillales;Bacillaceae;Virgibacillus;Virgibacillus subterraneus	0	0	1	0	0	0	0	0	1
Bacteria;Bacteria_none;Proteobacteria;Gammaproteobacteria;Alteromonadales;Moritellaceae;Moritella;Moritella profunda	0	1	0	0	0	0	0	0	1
Bacteria;Bacteria_none;Proteobacteria;Gammaproteobacteria;Alteromonadales;Moritellaceae;Moritella;Moritella marina	0	0	0	1	0	0	0	0	1
Bacteria;Bacteria_none;Proteobacteria;Gammaproteobacteria;Alteromonadales;Idiomarinaceae;Idiomarina;Idiomarina piscisalsi	0	0	1	0	0	0	0	0	1
Bacteria;Bacteria_none;Firmicutes;Bacilli;Bacillales;Bacillaceae;Virgibacillus;Virgibacillus sediminis	0	0	1	0	0	0	0	0	1
Bacteria;Bacteria_none;Proteobacteria;Gammaproteobacteria;Alteromonadales;Colwelliaceae;Thalassotalea;Thalassotalea profundi	1	0	0	0	0	0	0	0	1
Bacteria;Bacteria_none;Actinobacteria;Actinomycetia;Streptomycetales;Streptomycetaceae;Streptomyces;Streptomyces carpaticus	0	0	0	1	0	0	0	0	1
Bacteria;Bacteria_none;Proteobacteria;Gammaproteobacteria;Cellvibrionales;Cellvibrionaceae;Cellvibrio;Cellvibrio vulgaris	0	1	0	0	0	0	0	0	1
Bacteria;Bacteria_none;Proteobacteria;Gammaproteobacteria;Cellvibrionales;Cellvibrionaceae;Marinimicrobium;Marinimicrobium alkaliphilum	0	0	1	0	0	0	0	0	1
Bacteria;Bacteria_none;Proteobacteria;Gammaproteobacteria;Cellvibrionales;Cellvibrionaceae;Teredinibacter;Teredinibacter purpureus	0	0	0	0	0	1	0	0	1
Bacteria;Bacteria_none;Proteobacteria;Gammaproteobacteria;Chromatiales;Chromatiaceae;Halochromatium;Halochromatium glycolicum	0	1	0	0	0	0	0	0	1
Bacteria;Bacteria_none;Proteobacteria;Gammaproteobacteria;Chromatiales;Ectothiorhodospiraceae;Aquisalimonas;Aquisalimonas asiatica	0	1	0	0	0	0	0	0	1
Bacteria;Bacteria_none;Proteobacteria;Gammaproteobacteria;Chromatiales;Ectothiorhodospiraceae;Acidihalobacter;Acidihalobacter prosperus	0	0	1	0	0	0	0	0	1
Bacteria;Bacteria_none;Proteobacteria;Gammaproteobacteria;Chromatiales;Chromatiaceae;Thiohalocapsa;Thiohalocapsa marina	1	0	0	0	0	0	0	0	1
Bacteria;Bacteria_none;Actinobacteria;Actinomycetia;Streptomycetales;Streptomycetaceae;Streptacidiphilus;Streptacidiphilus pinicola	0	0	1	0	0	0	0	0	1
Bacteria;Bacteria_none;Actinobacteria;Actinomycetia;Streptomycetales;Streptomycetaceae;Streptomyces;Streptomyces actinomycinicus	0	0	0	0	0	1	0	0	1
Bacteria;Bacteria_none;Proteobacteria;Gammaproteobacteria;Chromatiales;Chromatiaceae;Thiocapsa;Thiocapsa rosea	0	1	0	0	0	0	0	0	1
Bacteria;Bacteria_none;Proteobacteria;Gammaproteobacteria;Chromatiales;Chromatiaceae;Thiocapsa;Thiocapsa bogorovii	1	0	0	0	0	0	0	0	1
Bacteria;Bacteria_none;Proteobacteria;Gammaproteobacteria;Chromatiales;Chromatiaceae;Thioalkalicoccus;Thioalkalicoccus limnaeus	0	0	0	1	0	0	0	0	1
Bacteria;Bacteria_none;Firmicutes;Bacilli;Bacillales;Paenibacillaceae;Cohnella;Cohnella hongkongensis	1	0	0	0	0	0	0	0	1
Bacteria;Bacteria_none;Actinobacteria;Actinomycetia;Streptomycetales;Streptomycetaceae;Streptomyces;Streptomyces aegyptia	0	0	1	0	0	0	0	0	1
Bacteria;Bacteria_none;Proteobacteria;Gammaproteobacteria;Chromatiales;Chromatiaceae;Chromatium;Chromatium okenii	0	0	1	0	0	0	0	0	1
Bacteria;Bacteria_none;Proteobacteria;Gammaproteobacteria;Cellvibrionales;Halieaceae;Halioglobus;Halioglobus maricola	0	0	1	0	0	0	0	0	1
Bacteria;Bacteria_none;Actinobacteria;Actinomycetia;Streptomycetales;Streptomycetaceae;Streptomyces;Streptomyces albidoflavus	0	0	0	1	0	0	0	0	1
Bacteria;Bacteria_none;Firmicutes;Bacilli;Bacillales;Paenibacillaceae;Cohnella;Cohnella capsici	0	0	0	1	0	0	0	0	1
Bacteria;Bacteria_none;Firmicutes;Bacilli;Bacillales;Paenibacillaceae;Cohnella;Cohnella arctica	0	0	0	0	0	0	1	0	1
Bacteria;Bacteria_none;Proteobacteria;Gammaproteobacteria;Cellvibrionales;Spongiibacteraceae;Zhongshania;Zhongshania aliphaticivorans	0	0	1	0	0	0	0	0	1
Bacteria;Bacteria_none;Firmicutes;Bacilli;Bacillales;Paenibacillaceae;Brevibacillus;Brevibacillus marinus	0	0	1	0	0	0	0	0	1
Bacteria;Bacteria_none;Proteobacteria;Gammaproteobacteria;Cellvibrionales;Microbulbiferaceae;Microbulbifer;Microbulbifer marinus	0	0	1	0	0	0	0	0	1
Bacteria;Bacteria_none;Firmicutes;Bacilli;Bacillales;Paenibacillaceae;Brevibacillus;Brevibacillus fluminis	0	1	0	0	0	0	0	0	1
Bacteria;Bacteria_none;Firmicutes;Bacilli;Bacillales;Paenibacillaceae;Aneurinibacillus;Aneurinibacillus soli	0	0	0	1	0	0	0	0	1
Bacteria;Bacteria_none;Proteobacteria;Gammaproteobacteria;Cellvibrionales;Halieaceae;Pseudohaliea;Pseudohaliea rubra	1	0	0	0	0	0	0	0	1
Bacteria;Bacteria_none;Proteobacteria;Gammaproteobacteria;Cellvibrionales;Halieaceae;Parahaliea;Parahaliea aestuarii	0	0	1	0	0	0	0	0	1
Bacteria;Bacteria_none;Proteobacteria;Deltaproteobacteria;Desulfovibrionales;Desulfohalobiaceae;Desulfohalophilus;Desulfohalophilus alkaliarsenatis	0	0	1	0	0	0	0	0	1
Bacteria;Bacteria_none;Firmicutes;Bacilli;Bacillales;Bacillaceae;Lysinibacillus;Lysinibacillus alkalisoli	0	1	0	0	0	0	0	0	1
Bacteria;Bacteria_none;Proteobacteria;Deltaproteobacteria;Desulfobacterales;Desulfocapsaceae;Desulfotalea;Desulfotalea psychrophila	0	0	0	0	1	0	0	0	1
Bacteria;Bacteria_none;Fusobacteria;Fusobacteriia;Fusobacteriales;Leptotrichiaceae;Leptotrichia;Leptotrichia shahii	0	0	0	1	0	0	0	0	1
Bacteria;Bacteria_none;Firmicutes;Tissierellia;Tissierellales;Peptoniphilaceae;Peptoniphilus;Peptoniphilus coxii	0	0	0	0	0	0	0	1	1
Bacteria;Bacteria_none;Bacteroidota;Bacteroidia;Bacteroidales;Muribaculaceae;Duncaniella;Duncaniella dubosii	0	1	0	0	0	0	0	0	1
Bacteria;Bacteria_none;Firmicutes;Bacilli;Bacillales;Bacillaceae;Alkalihalobacillus;Alkalihalobacillus lonarensis	0	0	0	0	0	1	0	0	1
Bacteria;Bacteria_none;Bacteroidota;Bacteroidia;Bacteroidales;Muribaculaceae;Muribaculum;Muribaculum gordoncarteri	0	0	0	1	0	0	0	0	1
Bacteria;Bacteria_none;Actinobacteria;Actinomycetia;Actinomycetales;Actinomycetaceae;Arcanobacterium;Arcanobacterium phocisimile	0	1	0	0	0	0	0	0	1
Bacteria;Bacteria_none;Actinobacteria;Actinomycetia;Actinomycetales;Actinomycetaceae;Arcanobacterium;Arcanobacterium urinimassiliense	0	0	1	0	0	0	0	0	1
Bacteria;Bacteria_none;Proteobacteria;Betaproteobacteria;Burkholderiales;Comamonadaceae;Polaromonas;Polaromonas cryoconiti	0	0	0	1	0	0	0	0	1
Bacteria;Bacteria_none;Actinobacteria;Actinomycetia;Micrococcales;Microbacteriaceae;Leucobacter;Leucobacter celer	0	1	0	0	0	0	0	0	1
Bacteria;Bacteria_none;Actinobacteria;Actinomycetia;Actinomycetales;Actinomycetaceae;Fannyhessea;Fannyhessea vaginae	0	0	0	0	0	1	0	0	1
Bacteria;Bacteria_none;Firmicutes;Tissierellia;Tissierellales;Thermohalobacteraceae;Clostridiisalibacter;Clostridiisalibacter paucivorans	0	0	1	0	0	0	0	0	1
Bacteria;Bacteria_none;Firmicutes;Bacilli;Bacillales;Bacillaceae;Alkalihalobacillus;Alkalihalobacillus alkalisediminis	0	0	1	0	0	0	0	0	1
Bacteria;Bacteria_none;Actinobacteria;Actinomycetia;Micrococcales;Microbacteriaceae;Leucobacter;Leucobacter aerolatus	1	0	0	0	0	0	0	0	1
Bacteria;Bacteria_none;Proteobacteria;Betaproteobacteria;Burkholderiales;Comamonadaceae;Hydrogenophaga;Hydrogenophaga taeniospiralis	0	0	0	0	0	1	0	0	1
Bacteria;Bacteria_none;Firmicutes;Bacilli;Bacillales;Bacillaceae;Alkalicoccus;Alkalicoccus halolimnae	0	0	0	1	0	0	0	0	1
Bacteria;Bacteria_none;Actinobacteria;Actinomycetia;Micrococcales;Microbacteriaceae;Leifsonia;Leifsonia xyli	0	0	0	0	0	0	0	1	1
Bacteria;Bacteria_none;Proteobacteria;Betaproteobacteria;Burkholderiales;Comamonadaceae;Hydrogenophaga;Hydrogenophaga laconesensis	0	1	0	0	0	0	0	0	1
Bacteria;Bacteria_none;Bacteroidota;Bacteroidia;Bacteroidales;Prevotellaceae;Paraprevotella;Paraprevotella clara	0	0	1	0	0	0	0	0	1
Bacteria;Bacteria_none;Bacteroidota;Bacteroidia;Bacteroidales;Prevotellaceae;Prevotella;Prevotella amnii	0	0	0	0	0	0	0	1	1
Bacteria;Bacteria_none;Bacteroidota;Bacteroidia;Bacteroidales;Prevotellaceae;Prevotella;Prevotella aurantiaca	0	1	0	0	0	0	0	0	1
Bacteria;Bacteria_none;Firmicutes;Tissierellia;Tissierellales;Tissierellaceae;Urmitella;Urmitella timonensis	0	1	0	0	0	0	0	0	1
Bacteria;Bacteria_none;Firmicutes;Bacilli;Bacillales;Alicyclobacillaceae;Tumebacillus;Tumebacillus luteolus	0	0	1	0	0	0	0	0	1
Bacteria;Bacteria_none;Bacteroidota;Bacteroidia;Bacteroidales;Prevotellaceae;Prevotella;Prevotella disiens	1	0	0	0	0	0	0	0	1
Bacteria;Bacteria_none;Fusobacteria;Fusobacteriia;Fusobacteriales;Fusobacteriaceae;Fusobacterium;Fusobacterium varium	1	0	0	0	0	0	0	0	1
Bacteria;Bacteria_none;Bacteroidota;Bacteroidia;Bacteroidales;Dysgonomonadaceae;Dysgonomonas;Dysgonomonas termitidis	1	0	0	0	0	0	0	0	1
Bacteria;Bacteria_none;Firmicutes;Bacilli;Bacillales;Bacillaceae;Alkalihalobacillus;Alkalihalobacillus urbisdiaboli	0	1	0	0	0	0	0	0	1
Bacteria;Bacteria_none;Firmicutes;Bacilli;Bacillales;Bacillaceae;Alkalihalobacterium;Alkalihalobacterium elongatum	0	1	0	0	0	0	0	0	1
Bacteria;Bacteria_none;Firmicutes;Bacilli;Bacillales;Bacillaceae;Amphibacillus;Amphibacillus sediminis	0	0	0	0	0	0	1	0	1
Bacteria;Bacteria_none;Proteobacteria;Betaproteobacteria;Burkholderiales;Oxalobacteraceae;Massilia;Massilia eburnea	1	0	0	0	0	0	0	0	1
Bacteria;Bacteria_none;Actinobacteria;Actinomycetia;Corynebacteriales;Mycobacteriaceae;Mycobacterium;Mycobacterium aquaticum	0	1	0	0	0	0	0	0	1
Bacteria;Bacteria_none;Firmicutes;Bacilli;Bacillales;Bacillaceae;Anoxybacillus;Anoxybacillus gonensis	0	1	0	0	0	0	0	0	1
Bacteria;Bacteria_none;Firmicutes;Bacilli;Bacillales;Bacillaceae;Anoxybacillus;Anoxybacillus flavithermus	0	0	0	1	0	0	0	0	1
Bacteria;Bacteria_none;Bacteroidota;Bacteroidia;Bacteroidales;Bacteroidaceae;Bacteroides;Bacteroides clarus	0	1	0	0	0	0	0	0	1
Bacteria;Bacteria_none;Actinobacteria;Actinomycetia;Corynebacteriales;Mycobacteriaceae;Hoyosella;Hoyosella rhizosphaerae	0	0	0	1	0	0	0	0	1
Bacteria;Bacteria_none;Bacteroidota;Bacteroidia;Bacteroidales;Bacteroidaceae;Bacteroides;Bacteroides faecalis	0	1	0	0	0	0	0	0	1
Bacteria;Bacteria_none;Proteobacteria;Betaproteobacteria;Burkholderiales;Oxalobacteraceae;Duganella;Duganella zoogloeoides	0	0	0	0	0	1	0	0	1
Bacteria;Bacteria_none;Proteobacteria;Betaproteobacteria;Burkholderiales;Oxalobacteraceae;Duganella;Duganella flavida	1	0	0	0	0	0	0	0	1
Bacteria;Bacteria_none;Actinobacteria;Actinomycetia;Corynebacteriales;Lawsonellaceae;Lawsonella;Lawsonella clevelandensis	1	0	0	0	0	0	0	0	1
Bacteria;Bacteria_none;Firmicutes;Tissierellia;Tissierellales;Peptoniphilaceae;Anaerococcus;Anaerococcus hydrogenalis	1	0	0	0	0	0	0	0	1
Bacteria;Bacteria_none;Proteobacteria;Betaproteobacteria;Burkholderiales;Comamonadaceae;Ramlibacter;Ramlibacter pinisoli	1	0	0	0	0	0	0	0	1
Bacteria;Bacteria_none;Bacteroidota;Bacteroidia;Bacteroidales;Bacteroidaceae;Bacteroides;Bacteroides pyogenes	0	1	0	0	0	0	0	0	1
Bacteria;Bacteria_none;Firmicutes;Tissierellia;Tissierellales;Peptoniphilaceae;Anaerococcus;Anaerococcus marasmi	1	0	0	0	0	0	0	0	1
Bacteria;Bacteria_none;Actinobacteria;Actinomycetia;Micrococcales;Microbacteriaceae;Leucobacter;Leucobacter exalbidus	0	1	0	0	0	0	0	0	1
Bacteria;Bacteria_none;Firmicutes;Tissierellia;Tissierellales;Peptoniphilaceae;Anaerococcus;Anaerococcus pacaensis	0	0	0	1	0	0	0	0	1
Bacteria;Bacteria_none;Firmicutes;Tissierellia;Tissierellales;Peptoniphilaceae;Anaerococcus;Anaerococcus rubeinfantis	1	0	0	0	0	0	0	0	1
Bacteria;Bacteria_none;Firmicutes;Tissierellia;Tissierellales;Peptoniphilaceae;Anaerococcus;Anaerococcus vaginimassiliensis	0	0	0	1	0	0	0	0	1
Bacteria;Bacteria_none;Bacteroidota;Bacteroidia;Bacteroidales;Bacteroidaceae;Phocaeicola;Phocaeicola salanitronis	0	0	0	1	0	0	0	0	1
Bacteria;Bacteria_none;Actinobacteria;Actinomycetia;Micrococcales;Microbacteriaceae;Leucobacter;Leucobacter corticis	0	1	0	0	0	0	0	0	1
Bacteria;Bacteria_none;Firmicutes;Tissierellia;Tissierellales;Peptoniphilaceae;Helcococcus;Helcococcus kunzii	0	1	0	0	0	0	0	0	1
Bacteria;Bacteria_none;Firmicutes;Tissierellia;Tissierellales;Peptoniphilaceae;Helcococcus;Helcococcus seattlensis	1	0	0	0	0	0	0	0	1
Bacteria;Bacteria_none;Bacteroidota;Bacteroidia;Bacteroidales;Prevotellaceae;Prevotella;Prevotella hominis	1	0	0	0	0	0	0	0	1
Bacteria;Bacteria_none;Fusobacteria;Fusobacteriia;Fusobacteriales;Leptotrichiaceae;Leptotrichia;Leptotrichia trevisanii	0	0	0	1	0	0	0	0	1
Bacteria;Bacteria_none;Bacteroidota;Bacteroidia;Bacteroidales;Bacteroidaceae;Bacteroides;Bacteroides bouchesdurhonensis	0	1	0	0	0	0	0	0	1
Bacteria;Bacteria_none;Firmicutes;Bacilli;Bacillales;Alicyclobacillaceae;Effusibacillus;Effusibacillus dendaii	0	0	0	1	0	0	0	0	1
Bacteria;Bacteria_none;Actinobacteria;Actinomycetia;Micrococcales;Microbacteriaceae;Galbitalea;Galbitalea soli	0	1	0	0	0	0	0	0	1
Bacteria;Bacteria_none;Actinobacteria;Actinomycetia;Corynebacteriales;Gordoniaceae;Gordonia;Gordonia jinghuaiqii	0	0	0	0	0	1	0	0	1
Bacteria;Bacteria_none;Bacteroidota;Bacteroidia;Bacteroidales;Rikenellaceae;Millionella;Millionella massiliensis	0	0	0	0	0	0	1	0	1
Bacteria;Bacteria_none;Proteobacteria;Betaproteobacteria;Burkholderiales;Burkholderiales_Incertae_sedis;Tepidimonas;Tepidimonas aquatica	0	0	0	0	0	1	0	0	1
Bacteria;Bacteria_none;Deinococcus-Thermus;Deinococci;Thermales;Thermaceae;Vulcanithermus;Vulcanithermus mediatlanticus	0	0	1	0	0	0	0	0	1
Bacteria;Bacteria_none;Actinobacteria;Actinomycetia;Corynebacteriales;Gordoniaceae;Gordonia;Gordonia insulae	0	0	0	0	0	0	0	1	1
Bacteria;Bacteria_none;Actinobacteria;Actinomycetia;Bifidobacteriales;Bifidobacteriaceae;Alloscardovia;Alloscardovia macacae	0	0	1	0	0	0	0	0	1
Bacteria;Bacteria_none;Actinobacteria;Actinomycetia;Corynebacteriales;Gordoniaceae;Gordonia;Gordonia humi	0	1	0	0	0	0	0	0	1
Bacteria;Bacteria_none;Deinococcus-Thermus;Deinococci;Deinococcales;Deinococcaceae;Deinococcus;Deinococcus terrestris	1	0	0	0	0	0	0	0	1
Bacteria;Bacteria_none;Actinobacteria;Actinomycetia;Corynebacteriales;Gordoniaceae;Gordonia;Gordonia caeni	0	1	0	0	0	0	0	0	1
Bacteria;Bacteria_none;Deinococcus-Thermus;Deinococci;Deinococcales;Deinococcaceae;Deinococcus;Deinococcus ruber	0	1	0	0	0	0	0	0	1
Bacteria;Bacteria_none;Proteobacteria;Betaproteobacteria;Burkholderiales;Burkholderiaceae;Trinickia;Trinickia caryophylli	1	0	0	0	0	0	0	0	1
Bacteria;Bacteria_none;Deinococcus-Thermus;Deinococci;Deinococcales;Deinococcaceae;Deinococcus;Deinococcus piscis	0	0	0	1	0	0	0	0	1
Bacteria;Bacteria_none;Proteobacteria;Betaproteobacteria;Burkholderiales;Burkholderiaceae;Ralstonia;Ralstonia pickettii	0	1	0	0	0	0	0	0	1
Bacteria;Bacteria_none;Deinococcus-Thermus;Deinococci;Deinococcales;Deinococcaceae;Deinococcus;Deinococcus metalli	0	1	0	0	0	0	0	0	1
Bacteria;Bacteria_none;Actinobacteria;Actinomycetia;Bifidobacteriales;Bifidobacteriaceae;Alloscardovia;Alloscardovia omnicolens	0	0	0	1	0	0	0	0	1
Bacteria;Bacteria_none;Actinobacteria;Actinomycetia;Micrococcales;Microbacteriaceae;Curtobacterium;Curtobacterium glycinis	0	0	0	1	0	0	0	0	1
Bacteria;Bacteria_none;Deinococcus-Thermus;Deinococci;Deinococcales;Deinococcaceae;Deinococcus;Deinococcus koreense	0	0	0	1	0	0	0	0	1
Bacteria;Bacteria_none;Deinococcus-Thermus;Deinococci;Deinococcales;Deinococcaceae;Deinococcus;Deinococcus antarcticus	0	1	0	0	0	0	0	0	1
Bacteria;Bacteria_none;Deferribacteres;Deferribacteres;Deferribacterales;Geovibrionaceae;Geovibrio;Geovibrio ferrireducens	0	0	1	0	0	0	0	0	1
Bacteria;Bacteria_none;Deferribacteres;Deferribacteres;Deferribacterales;Calditerrivibrionaceae;Calditerrivibrio;Calditerrivibrio nitroreducens	0	0	1	0	0	0	0	0	1
Bacteria;Bacteria_none;Cyanobacteria;Cyanobacteria_Incertae_sedis;Thermostichales;Thermostichaceae;Thermostichus;Thermostichus lividus	0	0	0	1	0	0	0	0	1
Bacteria;Bacteria_none;Proteobacteria;Betaproteobacteria;Burkholderiales;Burkholderiaceae;Paraburkholderia;Paraburkholderia metalliresistens	1	0	0	0	0	0	0	0	1
Bacteria;Bacteria_none;Elusimicrobia;Elusimicrobia;Elusimicrobiales;Elusimicrobiaceae;Elusimicrobium;Elusimicrobium minutum	1	0	0	0	0	0	0	0	1
Bacteria;Bacteria_none;Actinobacteria;Actinomycetia;Corynebacteriales;Gordoniaceae;Gordonia;Gordonia jinhuaensis	0	0	0	0	1	0	0	0	1
Bacteria;Bacteria_none;Nitrospirae;Thermodesulfovibrionia;Thermodesulfovibrionales;Thermodesulfovibrionaceae;Thermodesulfovibrio;Thermodesulfovibrio yellowstonii	0	0	0	0	0	1	0	0	1
Bacteria;Bacteria_none;Lentisphaerae;Lentisphaeria;Lentisphaerales;Lentisphaeraceae;Lentisphaera;Lentisphaera profundi	0	0	0	1	0	0	0	0	1
Bacteria;Bacteria_none;Actinobacteria;Actinomycetia;Actinomycetales;Actinomycetaceae;Nanchangia;Nanchangia anserum	0	0	0	1	0	0	0	0	1
Bacteria;Bacteria_none;Bacteroidota;Bacteroidia;Bacteroidales;Prevotellaceae;Prevotella;Prevotella melaninogenica	1	0	0	0	0	0	0	0	1
Bacteria;Bacteria_none;Bacteroidota;Bacteroidia;Bacteroidales;Prevotellaceae;Prevotella;Prevotella multiformis	0	1	0	0	0	0	0	0	1
Bacteria;Bacteria_none;Actinobacteria;Actinomycetia;Micrococcales;Microbacteriaceae;Humibacter;Humibacter soli	1	0	0	0	0	0	0	0	1
Bacteria;Bacteria_none;Firmicutes;Bacilli;Bacillales;Alicyclobacillaceae;Effusibacillus;Effusibacillus consociatus	0	0	0	0	0	0	1	0	1
Bacteria;Bacteria_none;Bacteroidota;Bacteroidia;Bacteroidales;Prevotellaceae;Prevotella;Prevotella oulorum	0	0	0	0	1	0	0	0	1
Bacteria;Bacteria_none;Firmicutes;Bacilli;Bacillales;Alicyclobacillaceae;Alicyclobacillus;Alicyclobacillus vulcanalis	0	0	0	0	0	1	0	0	1
Bacteria;Bacteria_none;Actinobacteria;Actinomycetia;Actinomycetales;Actinomycetaceae;Schaalia;Schaalia funkei	0	0	1	0	0	0	0	0	1
Bacteria;Bacteria_none;Actinobacteria;Actinomycetia;Actinomycetales;Actinomycetaceae;Schaalia;Schaalia odontolytica	1	0	0	0	0	0	0	0	1
Bacteria;Bacteria_none;Firmicutes;Bacilli;Bacillales;Alicyclobacillaceae;Alicyclobacillus;Alicyclobacillus disulfidooxidans	0	0	0	0	0	0	0	1	1
Bacteria;Bacteria_none;Actinobacteria;Actinomycetia;Actinomycetales;Actinomycetaceae;Schaalia;Schaalia turicensis	0	1	0	0	0	0	0	0	1
Bacteria;Bacteria_none;Proteobacteria;Betaproteobacteria;Burkholderiales;Burkholderiales_Incertae_sedis;Thiomonas;Thiomonas islandica	1	0	0	0	0	0	0	0	1
Bacteria;Bacteria_none;Bacteroidota;Bacteroidia;Bacteroidales;Prevotellaceae;Prevotella;Prevotella stercorea	1	0	0	0	0	0	0	0	1
Bacteria;Bacteria_none;Firmicutes;Bacilli;Bacillales;Alicyclobacillaceae;Alicyclobacillus;Alicyclobacillus acidoterrestris	0	0	1	0	0	0	0	0	1
Bacteria;Bacteria_none;Fibrobacteres;Fibrobacteria;Fibrobacterales;Fibrobacteraceae;Hallerella;Hallerella succinigenes	0	0	0	0	0	0	1	0	1
Bacteria;Bacteria_none;Fibrobacteres;Fibrobacteria;Fibrobacterales;Fibrobacteraceae;Fibrobacter;Fibrobacter succinogenes	0	1	0	0	0	0	0	0	1
Bacteria;Bacteria_none;Nitrospinae;Nitrospinia;Nitrospinales;Nitrospinaceae;Nitrospina;Nitrospina watsonii	0	0	1	0	0	0	0	0	1
Bacteria;Bacteria_none;Actinobacteria;Actinomycetia;Actinomycetales;Actinomycetaceae;Trueperella;Trueperella bernardiae	0	0	0	0	1	0	0	0	1
Bacteria;Bacteria_none;Actinobacteria;Actinomycetia;Actinomycetales;Actinomycetaceae;Trueperella;Trueperella bonasi	0	0	0	1	0	0	0	0	1
Bacteria;Bacteria_none;Actinobacteria;Actinomycetia;Micrococcales;Microbacteriaceae;Herbiconiux;Herbiconiux ginsengi	0	0	0	0	0	1	0	0	1
Bacteria;Bacteria_none;Actinobacteria;Actinomycetia;Corynebacteriales;Gordoniaceae;Gordonia;Gordonia otitidis	1	0	0	0	0	0	0	0	1
Bacteria;Bacteria_none;Proteobacteria;Betaproteobacteria;Burkholderiales;Burkholderiales_Incertae_sedis;Xylophilus;Xylophilus ampelinus	1	0	0	0	0	0	0	0	1
Bacteria;Bacteria_none;Proteobacteria;Betaproteobacteria;Burkholderiales;Oxalobacteraceae;Massilia;Massilia eurypsychrophila	0	1	0	0	0	0	0	0	1
Bacteria;Bacteria_none;Proteobacteria;Betaproteobacteria;Burkholderiales;Oxalobacteraceae;Massilia;Massilia kyonggiensis	1	0	0	0	0	0	0	0	1
Bacteria;Bacteria_none;Proteobacteria;Deltaproteobacteria;Desulfobacterales;Desulfocapsaceae;Desulforhopalus;Desulforhopalus vacuolatus	0	1	0	0	0	0	0	0	1
Bacteria;Bacteria_none;Firmicutes;Bacilli;Bacillales;Bacillaceae;Cytobacillus;Cytobacillus firmus	0	0	1	0	0	0	0	0	1
Bacteria;Bacteria_none;Proteobacteria;Betaproteobacteria;Rhodocyclales;Zoogloeaceae;Nitrogeniibacter;Nitrogeniibacter aestuarii	0	0	0	0	1	0	0	0	1
Bacteria;Bacteria_none;Proteobacteria;Betaproteobacteria;Rhodocyclales;Rhodocyclaceae;Rhodocyclus;Rhodocyclus purpureus	1	0	0	0	0	0	0	0	1
Bacteria;Bacteria_none;Actinobacteria;Actinomycetia;Streptosporangiales;Thermomonosporaceae;Actinomadura;Actinomadura formosensis	0	0	1	0	0	0	0	0	1
Bacteria;Bacteria_none;Proteobacteria;Betaproteobacteria;Rhodocyclales;Rhodocyclaceae;Niveibacterium;Niveibacterium umoris	0	0	0	0	0	0	0	1	1
Bacteria;Bacteria_none;Actinobacteria;Actinomycetia;Streptosporangiales;Thermomonosporaceae;Actinomadura;Actinomadura logoneensis	0	0	0	1	0	0	0	0	1
Bacteria;Bacteria_none;Firmicutes;Bacilli;Bacillales;Bacillaceae;Evansella;Evansella vedderi	0	0	0	0	0	0	0	1	1
Bacteria;Bacteria_none;Actinobacteria;Actinomycetia;Streptosporangiales;Thermomonosporaceae;Actinomadura;Actinomadura maheshkhaliensis	0	0	1	0	0	0	0	0	1
Bacteria;Bacteria_none;Actinobacteria;Actinomycetia;Streptosporangiales;Thermomonosporaceae;Actinomadura;Actinomadura mexicana	0	0	0	0	0	1	0	0	1
Bacteria;Bacteria_none;Firmicutes;Clostridia;Thermoanaerobacterales;Thermoanaerobacterales Family III. Incertae Sedis;Caldicellulosiruptor;Caldicellulosiruptor owensensis	0	0	1	0	0	0	0	0	1
Bacteria;Bacteria_none;Actinobacteria;Actinomycetia;Streptosporangiales;Thermomonosporaceae;Actinomadura;Actinomadura meyerae	0	0	1	0	0	0	0	0	1
Bacteria;Bacteria_none;Firmicutes;Bacilli;Bacillales;Bacillaceae;Ectobacillus;Ectobacillus polymachus	0	0	0	0	1	0	0	0	1
Bacteria;Bacteria_none;Firmicutes;Bacilli;Bacillales;Bacillaceae;Ectobacillus;Ectobacillus funiculus	0	1	0	0	0	0	0	0	1
Bacteria;Bacteria_none;Firmicutes;Bacilli;Bacillales;Bacillaceae;Desertibacillus;Desertibacillus haloalkaliphilus	0	0	0	0	0	1	0	0	1
Bacteria;Bacteria_none;Actinobacteria;Actinomycetia;Corynebacteriales;Mycobacteriaceae;Mycobacterium;Mycobacterium spongiae	0	0	0	1	0	0	0	0	1
Bacteria;Bacteria_none;Proteobacteria;Betaproteobacteria;Nitrosomonadales;Usitatibacteraceae;Usitatibacter;Usitatibacter rugosus	1	0	0	0	0	0	0	0	1
Bacteria;Bacteria_none;Actinobacteria;Actinomycetia;Streptosporangiales;Thermomonosporaceae;Actinomadura;Actinomadura viridis	0	0	1	0	0	0	0	0	1
Bacteria;Bacteria_none;Proteobacteria;Betaproteobacteria;Nitrosomonadales;Thiobacillaceae;Thiobacillus;Thiobacillus sajanensis	0	0	0	0	1	0	0	0	1
Bacteria;Bacteria_none;Firmicutes;Erysipelotrichia;Erysipelotrichales;Erysipelotrichaceae;Absiella;Absiella argi	1	0	0	0	0	0	0	0	1
Bacteria;Bacteria_none;Firmicutes;Erysipelotrichia;Erysipelotrichales;Erysipelotrichaceae;Allobaculum;Allobaculum stercoricanis	0	0	0	0	1	0	0	0	1
Bacteria;Bacteria_none;Firmicutes;Bacilli;Bacillales;Bacillaceae;Cytobacillus;Cytobacillus horneckiae	0	0	0	1	0	0	0	0	1
Bacteria;Bacteria_none;Actinobacteria;Coriobacteriia;Coriobacteriales;Atopobiaceae;Atopobium;Atopobium deltae	1	0	0	0	0	0	0	0	1
Bacteria;Bacteria_none;Proteobacteria;Betaproteobacteria;Nitrosomonadales;Spirillaceae;Spirillum;Spirillum winogradskyi	1	0	0	0	0	0	0	0	1
Bacteria;Bacteria_none;Firmicutes;Erysipelotrichia;Erysipelotrichales;Erysipelotrichaceae;Erysipelatoclostridium;[Clostridium] saccharogumia	0	0	1	0	0	0	0	0	1
Bacteria;Bacteria_none;Firmicutes;Bacilli;Bacillales;Bacillaceae;Gracilibacillus;Gracilibacillus dipsosauri	0	0	1	0	0	0	0	0	1
Bacteria;Bacteria_none;Proteobacteria;Betaproteobacteria;Rhodocyclales;Zoogloeaceae;Thauera;Thauera butanivorans	0	0	0	1	0	0	0	0	1
Bacteria;Bacteria_none;Actinobacteria;Actinomycetia;Streptosporangiales;Thermomonosporaceae;Actinocorallia;Actinocorallia populi	0	1	0	0	0	0	0	0	1
Bacteria;Bacteria_none;Actinobacteria;Actinomycetia;Streptosporangiales;Streptosporangiaceae;Planobispora;Planobispora longispora	1	0	0	0	0	0	0	0	1
Bacteria;Bacteria_none;Actinobacteria;Actinomycetia;Corynebacteriales;Mycobacteriaceae;Mycolicibacter;Mycolicibacter kumamotonensis	0	1	0	0	0	0	0	0	1
Bacteria;Bacteria_none;Firmicutes;Bacilli;Bacillales;Bacillaceae;Litoribacterium;Litoribacterium kuwaitense	0	0	1	0	0	0	0	0	1
Bacteria;Bacteria_none;Proteobacteria;Deltaproteobacteria;Desulfobacterales;Desulfobulbaceae;Desulfogranum;Desulfogranum marinum	1	0	0	0	0	0	0	0	1
Bacteria;Bacteria_none;Proteobacteria;Deltaproteobacteria;Desulfobacterales;Desulfobulbaceae;Desulfogranum;Desulfogranum japonicum	0	0	0	0	1	0	0	0	1
Bacteria;Bacteria_none;Actinobacteria;Actinomycetia;Streptosporangiales;Streptosporangiaceae;Nonomuraea;Nonomuraea flavida	1	0	0	0	0	0	0	0	1
Bacteria;Bacteria_none;Actinobacteria;Actinomycetia;Streptosporangiales;Streptosporangiaceae;Nonomuraea;Nonomuraea polychroma	0	1	0	0	0	0	0	0	1
Bacteria;Bacteria_none;Firmicutes;Bacilli;Bacillales;Bacillaceae;Lentibacillus;Lentibacillus salarius	0	0	0	0	0	0	1	0	1
Bacteria;Bacteria_none;Proteobacteria;Deltaproteobacteria;Desulfobacterales;Desulfobacteraceae;Desulforapulum;Desulforapulum autotrophicum	1	0	0	0	0	0	0	0	1
Bacteria;Bacteria_none;Firmicutes;Bacilli;Bacillales;Bacillaceae;Lentibacillus;Lentibacillus kimchii	0	0	1	0	0	0	0	0	1
Bacteria;Bacteria_none;Firmicutes;Clostridia;Halanaerobiales;Halanaerobiaceae;Halanaerobium;Halanaerobium alcaliphilum	0	0	0	0	0	1	0	0	1
Bacteria;Bacteria_none;Firmicutes;Bacilli;Bacillales;Bacillaceae;Lentibacillus;Lentibacillus halophilus	0	0	1	0	0	0	0	0	1
Bacteria;Bacteria_none;Actinobacteria;Actinomycetia;Streptosporangiales;Thermomonosporaceae;Actinocorallia;Actinocorallia libanotica	0	0	0	1	0	0	0	0	1
Bacteria;Bacteria_none;Firmicutes;Bacilli;Bacillales;Bacillaceae;Lentibacillus;Lentibacillus garicola	0	0	0	1	0	0	0	0	1
Bacteria;Bacteria_none;Firmicutes;Bacilli;Bacillales;Bacillaceae;Lederbergia;Lederbergia panacisoli	0	0	0	0	0	1	0	0	1
Bacteria;Bacteria_none;Firmicutes;Bacilli;Bacillales;Bacillaceae;Halolactibacillus;Halolactibacillus halophilus	0	1	0	0	0	0	0	0	1
Bacteria;Bacteria_none;Actinobacteria;Actinomycetia;Streptosporangiales;Streptosporangiaceae;Sphaerisporangium;Sphaerisporangium corydalis	0	0	0	1	0	0	0	0	1
Bacteria;Bacteria_none;Firmicutes;Clostridia;Halanaerobiales;Halobacteroidaceae;Halanaerocella;Halanaerocella petrolearia	0	1	0	0	0	0	0	0	1
Bacteria;Bacteria_none;Proteobacteria;Deltaproteobacteria;Desulfarculales;Desulfarculaceae;Desulfocarbo;Desulfocarbo indianensis	0	1	0	0	0	0	0	0	1
Bacteria;Bacteria_none;Firmicutes;Clostridia;Halanaerobiales;Halobacteroidaceae;Halobacteroides;Halobacteroides elegans	0	0	0	0	0	1	0	0	1
Bacteria;Bacteria_none;Firmicutes;Clostridia;Halanaerobiales;Halobacteroidaceae;Natroniella;Natroniella acetigena	0	0	1	0	0	0	0	0	1
Bacteria;Bacteria_none;Proteobacteria;Betaproteobacteria;Rhodocyclales;Zoogloeaceae;Zoogloea;Zoogloea oleivorans	0	0	1	0	0	0	0	0	1
Bacteria;Bacteria_none;Actinobacteria;Actinomycetia;Streptosporangiales;Thermomonosporaceae;Actinocorallia;Actinocorallia herbida	0	1	0	0	0	0	0	0	1
Bacteria;Bacteria_none;Firmicutes;Erysipelotrichia;Erysipelotrichales;Erysipelotrichaceae;Erysipelatoclostridium;[Clostridium] spiroforme	0	1	0	0	0	0	0	0	1
Bacteria;Bacteria_none;Actinobacteria;Coriobacteriia;Coriobacteriales;Atopobiaceae;Parolsenella;Parolsenella catena	1	0	0	0	0	0	0	0	1
Bacteria;Bacteria_none;Proteobacteria;Betaproteobacteria;Burkholderiales;Oxalobacteraceae;Massilia;Massilia oculi	1	0	0	0	0	0	0	0	1
Bacteria;Bacteria_none;Firmicutes;Bacilli;Bacillales;Bacillaceae;Compostibacillus;Compostibacillus humi	0	0	0	1	0	0	0	0	1
Bacteria;Bacteria_none;Firmicutes;Bacilli;Bacillales;Bacillaceae;Bacillus;Bacillus salitolerans	0	0	1	0	0	0	0	0	1
Bacteria;Bacteria_none;Firmicutes;Bacilli;Bacillales;Bacillaceae;Bacillus;Bacillus piscicola	0	1	0	0	0	0	0	0	1
Bacteria;Bacteria_none;Firmicutes;Bacilli;Bacillales;Bacillaceae;Bacillus;Bacillus nitroreducens	0	1	0	0	0	0	0	0	1
Bacteria;Bacteria_none;Actinobacteria;Coriobacteriia;Eggerthellales;Eggerthellaceae;Rubneribacter;Rubneribacter badeniensis	0	0	0	1	0	0	0	0	1
Bacteria;Bacteria_none;Actinobacteria;Actinomycetia;Corynebacteriales;Mycobacteriaceae;Mycobacterium;Mycobacterium interjectum	0	0	1	0	0	0	0	0	1
Bacteria;Bacteria_none;Actinobacteria;Nitriliruptoria;Egibacterales;Egibacteraceae;Egibacter;Egibacter rhizosphaerae	0	0	0	0	0	1	0	0	1
Bacteria;Bacteria_none;Firmicutes;Bacilli;Bacillales;Bacillaceae;Bacillus;Bacillus methanolicus	0	0	0	1	0	0	0	0	1
Bacteria;Bacteria_none;Actinobacteria;Actinomycetia;Corynebacteriales;Mycobacteriaceae;Mycobacterium;Mycobacterium heraklionense	0	1	0	0	0	0	0	0	1
Bacteria;Bacteria_none;Proteobacteria;Betaproteobacteria;Burkholderiales;Sphaerotilaceae;Sphaerotilus;Sphaerotilus montanus	0	1	0	0	0	0	0	0	1
Bacteria;Bacteria_none;Actinobacteria;Rubrobacteria;Rubrobacterales;Rubrobacteraceae;Rubrobacter;Rubrobacter taiwanensis	0	1	0	0	0	0	0	0	1
Bacteria;Bacteria_none;Firmicutes;Bacilli;Bacillales;Bacillaceae;Bacillus;Bacillus fonticola	0	1	0	0	0	0	0	0	1
Bacteria;Bacteria_none;Firmicutes;Bacilli;Bacillales;Bacillaceae;Bacillus;Bacillus coahuilensis	0	1	0	0	0	0	0	0	1
Bacteria;Bacteria_none;Firmicutes;Bacilli;Bacillales;Bacillaceae;Bacillus;Bacillus chungangensis	0	0	1	0	0	0	0	0	1
Bacteria;Bacteria_none;Actinobacteria;Thermoleophilia;Solirubrobacterales;Patulibacteraceae;Patulibacter;Patulibacter ginsengiterrae	0	0	1	0	0	0	0	0	1
Bacteria;Bacteria_none;Actinobacteria;Actinomycetia;Actinomycetales;Actinomycetaceae;Actinomyces;Actinomyces trachealis	1	0	0	0	0	0	0	0	1
Bacteria;Bacteria_none;Proteobacteria;Betaproteobacteria;Burkholderiales;Oxalobacteraceae;Telluria;Telluria mixta	1	0	0	0	0	0	0	0	1
Bacteria;Bacteria_none;Proteobacteria;Betaproteobacteria;Burkholderiales;Oxalobacteraceae;Rugamonas;Rugamonas rubra	1	0	0	0	0	0	0	0	1
Bacteria;Bacteria_none;Aquificae;Aquificae;Aquificales;Hydrogenothermaceae;Venenivibrio;Venenivibrio stagnispumantis	0	1	0	0	0	0	0	0	1
Bacteria;Bacteria_none;Firmicutes;Bacilli;Bacillales;Bacillaceae;Aureibacillus;Aureibacillus halotolerans	0	1	0	0	0	0	0	0	1
Bacteria;Bacteria_none;Aquificae;Aquificae;Desulfurobacteriales;Desulfurobacteriaceae;Desulfurobacterium;Desulfurobacterium indicum	0	0	1	0	0	0	0	0	1
Bacteria;Bacteria_none;Firmicutes;Bacilli;Bacillales;Bacillaceae;Aquibacillus;Aquibacillus albus	0	0	0	0	0	0	1	0	1
Bacteria;Bacteria_none;Proteobacteria;Betaproteobacteria;Burkholderiales;Oxalobacteraceae;Noviherbaspirillum;Noviherbaspirillum denitrificans	1	0	0	0	0	0	0	0	1
Bacteria;Bacteria_none;Proteobacteria;Betaproteobacteria;Burkholderiales;Oxalobacteraceae;Noviherbaspirillum;Noviherbaspirillum aurantiacum	1	0	0	0	0	0	0	0	1
Bacteria;Bacteria_none;Actinobacteria;Coriobacteriia;Eggerthellales;Eggerthellaceae;Gordonibacter;Gordonibacter urolithinfaciens	0	0	0	0	0	0	0	1	1
Bacteria;Bacteria_none;Actinobacteria;Actinomycetia;Corynebacteriales;Mycobacteriaceae;Mycobacterium;Mycobacterium kubicae	0	0	0	1	0	0	0	0	1
Bacteria;Bacteria_none;Actinobacteria;Actinomycetia;Corynebacteriales;Mycobacteriaceae;Mycobacterium;Mycobacterium lepromatosis	0	1	0	0	0	0	0	0	1
Bacteria;Bacteria_none;Proteobacteria;Betaproteobacteria;Neisseriales;Neisseriaceae;Neisseria;Neisseria arctica	1	0	0	0	0	0	0	0	1
Bacteria;Bacteria_none;Firmicutes;Erysipelotrichia;Erysipelotrichales;Erysipelotrichaceae;Erysipelothrix;Erysipelothrix urinaevulpis	0	0	0	0	0	0	1	0	1
Bacteria;Bacteria_none;Actinobacteria;Coriobacteriia;Coriobacteriales;Atopobiaceae;Parolsenella;Parolsenella massiliensis	1	0	0	0	0	0	0	0	1
Bacteria;Bacteria_none;Proteobacteria;Betaproteobacteria;Nitrosomonadales;Methylophilaceae;Methylovorus;Methylovorus glucosotrophus	0	1	0	0	0	0	0	0	1
Bacteria;Bacteria_none;Firmicutes;Erysipelotrichia;Erysipelotrichales;Erysipelotrichaceae;Holdemania;Holdemania filiformis	0	0	0	0	0	1	0	0	1
Bacteria;Bacteria_none;Actinobacteria;Coriobacteriia;Coriobacteriales;Coriobacteriaceae;Collinsella;Collinsella bouchesdurhonensis	0	0	0	1	0	0	0	0	1
Bacteria;Bacteria_none;Firmicutes;Bacilli;Bacillales;Bacillaceae;Caldibacillus;Caldibacillus thermoamylovorans	0	1	0	0	0	0	0	0	1
Bacteria;Bacteria_none;Proteobacteria;Betaproteobacteria;Neisseriales;Neisseriaceae;Simonsiella;Simonsiella muelleri	1	0	0	0	0	0	0	0	1
Bacteria;Bacteria_none;Proteobacteria;Betaproteobacteria;Neisseriales;Neisseriaceae;Neisseria;Neisseria skkuensis	1	0	0	0	0	0	0	0	1
Bacteria;Bacteria_none;Proteobacteria;Betaproteobacteria;Neisseriales;Neisseriaceae;Neisseria;Neisseria iguanae	1	0	0	0	0	0	0	0	1
Bacteria;Bacteria_none;Actinobacteria;Coriobacteriia;Coriobacteriales;Coriobacteriaceae;Senegalimassilia;Senegalimassilia faecalis	0	1	0	0	0	0	0	0	1
Bacteria;Bacteria_none;Proteobacteria;Betaproteobacteria;Neisseriales;Neisseriaceae;Neisseria;Neisseria animaloris	0	0	0	0	0	1	0	0	1
Bacteria;Bacteria_none;Firmicutes;Bacilli;Bacillales;Bacillaceae;Bacillus;Bacillus solimangrovi	1	0	0	0	0	0	0	0	1
Bacteria;Bacteria_none;Firmicutes;Erysipelotrichia;Erysipelotrichales;Erysipelotrichaceae;Traorella;Traorella massiliensis	0	0	1	0	0	0	0	0	1
Bacteria;Bacteria_none;Proteobacteria;Betaproteobacteria;Neisseriales;Neisseriaceae;Kingella;Kingella potus	0	0	0	1	0	0	0	0	1
Bacteria;Bacteria_none;Proteobacteria;Betaproteobacteria;Neisseriales;Neisseriaceae;Eikenella;Eikenella exigua	1	0	0	0	0	0	0	0	1
Bacteria;Bacteria_none;Actinobacteria;Coriobacteriia;Eggerthellales;Eggerthellaceae;Cryptobacterium;Cryptobacterium curtum	0	1	0	0	0	0	0	0	1
Bacteria;Bacteria_none;Firmicutes;Bacilli;Bacillales;Bacillaceae;Bacillus;Bacillus tianshenii	0	1	0	0	0	0	0	0	1
Bacteria;Bacteria_none;Proteobacteria;Betaproteobacteria;Neisseriales;Neisseriaceae;Bergeriella;Bergeriella denitrificans	1	0	0	0	0	0	0	0	1
Bacteria;Bacteria_none;Proteobacteria;Betaproteobacteria;Neisseriales;Neisseriaceae;Alysiella;Alysiella filiformis	1	0	0	0	0	0	0	0	1
Bacteria;Bacteria_none;Proteobacteria;Betaproteobacteria;Neisseriales;Chromobacteriaceae;Paludibacterium;Paludibacterium purpuratum	0	1	0	0	0	0	0	0	1
Bacteria;Bacteria_none;Firmicutes;Bacilli;Bacillales;Bacillaceae;Bacillus;Bacillus spongiae	0	0	1	0	0	0	0	0	1
Bacteria;Bacteria_none;Actinobacteria;Actinomycetia;Corynebacteriales;Mycobacteriaceae;Mycobacterium;Mycobacterium paraterrae	0	1	0	0	0	0	0	0	1
Bacteria;Bacteria_none;Firmicutes;Bacilli;Lactobacillales;Streptococcaceae;Lactococcus;Lactococcus kimchii	1	0	0	0	0	0	0	0	1
